Aasiaalli	Aasiaat+LI
Aasiaallu	Aasiaat+LU
Aasiaat	Aasiaat
Aasiammioqarpoq	Aasiaat+MIU-QAR+vuq
Aasiammioqarporli	Aasiaat+MIU-QAR+vuq+LI
Aasiammioqarporlu	Aasiaat+MIU-QAR+vuq+LU
Aasiammioqassavoq	Aasiaat+MIU-QAR-SSA+vuq
Aasiammioqassavorli	Aasiaat+MIU-QAR-SSA+vuq+LI
Aasiammioqassavorlu	Aasiaat+MIU-QAR-SSA+vuq+LU
Aasiammiu	Aasiaat+MIU
Aasiammiuli	Aasiaat+MIU+LI
Aasiammiulu	Aasiaat+MIU+LU
Aasiammiumi	Aasiaat+MIU-mi
Aasiammiumik	Aasiaat+MIU-mik
Aasiammiumili	Aasiaat+MIU-mi+LI
Aasiammiumilli	Aasiaat+MIU-mik+LI
Aasiammiumillu	Aasiaat+MIU-mik+LU
Aasiammiumilu	Aasiaat+MIU-mi+LU
Aasiammiuussavoq	Aasiaat+MIU-U-SSA+vuq
Aasiammiuussavorli	Aasiaat+MIU-U-SSA+vuq+LI
Aasiammiuussavorlu	Aasiaat+MIU-U-SSA+vuq+LU
Aasiammiuussavunga	Aasiaat+MIU-U-SSA+vuŋa
Aasiammiuussavungali	Aasiaat+MIU-U-SSA+vuŋa+LI
Aasiammiuuvoq	Aasiaat+MIU-U+vuq
Aasiammiuuvorli	Aasiaat+MIU-U+vuq+LI
Aasiammiuuvorlu	Aasiaat+MIU-U+vuq+LU
Aasiammiuuvunga	Aasiaat+MIU-U+vuŋa
Aasiammiuuvungali	Aasiaat+MIU-U+vuŋa+LI
Aasiammiuuvungalu	Aasiaat+MIU-U+vuŋa+LU
Avanersuaq	Avanersuaq
Avanersuarli	Avanersuaq+LI
Avanersuarlu	Avanersuaq+LU
Avanersuarmi	Avanersuaq+mi
Avanersuarmik	Avanersuaq+mik
Avanersuarmili	Avanersuaq+mi+LI
Avanersuarmilli	Avanersuaq+mik+LI
Avanersuarmillu	Avanersuaq+mik+LU
Avanersuarmilu	Avanersuaq+mi+LU
Avanersuarmioqarpoq	Avanersuaq+MIU-QAR+vuq
Avanersuarmioqarporli	Avanersuaq+MIU-QAR+vuq+LI
Avanersuarmioqarporlu	Avanersuaq+MIU-QAR+vuq+LU
Avanersuarmioqassavoq	Avanersuaq+MIU-QAR-SSA+vuq
Avanersuarmioqassavorli	Avanersuaq+MIU-QAR-SSA+vuq+LI
Avanersuarmioqassavorlu	Avanersuaq+MIU-QAR-SSA+vuq+LU
Avanersuarmiu	Avanersuaq+MIU
Avanersuarmiuli	Avanersuaq+MIU+LI
Avanersuarmiulu	Avanersuaq+MIU+LU
Avanersuarmiumi	Avanersuaq+MIU-mi
Avanersuarmiumik	Avanersuaq+MIU-mik
Avanersuarmiumili	Avanersuaq+MIU-mi+LI
Avanersuarmiumilu	Avanersuaq+MIU-mi+LU
Avanersuarmiumilli	Avanersuaq+MIU-mik+LI
Avanersuarmiumillu	Avanersuaq+MIU-mik+LU
Avanersuarmiuussavoq	Avanersuaq+MIU-U-SSA+vuq
Avanersuarmiuussavorli	Avanersuaq+MIU-U-SSA+vuq+LI
Avanersuarmiuussavunga	Avanersuaq+MIU-U-SSA+vuŋa
Avanersuarmiuussavungali	Avanersuaq+MIU-U-SSA+vuŋa+LI
Avanersuarmiuussavungalu	Avanersuaq+MIU-U-SSA+vuŋa+LU
Avanersuarmiuuvoq	Avanersuaq+MIU-U+vuq
Avanersuarmiuuvorli	Avanersuaq+MIU-U+vuq+LI
Avanersuarmiuuvorlu	Avanersuaq+MIU-U+vuq+LU
Avanersuarmiuuvunga	Avanersuaq+MIU-U+vuŋa
Avanersuarmiuuvungali	Avanersuaq+MIU-U+vuŋa+LI
Avanersuarmiuuvungalu	Avanersuaq+MIU-U+vuŋa+LU
Esbjerg	Esbjerg
Esbjergili	Esbjerg+LI
Esbjergilu	Esbjerg+LU
Esbjergimi	Esbjerg-mi
Esbjergimik	Esbjerg-mik
Esbjergimili	Esbjerg-mi+LI
Esbjergimilli	Esbjerg-mik+LI
Esbjergimillu	Esbjerg-mik+LU
Esbjergimilu	Esbjerg-mi+LU
Esbjergimioqarpoq	Esbjerg+MIU-QAR+vuq
Esbjergimioqarporli	Esbjerg+MIU-QAR+vuq+LI
Esbjergimioqarporlu	Esbjerg+MIU-QAR+vuq+LU
Esbjergimioqassavoq	Esbjerg+MIU-QAR-SSA+vuq
Esbjergimioqassavorli	Esbjerg+MIU-QAR-SSA+vuq+LI
Esbjergimioqassavorlu	Esbjerg+MIU-QAR-SSA+vuq+LU
Esbjergimiu	Esbjerg+MIU
Esbjergimiuli	Esbjerg+MIU+LI
Esbjergimiulu	Esbjerg+MIU+LU
Esbjergimiumi	Esbjerg+MIU-mi
Esbjergimiumik	Esbjerg+MIU-mik
Esbjergimiumili	Esbjerg+MIU-mi+LI
Esbjergimiumilli	Esbjerg+MIU-mik+LI
Esbjergimiumillu	Esbjerg+MIU-mik+LU
Esbjergimiumilu	Esbjerg+MIU-mi+LU
Esbjergimiuussavoq	Esbjerg+MIU-U-SSA+vuq
Esbjergimiuussavorli	Esbjerg+MIU-U-SSA+vuq+LI
Esbjergimiuussavorlu	Esbjerg+MIU-U-SSA+vuq+LU
Esbjergimiuussavunga	Esbjerg+MIU-U-SSA+vuŋa
Esbjergimiuussavungali	Esbjerg+MIU-U-SSA+vuŋa+LI
Esbjergimiuussavungalu	Esbjerg+MIU-U-SSA+vuŋa+LU
Esbjergimiuuvoq	Esbjerg+MIU-U+vuq
Esbjergimiuuvorli	Esbjerg+MIU-U+vuq+LI
Esbjergimiuuvorlu	Esbjerg+MIU-U+vuq+LU
Esbjergimiuuvunga	Esbjerg+MIU-U+vuŋa
Esbjergimiuuvungali	Esbjerg+MIU-U+vuŋa+LI
Esbjergimiuuvungalu	Esbjerg+MIU-U+vuŋa+LU
Finland	Finland
Finlandili	Finland+LI
Finlandilu	Finland+LU
Finlandimi	Finland-mi
Finlandimik	Finland-mik
Finlandimili	Finland-mi+LI
Finlandimilli	Finland-mik+LI
Finlandimillu	Finland-mik+LU
Finlandimilu	Finland-mi+LU
Finlandimioqarpoq	Finland+MIU-QAR+vuq
Finlandimioqarporli	Finland+MIU-QAR+vuq+LI
Finlandimioqarporlu	Finland+MIU-QAR+vuq+LU
Finlandimioqassavoq	Finland+MIU-QAR-SSA+vuq
Finlandimioqassavorli	Finland+MIU-QAR-SSA+vuq+LI
Finlandimioqassavorlu	Finland+MIU-QAR-SSA+vuq+LU
Finlandimiu	Finland+MIU
Finlandimiuli	Finland+MIU+LI
Finlandimiulu	Finland+MIU+LU
Finlandimiumi	Finland+MIU-mi
Finlandimiumik	Finland+MIU-mik
Finlandimiumili	Finland+MIU-mi+LI
Finlandimiumilu	Finland+MIU-mi+LU
Finlandimiumilli	Finland+MIU-mik+LI
Finlandimiumillu	Finland+MIU-mik+LU
Finlandimiuussavoq	Finland+MIU-U-SSA+vuq
Finlandimiuussavorli	Finland+MIU-U-SSA+vuq+LI
Finlandimiuussavorlu	Finland+MIU-U-SSA+vuq+LU
Finlandimiuussavunga	Finland+MIU-U-SSA+vuŋa
Finlandimiuussavungali	Finland+MIU-U-SSA+vuŋa+LI
Finlandimiuussavungalu	Finland+MIU-U-SSA+vuŋa+LU
Finlandimiuuvoq	Finland+MIU-U+vuq
Finlandimiuuvorli	Finland+MIU-U+vuq+LI
Finlandimiuuvorlu	Finland+MIU-U+vuq+LU
Finlandimiuuvunga	Finland+MIU-U+vuŋa
Finlandimiuuvungali	Finland+MIU-U+vuŋa+LI
Finlandimiuuvungalu	Finland+MIU-U+vuŋa+LU
Gentofte	Gentofte
Gentofteli	Gentofte+LI
Gentoftelu	Gentofte+LU
Gentoftemi	Gentofte-mi
Gentoftemik	Gentofte-mik
Gentoftemili	Gentofte-mi+LI
Gentoftemilli	Gentofte-mik+LI
Gentoftemillu	Gentofte-mik+LU
Gentoftemilu	Gentofte-mi+LU
Gentoftemioqarpoq	Gentofte+MIU-QAR+vuq
Gentoftemioqarporli	Gentofte+MIU-QAR+vuq+LI
Gentoftemioqarporlu	Gentofte+MIU-QAR+vuq+LU
Gentoftemioqassavoq	Gentofte+MIU-QAR-SSA+vuq
Gentoftemioqassavorli	Gentofte+MIU-QAR-SSA+vuq+LI
Gentoftemioqassavorlu	Gentofte+MIU-QAR-SSA+vuq+LU
Gentoftemiu	Gentofte+MIU
Gentoftemiuli	Gentofte+MIU+LI
Gentoftemiumi	Gentofte+MIU-mi
Gentoftemiumik	Gentofte+MIU-mik
Gentoftemiumili	Gentofte+MIU-mi+LI
Gentoftemiumilu	Gentofte+MIU-mi+LU
Gentoftemiuussavoq	Gentofte+MIU-U-SSA+vuq
Gentoftemiuussavorli	Gentofte+MIU-U-SSA+vuq+LI
Gentoftemiuussavorlu	Gentofte+MIU-U-SSA+vuq+LU
Gentoftemiuussavunga	Gentofte+MIU-U-SSA+vuŋa
Gentoftemiuussavungali	Gentofte+MIU-U-SSA+vuŋa+LI
Gentoftemiuussavungalu	Gentofte+MIU-U-SSA+vuŋa+LU
Gentoftemiuuvoq	Gentofte+MIU-U+vuq
Gentoftemiuuvorli	Gentofte+MIU-U+vuq+LI
Gentoftemiuuvorlu	Gentofte+MIU-U+vuq+LU
Gentoftemiuuvunga	Gentofte+MIU-U+vuŋa
Gentoftemiuuvungali	Gentofte+MIU-U+vuŋa+LI
Gentoftemiuuvungalu	Gentofte+MIU-U+vuŋa+LU
Illoqqortoormiormioqarpoq	Illoqqortoormiut+MIU-QAR+vuq
Illoqqortoormiormioqarporli	Illoqqortoormiut+MIU-QAR+vuq+LI
Illoqqortoormiormioqarporlu	Illoqqortoormiut+MIU-QAR+vuq+LU
Illoqqortoormiormioqassavoq	Illoqqortoormiut+MIU-QAR-SSA+vuq
Illoqqortoormiormioqassavorli	Illoqqortoormiut+MIU-QAR-SSA+vuq+LI
Illoqqortoormiormioqassavorlu	Illoqqortoormiut+MIU-QAR-SSA+vuq+LU
Illoqqortoormiormiu	Illoqqortoormiut+MIU
Illoqqortoormiormiuli	Illoqqortoormiut+MIU+LI
Illoqqortoormiormiulu	Illoqqortoormiut+MIU+LU
Illoqqortoormiormiumi	Illoqqortoormiut+MIU-mi
Illoqqortoormiormiumik	Illoqqortoormiut+MIU-mik
Illoqqortoormiormiumili	Illoqqortoormiut+MIU-mi+LI
Illoqqortoormiormiumilli	Illoqqortoormiut+MIU-mik+LI
Illoqqortoormiormiumillu	Illoqqortoormiut+MIU-mik+LU
Illoqqortoormiormiumilu	Illoqqortoormiut+MIU-mi+LU
Illoqqortoormiormiuussavoq	Illoqqortoormiut+MIU-U-SSA+vuq
Illoqqortoormiormiuussavorli	Illoqqortoormiut+MIU-U-SSA+vuq+LI
Illoqqortoormiormiuussavorlu	Illoqqortoormiut+MIU-U-SSA+vuq+LU
Illoqqortoormiormiuussavunga	Illoqqortoormiut+MIU-U-SSA+vuŋa
Illoqqortoormiormiuussavungali	Illoqqortoormiut+MIU-U-SSA+vuŋa+LI
Illoqqortoormiormiuussavungalu	Illoqqortoormiut+MIU-U-SSA+vuŋa+LU
Illoqqortoormiormiuuvoq	Illoqqortoormiut+MIU-U+vuq
Illoqqortoormiormiuuvorli	Illoqqortoormiut+MIU-U+vuq+LI
Illoqqortoormiormiuuvorlu	Illoqqortoormiut+MIU-U+vuq+LU
Illoqqortoormiormiuuvunga	Illoqqortoormiut+MIU-U+vuŋa
Illoqqortoormiormiuuvungali	Illoqqortoormiut+MIU-U+vuŋa+LI
Illoqqortoormiormiuuvungalu	Illoqqortoormiut+MIU-U+vuŋa+LU
Illoqqortoormiulli	Illoqqortoormiut+LI
Illoqqortoormiullu	Illoqqortoormiut+LU
Illoqqortoormiut	Illoqqortoormiut
Iluliarmioqarpoq	Ilulissat+MIU-QAR+vuq
Iluliarmioqarporli	Ilulissat+MIU-QAR+vuq+LI
Iluliarmioqarporlu	Ilulissat+MIU-QAR+vuq+LU
Iluliarmioqassavoq	Ilulissat+MIU-QAR-SSA+vuq
Iluliarmioqassavorli	Ilulissat+MIU-QAR-SSA+vuq+LI
Iluliarmioqassavorlu	Ilulissat+MIU-QAR-SSA+vuq+LU
Iluliarmiu	Ilulissat+MIU
Iluliarmiuli	Ilulissat+MIU+LI
Iluliarmiulu	Ilulissat+MIU+LU
Iluliarmiumi	Ilulissat+MIU-mi
Iluliarmiumik	Ilulissat+MIU-mik
Iluliarmiumili	Ilulissat+MIU-mi+LI
Iluliarmiumillu	Ilulissat+MIU-mik+LU
Iluliarmiumilu	Ilulissat+MIU-mi+LU
Iluliarmiuussavoq	Ilulissat+MIU-U-SSA+vuq
Iluliarmiuussavorli	Ilulissat+MIU-U-SSA+vuq+LI
Iluliarmiuussavorlu	Ilulissat+MIU-U-SSA+vuq+LU
Iluliarmiuussavunga	Ilulissat+MIU-U-SSA+vuŋa
Iluliarmiuussavungali	Ilulissat+MIU-U-SSA+vuŋa+LI
Iluliarmiuussavungalu	Ilulissat+MIU-U-SSA+vuŋa+LU
Iluliarmiuuvoq	Ilulissat+MIU-U+vuq
Iluliarmiuuvorli	Ilulissat+MIU-U+vuq+LI
Iluliarmiuuvorlu	Ilulissat+MIU-U+vuq+LU
Iluliarmiuuvunga	Ilulissat+MIU-U+vuŋa
Iluliarmiuuvungali	Ilulissat+MIU-U+vuŋa+LI
Iluliarmiuuvungalu	Ilulissat+MIU-U+vuŋa+LU
Ilulissalli	Ilulissat+LI
Ilulissallu	Ilulissat+LU
Ilulissat	Ilulissat
Ivittoormioqarpoq	Ivittuut+MIU-QAR+vuq
Ivittoormioqarporli	Ivittuut+MIU-QAR+vuq+LI
Ivittoormioqarporlu	Ivittuut+MIU-QAR+vuq+LU
Ivittoormioqassavoq	Ivittuut+MIU-QAR-SSA+vuq
Ivittoormioqassavorli	Ivittuut+MIU-QAR-SSA+vuq+LI
Ivittoormioqassavorlu	Ivittuut+MIU-QAR-SSA+vuq+LU
Ivittoormiu	Ivittuut+MIU
Ivittoormiuli	Ivittuut+MIU+LI
Ivittoormiulu	Ivittuut+MIU+LU
Ivittoormiumi	Ivittuut+MIU-mi
Ivittoormiumik	Ivittuut+MIU-mik
Ivittoormiumili	Ivittuut+MIU-mi+LI
Ivittoormiumilli	Ivittuut+MIU-mik+LI
Ivittoormiumillu	Ivittuut+MIU-mik+LU
Ivittoormiumilu	Ivittuut+MIU-mi+LU
Ivittoormiuussavoq	Ivittuut+MIU-U-SSA+vuq
Ivittoormiuussavorli	Ivittuut+MIU-U-SSA+vuq+LI
Ivittoormiuussavorlu	Ivittuut+MIU-U-SSA+vuq+LU
Ivittoormiuussavunga	Ivittuut+MIU-U-SSA+vuŋa
Ivittoormiuussavungali	Ivittuut+MIU-U-SSA+vuŋa+LI
Ivittoormiuussavungalu	Ivittuut+MIU-U-SSA+vuŋa+LU
Ivittoormiuuvoq	Ivittuut+MIU-U+vuq
Ivittoormiuuvorli	Ivittuut+MIU-U+vuq+LI
Ivittoormiuuvorlu	Ivittuut+MIU-U+vuq+LU
Ivittoormiuuvunga	Ivittuut+MIU-U+vuŋa
Ivittoormiuuvungali	Ivittuut+MIU-U+vuŋa+LI
Ivittoormiuuvungalu	Ivittuut+MIU-U+vuŋa+LU
Ivittuulli	Ivittuut+LI
Ivittuullu	Ivittuut+LU
Ivittuut	Ivittuut
Kangaatsiami	Kangaatsiaq-mi
Kangaatsiamik	Kangaatsiaq-mik
Kangaatsiamili	Kangaatsiaq-mi+LI
Kangaatsiamilli	Kangaatsiaq-mik+LI
Kangaatsiamillu	Kangaatsiaq-mik+LU
Kangaatsiamilu	Kangaatsiaq-mi+LU
Kangaatsiaq	Kangaatsiaq
Kangaatsiarli	Kangaatsiaq+LI
Kangaatsiarlu	Kangaatsiaq+LU
Kangaatsiarmioqarpoq	Kangaatsiaq+MIU-QAR+vuq
Kangaatsiarmioqarporli	Kangaatsiaq+MIU-QAR+vuq+LI
Kangaatsiarmioqarporlu	Kangaatsiaq+MIU-QAR+vuq+LU
Kangaatsiarmioqassavoq	Kangaatsiaq+MIU-QAR-SSA+vuq
Kangaatsiarmioqassavorli	Kangaatsiaq+MIU-QAR-SSA+vuq+LI
Kangaatsiarmioqassavorlu	Kangaatsiaq+MIU-QAR-SSA+vuq+LU
Kangaatsiarmiu	Kangaatsiaq+MIU
Kangaatsiarmiuli	Kangaatsiaq+MIU+LI
Kangaatsiarmiulu	Kangaatsiaq+MIU+LU
Kangaatsiarmiumi	Kangaatsiaq+MIU-mi
Kangaatsiarmiumik	Kangaatsiaq+MIU-mik
Kangaatsiarmiumili	Kangaatsiaq+MIU-mi+LI
Kangaatsiarmiumilli	Kangaatsiaq+MIU-mik+LI
Kangaatsiarmiumillu	Kangaatsiaq+MIU-mik+LU
Kangaatsiarmiuussavoq	Kangaatsiaq+MIU-U-SSA+vuq
Kangaatsiarmiuussavorli	Kangaatsiaq+MIU-U-SSA+vuq+LI
Kangaatsiarmiuussavunga	Kangaatsiaq+MIU-U-SSA+vuŋa
Kangaatsiarmiuussavungalu	Kangaatsiaq+MIU-U-SSA+vuŋa+LU
Kangaatsiarmiuuvoq	Kangaatsiaq+MIU-U+vuq
Kangaatsiarmiuuvorli	Kangaatsiaq+MIU-U+vuq+LI
Kangaatsiarmiuuvorlu	Kangaatsiaq+MIU-U+vuq+LU
Kangaatsiarmiuuvunga	Kangaatsiaq+MIU-U+vuŋa
Kangaatsiarmiuuvungali	Kangaatsiaq+MIU-U+vuŋa+LI
Kangaatsiarmiuuvungalu	Kangaatsiaq+MIU-U+vuŋa+LU
Langgård	Langgård
Langgårdeqarpoq	Langgård-QAR+vuq
Langgårdeqarporli	Langgård-QAR+vuq+LI
Langgårdeqarporlu	Langgård-QAR+vuq+LU
Langgårdeqassavoq	Langgård-QAR-SSA+vuq
Langgårdeqassavorli	Langgård-QAR-SSA+vuq+LI
Langgårdeqassavorlu	Langgård-QAR-SSA+vuq+LU
Langgårdili	Langgård+LI
Langgårdilu	Langgård+LU
Langgårdimi	Langgård-mi
Langgårdimik	Langgård-mik
Langgårdimili	Langgård-mi+LI
Langgårdimilli	Langgård-mik+LI
Langgårdimillu	Langgård-mik+LU
Langgårdimilu	Langgård-mi+LU
Langgårdiussavoq	Langgård-U-SSA+vuq
Langgårdiussavorli	Langgård-U-SSA+vuq+LI
Langgårdiussavorlu	Langgård-U-SSA+vuq+LU
Langgårdiussavunga	Langgård-U-SSA+vuŋa
Langgårdiussavungali	Langgård-U-SSA+vuŋa+LI
Langgårdiuvoq	Langgård-U+vuq
Langgårdiuvorli	Langgård-U+vuq+LI
Langgårdiuvorlu	Langgård-U+vuq+LU
Langgårdiuvunga	Langgård-U+vuŋa
Langgårdiuvungali	Langgård-U+vuŋa+LI
Maniitsoq	Maniitsoq
Maniitsorli	Maniitsoq+LI
Maniitsorlu	Maniitsoq+LU
Maniitsormioqarpoq	Maniitsoq+MIU-QAR+vuq
Maniitsormioqarporli	Maniitsoq+MIU-QAR+vuq+LI
Maniitsormioqarporlu	Maniitsoq+MIU-QAR+vuq+LU
Maniitsormioqassavoq	Maniitsoq+MIU-QAR-SSA+vuq
Maniitsormioqassavorli	Maniitsoq+MIU-QAR-SSA+vuq+LI
Maniitsormioqassavorlu	Maniitsoq+MIU-QAR-SSA+vuq+LU
Maniitsormiu	Maniitsoq+MIU
Maniitsormiuli	Maniitsoq+MIU+LI
Maniitsormiulu	Maniitsoq+MIU+LU
Maniitsormiumi	Maniitsoq+MIU-mi
Maniitsormiumik	Maniitsoq+MIU-mik
Maniitsormiumili	Maniitsoq+MIU-mi+LI
Maniitsormiumilli	Maniitsoq+MIU-mik+LI
Maniitsormiumillu	Maniitsoq+MIU-mik+LU
Maniitsormiumilu	Maniitsoq+MIU-mi+LU
Maniitsormiuussavoq	Maniitsoq+MIU-U-SSA+vuq
Maniitsormiuussavorli	Maniitsoq+MIU-U-SSA+vuq+LI
Maniitsormiuussavorlu	Maniitsoq+MIU-U-SSA+vuq+LU
Maniitsormiuussavunga	Maniitsoq+MIU-U-SSA+vuŋa
Maniitsormiuussavungali	Maniitsoq+MIU-U-SSA+vuŋa+LI
Maniitsormiuussavungalu	Maniitsoq+MIU-U-SSA+vuŋa+LU
Maniitsormiuuvoq	Maniitsoq+MIU-U+vuq
Maniitsormiuuvorli	Maniitsoq+MIU-U+vuq+LI
Maniitsormiuuvorlu	Maniitsoq+MIU-U+vuq+LU
Maniitsormiuuvunga	Maniitsoq+MIU-U+vuŋa
Maniitsormiuuvungali	Maniitsoq+MIU-U+vuŋa+LI
Maniitsormiuuvungalu	Maniitsoq+MIU-U+vuŋa+LU
Maniitsumi	Maniitsoq-mi
Maniitsumik	Maniitsoq-mik
Maniitsumili	Maniitsoq-mi+LI
Maniitsumilli	Maniitsoq-mik+LI
Maniitsumillu	Maniitsoq-mik+LU
Maniitsumilu	Maniitsoq-mi+LU
Nanortalik	Nanortalik
Nanortalilli	Nanortalik+LI
Nanortalillu	Nanortalik+LU
Nanortalimmi	Nanortalik+mi
Nanortalimmik	Nanortalik+mik
Nanortalimmili	Nanortalik+mi+LI
Nanortalimmilli	Nanortalik+mik+LI
Nanortalimmillu	Nanortalik+mik+LU
Nanortalimmilu	Nanortalik+mi+LU
Nanortalimmioqarpoq	Nanortalik+MIU-QAR+vuq
Nanortalimmioqarporli	Nanortalik+MIU-QAR+vuq+LI
Nanortalimmioqarporlu	Nanortalik+MIU-QAR+vuq+LU
Nanortalimmioqassavoq	Nanortalik+MIU-QAR-SSA+vuq
Nanortalimmioqassavorli	Nanortalik+MIU-QAR-SSA+vuq+LI
Nanortalimmioqassavorlu	Nanortalik+MIU-QAR-SSA+vuq+LU
Nanortalimmiu	Nanortalik+MIU
Nanortalimmiuli	Nanortalik+MIU+LI
Nanortalimmiumi	Nanortalik+MIU-mi
Nanortalimmiumik	Nanortalik+MIU-mik
Nanortalimmiumillu	Nanortalik+MIU-mik+LU
Nanortalimmiuussavoq	Nanortalik+MIU-U-SSA+vuq
Nanortalimmiuussavorli	Nanortalik+MIU-U-SSA+vuq+LI
Nanortalimmiuussavunga	Nanortalik+MIU-U-SSA+vuŋa
Nanortalimmiuussavungali	Nanortalik+MIU-U-SSA+vuŋa+LI
Nanortalimmiuussavungalu	Nanortalik+MIU-U-SSA+vuŋa+LU
Nanortalimmiuuvoq	Nanortalik+MIU-U+vuq
Nanortalimmiuuvorli	Nanortalik+MIU-U+vuq+LI
Nanortalimmiuuvorlu	Nanortalik+MIU-U+vuq+LU
Nanortalimmiuuvunga	Nanortalik+MIU-U+vuŋa
Nanortalimmiuuvungali	Nanortalik+MIU-U+vuŋa+LI
Nanortalimmiuuvungalu	Nanortalik+MIU-U+vuŋa+LU
Narsami	Narsaq-mi
Narsamik	Narsaq-mik
Narsamili	Narsaq-mi+LI
Narsamilli	Narsaq-mik+LI
Narsamillu	Narsaq-mik+LU
Narsamilu	Narsaq-mi+LU
Narsaq	Narsaq
Narsarli	Narsaq+LI
Narsarlu	Narsaq+LU
Narsarmioqarpoq	Narsaq+MIU-QAR+vuq
Narsarmioqarporli	Narsaq+MIU-QAR+vuq+LI
Narsarmioqarporlu	Narsaq+MIU-QAR+vuq+LU
Narsarmioqassavoq	Narsaq+MIU-QAR-SSA+vuq
Narsarmioqassavorli	Narsaq+MIU-QAR-SSA+vuq+LI
Narsarmioqassavorlu	Narsaq+MIU-QAR-SSA+vuq+LU
Narsarmiu	Narsaq+MIU
Narsarmiulu	Narsaq+MIU+LU
Narsarmiumi	Narsaq+MIU-mi
Narsarmiumik	Narsaq+MIU-mik
Narsarmiumili	Narsaq+MIU-mi+LI
Narsarmiumilli	Narsaq+MIU-mik+LI
Narsarmiumillu	Narsaq+MIU-mik+LU
Narsarmiuussavoq	Narsaq+MIU-U-SSA+vuq
Narsarmiuussavorli	Narsaq+MIU-U-SSA+vuq+LI
Narsarmiuussavunga	Narsaq+MIU-U-SSA+vuŋa
Narsarmiuussavungali	Narsaq+MIU-U-SSA+vuŋa+LI
Narsarmiuuvoq	Narsaq+MIU-U+vuq
Narsarmiuuvorli	Narsaq+MIU-U+vuq+LI
Narsarmiuuvorlu	Narsaq+MIU-U+vuq+LU
Narsarmiuuvunga	Narsaq+MIU-U+vuŋa
Narsarmiuuvungali	Narsaq+MIU-U+vuŋa+LI
Nuuk	Nuuk
Nuulli	Nuuk+LI
Nuullu	Nuuk+LU
Nuummi	Nuuk+mi
Nuummik	Nuuk+mik
Nuummili	Nuuk+mi+LI
Nuummilli	Nuuk+mik+LI
Nuummillu	Nuuk+mik+LU
Nuummilu	Nuuk+mi+LU
Nuummioqarpoq	Nuuk+MIU-QAR+vuq
Nuummioqarporli	Nuuk+MIU-QAR+vuq+LI
Nuummioqarporlu	Nuuk+MIU-QAR+vuq+LU
Nuummioqassavoq	Nuuk+MIU-QAR-SSA+vuq
Nuummioqassavorli	Nuuk+MIU-QAR-SSA+vuq+LI
Nuummioqassavorlu	Nuuk+MIU-QAR-SSA+vuq+LU
Nuummiu	Nuuk+MIU
Nuummiuli	Nuuk+MIU+LI
Nuummiulu	Nuuk+MIU+LU
Nuummiumi	Nuuk+MIU-mi
Nuummiumik	Nuuk+MIU-mik
Nuummiumili	Nuuk+MIU-mi+LI
Nuummiumilli	Nuuk+MIU-mik+LI
Nuummiumillu	Nuuk+MIU-mik+LU
Nuummiumilu	Nuuk+MIU-mi+LU
Nuummiuussavoq	Nuuk+MIU-U-SSA+vuq
Nuummiuussavorli	Nuuk+MIU-U-SSA+vuq+LI
Nuummiuussavorlu	Nuuk+MIU-U-SSA+vuq+LU
Nuummiuussavunga	Nuuk+MIU-U-SSA+vuŋa
Nuummiuussavungali	Nuuk+MIU-U-SSA+vuŋa+LI
Nuummiuussavungalu	Nuuk+MIU-U-SSA+vuŋa+LU
Nuummiuuvoq	Nuuk+MIU-U+vuq
Nuummiuuvorli	Nuuk+MIU-U+vuq+LI
Nuummiuuvorlu	Nuuk+MIU-U+vuq+LU
Nuummiuuvunga	Nuuk+MIU-U+vuŋa
Nuummiuuvungali	Nuuk+MIU-U+vuŋa+LI
Nuummiuuvungalu	Nuuk+MIU-U+vuŋa+LU
Paamiormioqarpoq	Paamiut+MIU-QAR+vuq
Paamiormioqarporli	Paamiut+MIU-QAR+vuq+LI
Paamiormioqarporlu	Paamiut+MIU-QAR+vuq+LU
Paamiormioqassavoq	Paamiut+MIU-QAR-SSA+vuq
Paamiormioqassavorli	Paamiut+MIU-QAR-SSA+vuq+LI
Paamiormioqassavorlu	Paamiut+MIU-QAR-SSA+vuq+LU
Paamiormiu	Paamiut+MIU
Paamiormiuli	Paamiut+MIU+LI
Paamiormiulu	Paamiut+MIU+LU
Paamiormiumi	Paamiut+MIU-mi
Paamiormiumik	Paamiut+MIU-mik
Paamiormiumili	Paamiut+MIU-mi+LI
Paamiormiumilli	Paamiut+MIU-mik+LI
Paamiormiumilu	Paamiut+MIU-mi+LU
Paamiormiuussavoq	Paamiut+MIU-U-SSA+vuq
Paamiormiuussavorli	Paamiut+MIU-U-SSA+vuq+LI
Paamiormiuussavorlu	Paamiut+MIU-U-SSA+vuq+LU
Paamiormiuussavunga	Paamiut+MIU-U-SSA+vuŋa
Paamiormiuussavungali	Paamiut+MIU-U-SSA+vuŋa+LI
Paamiormiuussavungalu	Paamiut+MIU-U-SSA+vuŋa+LU
Paamiormiuuvoq	Paamiut+MIU-U+vuq
Paamiormiuuvorli	Paamiut+MIU-U+vuq+LI
Paamiormiuuvorlu	Paamiut+MIU-U+vuq+LU
Paamiormiuuvunga	Paamiut+MIU-U+vuŋa
Paamiormiuuvungali	Paamiut+MIU-U+vuŋa+LI
Paamiormiuuvungalu	Paamiut+MIU-U+vuŋa+LU
Paamiulli	Paamiut+LI
Paamiullu	Paamiut+LU
Paamiut	Paamiut
Per	Per
Pereqarpoq	Per-QAR+vuq
Pereqarporli	Per-QAR+vuq+LI
Pereqarporlu	Per-QAR+vuq+LU
Pereqassavoq	Per-QAR-SSA+vuq
Pereqassavorli	Per-QAR-SSA+vuq+LI
Pereqassavorlu	Per-QAR-SSA+vuq+LU
Perili	Per+LI
Perilu	Per+LU
Perimi	Per-mi
Perimik	Per-mik
Perimili	Per-mi+LI
Perimilli	Per-mik+LI
Perimillu	Per-mik+LU
Perimilu	Per-mi+LU
Periussavunga	Per-U-SSA+vuŋa
Periuvoq	Per-U+vuq
Periuvorli	Per-U+vuq+LI
Periuvorlu	Per-U+vuq+LU
Periuvunga	Per-U+vuŋa
Periuvungali	Per-U+vuŋa+LI
Qaqortoq	Qaqortoq
Qaqortorli	Qaqortoq+LI
Qaqortorlu	Qaqortoq+LU
Qaqortormioqarpoq	Qaqortoq+MIU-QAR+vuq
Qaqortormioqarporli	Qaqortoq+MIU-QAR+vuq+LI
Qaqortormioqarporlu	Qaqortoq+MIU-QAR+vuq+LU
Qaqortormioqassavoq	Qaqortoq+MIU-QAR-SSA+vuq
Qaqortormioqassavorli	Qaqortoq+MIU-QAR-SSA+vuq+LI
Qaqortormioqassavorlu	Qaqortoq+MIU-QAR-SSA+vuq+LU
Qaqortormiu	Qaqortoq+MIU
Qaqortormiuli	Qaqortoq+MIU+LI
Qaqortormiulu	Qaqortoq+MIU+LU
Qaqortormiumi	Qaqortoq+MIU-mi
Qaqortormiumik	Qaqortoq+MIU-mik
Qaqortormiumillu	Qaqortoq+MIU-mik+LU
Qaqortormiumilu	Qaqortoq+MIU-mi+LU
Qaqortormiuussavoq	Qaqortoq+MIU-U-SSA+vuq
Qaqortormiuussavunga	Qaqortoq+MIU-U-SSA+vuŋa
Qaqortormiuussavungali	Qaqortoq+MIU-U-SSA+vuŋa+LI
Qaqortormiuussavungalu	Qaqortoq+MIU-U-SSA+vuŋa+LU
Qaqortormiuuvoq	Qaqortoq+MIU-U+vuq
Qaqortormiuuvorli	Qaqortoq+MIU-U+vuq+LI
Qaqortormiuuvorlu	Qaqortoq+MIU-U+vuq+LU
Qaqortormiuuvunga	Qaqortoq+MIU-U+vuŋa
Qaqortormiuuvungali	Qaqortoq+MIU-U+vuŋa+LI
Qaqortormiuuvungalu	Qaqortoq+MIU-U+vuŋa+LU
Qaqortumi	Qaqortoq-mi
Qaqortumik	Qaqortoq-mik
Qaqortumili	Qaqortoq-mi+LI
Qaqortumilli	Qaqortoq-mik+LI
Qaqortumillu	Qaqortoq-mik+LU
Qaqortumilu	Qaqortoq-mi+LU
Qasigiannguarmioqarpoq	Qasigiannguit+MIU-QAR+vuq
Qasigiannguarmioqarporli	Qasigiannguit+MIU-QAR+vuq+LI
Qasigiannguarmioqarporlu	Qasigiannguit+MIU-QAR+vuq+LU
Qasigiannguarmioqassavoq	Qasigiannguit+MIU-QAR-SSA+vuq
Qasigiannguarmioqassavorli	Qasigiannguit+MIU-QAR-SSA+vuq+LI
Qasigiannguarmioqassavorlu	Qasigiannguit+MIU-QAR-SSA+vuq+LU
Qasigiannguarmiu	Qasigiannguit+MIU
Qasigiannguarmiuli	Qasigiannguit+MIU+LI
Qasigiannguarmiumi	Qasigiannguit+MIU-mi
Qasigiannguarmiumik	Qasigiannguit+MIU-mik
Qasigiannguarmiumili	Qasigiannguit+MIU-mi+LI
Qasigiannguarmiumilli	Qasigiannguit+MIU-mik+LI
Qasigiannguarmiumillu	Qasigiannguit+MIU-mik+LU
Qasigiannguarmiumilu	Qasigiannguit+MIU-mi+LU
Qasigiannguarmiuussavorli	Qasigiannguit+MIU-U-SSA+vuq+LI
Qasigiannguarmiuussavorlu	Qasigiannguit+MIU-U-SSA+vuq+LU
Qasigiannguarmiuussavunga	Qasigiannguit+MIU-U-SSA+vuŋa
Qasigiannguarmiuussavungali	Qasigiannguit+MIU-U-SSA+vuŋa+LI
Qasigiannguarmiuussavungalu	Qasigiannguit+MIU-U-SSA+vuŋa+LU
Qasigiannguarmiuuvoq	Qasigiannguit+MIU-U+vuq
Qasigiannguarmiuuvorli	Qasigiannguit+MIU-U+vuq+LI
Qasigiannguarmiuuvorlu	Qasigiannguit+MIU-U+vuq+LU
Qasigiannguarmiuuvunga	Qasigiannguit+MIU-U+vuŋa
Qasigiannguarmiuuvungali	Qasigiannguit+MIU-U+vuŋa+LI
Qasigiannguarmiuuvungalu	Qasigiannguit+MIU-U+vuŋa+LU
Qasigiannguilli	Qasigiannguit+LI
Qasigiannguillu	Qasigiannguit+LU
Qasigiannguit	Qasigiannguit
Qasigiannguussavoq	Qasigiannguit+MIU-U-SSA+vuq
Qasigiannguussavorli	Qasigiannguit-U-SSA+vuq+LI
Qasigiannguussavorlu	Qasigiannguit-U-SSA+vuq+LU
Qasigiannguuvoq	Qasigiannguit-U+vuq
Qasigiannguuvorli	Qasigiannguit-U+vuq+LI
Qasigiannguuvorlu	Qasigiannguit-U+vuq+LU
Qeqertarsuaq	Qeqertarsuaq
Qeqertarsuarli	Qeqertarsuaq+LI
Qeqertarsuarlu	Qeqertarsuaq+LU
Qeqertarsuarmi	Qeqertarsuaq+mi
Qeqertarsuarmik	Qeqertarsuaq+mik
Qeqertarsuarmili	Qeqertarsuaq+mi+LI
Qeqertarsuarmilli	Qeqertarsuaq+mik+LI
Qeqertarsuarmillu	Qeqertarsuaq+mik+LU
Qeqertarsuarmilu	Qeqertarsuaq+mi+LU
Qeqertarsuarmioqarpoq	Qeqertarsuaq+MIU-QAR+vuq
Qeqertarsuarmioqarporli	Qeqertarsuaq+MIU-QAR+vuq+LI
Qeqertarsuarmioqarporlu	Qeqertarsuaq+MIU-QAR+vuq+LU
Qeqertarsuarmioqassavoq	Qeqertarsuaq+MIU-QAR-SSA+vuq
Qeqertarsuarmioqassavorli	Qeqertarsuaq+MIU-QAR-SSA+vuq+LI
Qeqertarsuarmioqassavorlu	Qeqertarsuaq+MIU-QAR-SSA+vuq+LU
Qeqertarsuarmiu	Qeqertarsuaq+MIU
Qeqertarsuarmiuli	Qeqertarsuaq+MIU+LI
Qeqertarsuarmiulu	Qeqertarsuaq+MIU+LU
Qeqertarsuarmiumi	Qeqertarsuaq+MIU-mi
Qeqertarsuarmiumik	Qeqertarsuaq+MIU-mik
Qeqertarsuarmiumili	Qeqertarsuaq+MIU-mi+LI
Qeqertarsuarmiumillu	Qeqertarsuaq+MIU-mik+LU
Qeqertarsuarmiuussavoq	Qeqertarsuaq+MIU-U-SSA+vuq
Qeqertarsuarmiuussavorli	Qeqertarsuaq+MIU-U-SSA+vuq+LI
Qeqertarsuarmiuussavorlu	Qeqertarsuaq+MIU-U-SSA+vuq+LU
Qeqertarsuarmiuussavunga	Qeqertarsuaq+MIU-U-SSA+vuŋa
Qeqertarsuarmiuussavungali	Qeqertarsuaq+MIU-U-SSA+vuŋa+LI
Qeqertarsuarmiuussavungalu	Qeqertarsuaq+MIU-U-SSA+vuŋa+LU
Qeqertarsuarmiuuvoq	Qeqertarsuaq+MIU-U+vuq
Qeqertarsuarmiuuvorli	Qeqertarsuaq+MIU-U+vuq+LI
Qeqertarsuarmiuuvorlu	Qeqertarsuaq+MIU-U+vuq+LU
Qeqertarsuarmiuuvunga	Qeqertarsuaq+MIU-U+vuŋa
Qeqertarsuarmiuuvungali	Qeqertarsuaq+MIU-U+vuŋa+LI
Sisimiormioqarpoq	Sisimiut+MIU-QAR+vuq
Sisimiormioqarporli	Sisimiut+MIU-QAR+vuq+LI
Sisimiormioqarporlu	Sisimiut+MIU-QAR+vuq+LU
Sisimiormioqassavoq	Sisimiut+MIU-QAR-SSA+vuq
Sisimiormioqassavorli	Sisimiut+MIU-QAR-SSA+vuq+LI
Sisimiormioqassavorlu	Sisimiut+MIU-QAR-SSA+vuq+LU
Sisimiormiu	Sisimiut+MIU
Sisimiormiuli	Sisimiut+MIU+LI
Sisimiormiulu	Sisimiut+MIU+LU
Sisimiormiumi	Sisimiut+MIU-mi
Sisimiormiumik	Sisimiut+MIU-mik
Sisimiormiumili	Sisimiut+MIU-mi+LI
Sisimiormiumilli	Sisimiut+MIU-mik+LI
Sisimiormiumillu	Sisimiut+MIU-mik+LU
Sisimiormiumilu	Sisimiut+MIU-mi+LU
Sisimiormiuussavoq	Sisimiut+MIU-U-SSA+vuq
Sisimiormiuussavorli	Sisimiut+MIU-U-SSA+vuq+LI
Sisimiormiuussavorlu	Sisimiut+MIU-U-SSA+vuq+LU
Sisimiormiuussavunga	Sisimiut+MIU-U-SSA+vuŋa
Sisimiormiuussavungali	Sisimiut+MIU-U-SSA+vuŋa+LI
Sisimiormiuussavungalu	Sisimiut+MIU-U-SSA+vuŋa+LU
Sisimiormiuuvoq	Sisimiut+MIU-U+vuq
Sisimiormiuuvorli	Sisimiut+MIU-U+vuq+LI
Sisimiormiuuvorlu	Sisimiut+MIU-U+vuq+LU
Sisimiormiuuvunga	Sisimiut+MIU-U+vuŋa
Sisimiormiuuvungali	Sisimiut+MIU-U+vuŋa+LI
Sisimiormiuuvungalu	Sisimiut+MIU-U+vuŋa+LU
Sisimiulli	Sisimiut+LI
Sisimiullu	Sisimiut+LU
Sisimiut	Sisimiut
Tasiilami	Tasiilaq-mi
Tasiilamik	Tasiilaq-mik
Tasiilamili	Tasiilaq-mi+LI
Tasiilamilli	Tasiilaq-mik+LI
Tasiilamillu	Tasiilaq-mik+LU
Tasiilamilu	Tasiilaq-mi+LU
Tasiilaq	Tasiilaq
Tasiilarli	Tasiilaq+LI
Tasiilarlu	Tasiilaq+LU
Tasiilarmioqarpoq	Tasiilaq+MIU-QAR+vuq
Tasiilarmioqarporli	Tasiilaq+MIU-QAR+vuq+LI
Tasiilarmioqarporlu	Tasiilaq+MIU-QAR+vuq+LU
Tasiilarmioqassavoq	Tasiilaq+MIU-QAR-SSA+vuq
Tasiilarmioqassavorli	Tasiilaq+MIU-QAR-SSA+vuq+LI
Tasiilarmioqassavorlu	Tasiilaq+MIU-QAR-SSA+vuq+LU
Tasiilarmiu	Tasiilaq+MIU
Tasiilarmiuli	Tasiilaq+MIU+LI
Tasiilarmiulu	Tasiilaq+MIU+LU
Tasiilarmiumi	Tasiilaq+MIU-mi
Tasiilarmiumik	Tasiilaq+MIU-mik
Tasiilarmiumili	Tasiilaq+MIU-mi+LI
Tasiilarmiumilli	Tasiilaq+MIU-mik+LI
Tasiilarmiumilu	Tasiilaq+MIU-mi+LU
Tasiilarmiuussavoq	Tasiilaq+MIU-U-SSA+vuq
Tasiilarmiuussavorli	Tasiilaq+MIU-U-SSA+vuq+LI
Tasiilarmiuussavorlu	Tasiilaq+MIU-U-SSA+vuq+LU
Tasiilarmiuussavunga	Tasiilaq+MIU-U-SSA+vuŋa
Tasiilarmiuussavungali	Tasiilaq+MIU-U-SSA+vuŋa+LI
Tasiilarmiuussavungalu	Tasiilaq+MIU-U-SSA+vuŋa+LU
Tasiilarmiuuvoq	Tasiilaq+MIU-U+vuq
Tasiilarmiuuvorli	Tasiilaq+MIU-U+vuq+LI
Tasiilarmiuuvorlu	Tasiilaq+MIU-U+vuq+LU
Tasiilarmiuuvunga	Tasiilaq+MIU-U+vuŋa
Tasiilarmiuuvungali	Tasiilaq+MIU-U+vuŋa+LI
Tasiilarmiuuvungalu	Tasiilaq+MIU-U+vuŋa+LU
Tika	Tika
Tikaassavoq	Tika-U-SSA+vuq
Tikaassavorli	Tika-U-SSA+vuq+LI
Tikaassavorlu	Tika-U-SSA+vuq+LU
Tikaassavunga	Tika-U-SSA+vuŋa
Tikaassavungali	Tika-U-SSA+vuŋa+LI
Tikaassavungalu	Tika-U-SSA+vuŋa+LU
Tikaavoq	Tika-U+vuq
Tikaavorli	Tika-U+vuq+LI
Tikaavorlu	Tika-U+vuq+LU
Tikaavunga	Tika-U+vuŋa
Tikaavungali	Tika-U+vuŋa+LI
Tikaavungalu	Tika-U+vuŋa+LU
Tikali	Tika+LI
Tikalu	Tika+LU
Tikami	Tika-mi
Tikamik	Tika-mik
Tikamili	Tika-mi+LI
Tikamilli	Tika-mik+LI
Tikamillu	Tika-mik+LU
Tikamilu	Tika-mi+LU
Tikaqarpoq	Tika-QAR+vuq
Tikaqarporli	Tika-QAR+vuq+LI
Tikaqarporlu	Tika-QAR+vuq+LU
Tikaqassavorli	Tika-QAR-SSA+vuq+LI
Tikaqassavorlu	Tika-QAR-SSA+vuq+LU
Upernavik	Upernavik
Upernavilli	Upernavik+LI
Upernavillu	Upernavik+LU
Upernavimmi	Upernavik+mi
Upernavimmik	Upernavik+mik
Upernavimmili	Upernavik+mi+LI
Upernavimmilli	Upernavik+mik+LI
Upernavimmillu	Upernavik+mik+LU
Upernavimmilu	Upernavik+mi+LU
Upernavimmioqarpoq	Upernavik+MIU-QAR+vuq
Upernavimmioqarporli	Upernavik+MIU-QAR+vuq+LI
Upernavimmioqarporlu	Upernavik+MIU-QAR+vuq+LU
Upernavimmioqassavoq	Upernavik+MIU-QAR-SSA+vuq
Upernavimmioqassavorli	Upernavik+MIU-QAR-SSA+vuq+LI
Upernavimmioqassavorlu	Upernavik+MIU-QAR-SSA+vuq+LU
Upernavimmiu	Upernavik+MIU
Upernavimmiuli	Upernavik+MIU+LI
Upernavimmiulu	Upernavik+MIU+LU
Upernavimmiumi	Upernavik+MIU-mi
Upernavimmiumik	Upernavik+MIU-mik
Upernavimmiumili	Upernavik+MIU-mi+LI
Upernavimmiumilli	Upernavik+MIU-mik+LI
Upernavimmiumillu	Upernavik+MIU-mik+LU
Upernavimmiuussavoq	Upernavik+MIU-U-SSA+vuq
Upernavimmiuussavorli	Upernavik+MIU-U-SSA+vuq+LI
Upernavimmiuussavorlu	Upernavik+MIU-U-SSA+vuq+LU
Upernavimmiuussavunga	Upernavik+MIU-U-SSA+vuŋa
Upernavimmiuussavungali	Upernavik+MIU-U-SSA+vuŋa+LI
Upernavimmiuussavungalu	Upernavik+MIU-U-SSA+vuŋa+LU
Upernavimmiuuvoq	Upernavik+MIU-U+vuq
Upernavimmiuuvorli	Upernavik+MIU-U+vuq+LI
Upernavimmiuuvorlu	Upernavik+MIU-U+vuq+LU
Upernavimmiuuvunga	Upernavik+MIU-U+vuŋa
Upernavimmiuuvungali	Upernavik+MIU-U+vuŋa+LI
Upernavimmiuuvungalu	Upernavik+MIU-U+vuŋa+LU
Uummannami	Uummannaq-mi
Uummannamik	Uummannaq-mik
Uummannamili	Uummannaq-mi+LI
Uummannamilli	Uummannaq-mik+LI
Uummannamillu	Uummannaq-mik+LU
Uummannamilu	Uummannaq-mi+LU
Uummannaq	Uummannaq
Uummannarli	Uummannaq+LI
Uummannarlu	Uummannaq+LU
Uummannarmioqarpoq	Uummannaq+MIU-QAR+vuq
Uummannarmioqarporli	Uummannaq+MIU-QAR+vuq+LI
Uummannarmioqarporlu	Uummannaq+MIU-QAR+vuq+LU
Uummannarmioqassavoq	Uummannaq+MIU-QAR-SSA+vuq
Uummannarmioqassavorli	Uummannaq+MIU-QAR-SSA+vuq+LI
Uummannarmioqassavorlu	Uummannaq+MIU-QAR-SSA+vuq+LU
Uummannarmiu	Uummannaq+MIU
Uummannarmiuli	Uummannaq+MIU+LI
Uummannarmiulu	Uummannaq+MIU+LU
Uummannarmiumi	Uummannaq+MIU-mi
Uummannarmiumik	Uummannaq+MIU-mik
Uummannarmiumili	Uummannaq+MIU-mi+LI
Uummannarmiumilli	Uummannaq+MIU-mik+LI
Uummannarmiumillu	Uummannaq+MIU-mik+LU
Uummannarmiumilu	Uummannaq+MIU-mi+LU
Uummannarmiuussavorli	Uummannaq+MIU-U-SSA+vuq+LI
Uummannarmiuussavorlu	Uummannaq+MIU-U-SSA+vuq+LU
Uummannarmiuussavunga	Uummannaq+MIU-U-SSA+vuŋa
Uummannarmiuussavungali	Uummannaq+MIU-U-SSA+vuŋa+LI
Uummannarmiuussavungalu	Uummannaq+MIU-U-SSA+vuŋa+LU
Uummannarmiuuvoq	Uummannaq+MIU-U+vuq
Uummannarmiuuvorli	Uummannaq+MIU-U+vuq+LI
Uummannarmiuuvorlu	Uummannaq+MIU-U+vuq+LU
Uummannarmiuuvunga	Uummannaq+MIU-U+vuŋa
Uummannarmiuuvungali	Uummannaq+MIU-U+vuŋa+LI
Uummannarmiuuvungalu	Uummannaq+MIU-U+vuŋa+LU
aamma	aamma
aammali	aamma+LI
aammalu	aamma+LU
akisooq	akisooq
akisoorli	akisooq+LI
akisoorlu	akisooq+LU
akisuujussavoq	akisooq-U-SSA+vuq
akisuujussavorli	akisooq-U-SSA+vuq+LI
akisuujussavorlu	akisooq-U-SSA+vuq+LU
akisuujussavunga	akisooq-U-SSA+vuŋa
akisuujussavungali	akisooq-U-SSA+vuŋa+LI
akisuujussavungalu	akisooq-U-SSA+vuŋa+LU
akisuujuvoq	akisooq-U+vuq
akisuujuvorli	akisooq-U+vuq+LI
akisuujuvorlu	akisooq-U+vuq+LU
akisuujuvunga	akisooq-U+vuŋa
akisuujuvungali	akisooq-U+vuŋa+LI
akisuujuvungalu	akisooq-U+vuŋa+LU
akisuumi	akisooq-mi
akisuumik	akisooq-mik
akisuumili	akisooq-mi+LI
akisuumilli	akisooq-mik+LI
akisuumillu	akisooq-mik+LU
akisuumilu	akisooq-mi+LU
ateq	ateq
ateqarpoq	ateq-QAR+vuq
ateqarporli	ateq-QAR+vuq+LI
ateqarporlu	ateq-QAR+vuq+LU
ateqarpunga	ateq-QAR+vuŋa
ateqarpungali	ateq-QAR+vuŋa+LI
ateqarpungalu	ateq-QAR+vuŋa+LU
ateqassavoq	ateq-QAR-SSA+vuq
ateqassavorli	ateq-QAR-SSA+vuq+LI
ateqassavorlu	ateq-QAR-SSA+vuq+LU
ateqassavunga	ateq-QAR-SSA+vuŋa
ateqassavungali	ateq-QAR-SSA+vuŋa+LI
ateqassavungalu	ateq-QAR-SSA+vuŋa+LU
atera	ateq+ga
aterali	ateq+ga+LI
ateralu	ateq+ga+LU
aterli	ateq+LI
aterlu	ateq+LU
atermi	ateq+mi
atermik	ateq+mik
atermili	ateq+mi+LI
atermilli	ateq+mik+LI
atermilu	ateq+mi+LU
atiussavoq	ateq-U-SSA+vuq
atiussavorli	ateq-U-SSA+vuq+LI
atiussavorlu	ateq-U-SSA+vuq+LU
atiuvoq	ateq-U+vuq
atiuvorli	ateq-U+vuq+LI
atiuvorlu	ateq-U+vuq+LU
ilinniartippassi	ilinniartip+vassi
ilinniartippassili	ilinniartip+vassi+LI
ilinniartippassilu	ilinniartip+vassi+LU
ilinniartissavassi	ilinniartip-SSA+vassi
ilinniartissavassili	ilinniartip-SSA+vassi+LI
ilinniartissavassilu	ilinniartip-SSA+vassi+LU
illoqarpoq	illu-QAR+vuq
illoqarporli	illu-QAR+vuq+LI
illoqarporlu	illu-QAR+vuq+LU
illoqarpunga	illu-QAR+vuŋa
illoqarpungali	illu-QAR+vuŋa+LI
illoqarpungalu	illu-QAR+vuŋa+LU
illoqassavoq	illu-QAR-SSA+vuq
illoqassavorli	illu-QAR-SSA+vuq+LI
illoqassavorlu	illu-QAR-SSA+vuq+LU
illoqassavunga	illu-QAR-SSA+vuŋa
illoqassavungali	illu-QAR-SSA+vuŋa+LI
illoqassavungalu	illu-QAR-SSA+vuŋa+LU
illu	illu
illuga	illu+ga
illugali	illu+ga+LI
illugalu	illu+ga+LU
illuli	illu+LI
illulu	illu+LU
illumi	illu-mi
illumik	illu-mik
illumili	illu-mi+LI
illumilli	illu-mik+LI
illumillu	illu-mik+LU
illumioqarpoq	illu+MIU-QAR+vuq
illumioqarporli	illu+MIU-QAR+vuq+LI
illumioqarporlu	illu+MIU-QAR+vuq+LU
illumioqassavoq	illu+MIU-QAR-SSA+vuq
illumioqassavorli	illu+MIU-QAR-SSA+vuq+LI
illumioqassavorlu	illu+MIU-QAR-SSA+vuq+LU
illumiu	illu+MIU
illumiuli	illu+MIU+LI
illumiumi	illu+MIU-mi
illumiumik	illu+MIU-mik
illumiumili	illu+MIU-mi+LI
illumiumillu	illu+MIU-mik+LU
illuussavoq	illu-U-SSA+vuq
illuussavorli	illu-U-SSA+vuq+LI
illuuvoq	illu-U+vuq
illuuvorli	illu-U+vuq+LI
illuuvorlu	illu-U+vuq+LU
kalaaleq	kalaaleq
kalaaleqarpoq	kalaaleq-QAR+vuq
kalaaleqarporli	kalaaleq-QAR+vuq+LI
kalaaleqarporlu	kalaaleq-QAR+vuq+LU
kalaaleqassavoq	kalaaleq-QAR-SSA+vuq
kalaaleqassavorli	kalaaleq-QAR-SSA+vuq+LI
kalaaleqassavorlu	kalaaleq-QAR-SSA+vuq+LU
kalaalerli	kalaaleq+LI
kalaalerlu	kalaaleq+LU
kalaaliussavoq	kalaaleq-U-SSA+vuq
kalaaliussavorli	kalaaleq-U-SSA+vuq+LI
kalaaliussavorlu	kalaaleq-U-SSA+vuq+LU
kalaaliussavunga	kalaaleq-U-SSA+vuŋa
kalaaliussavungali	kalaaleq-U-SSA+vuŋa+LI
kalaaliussavungalu	kalaaleq-U-SSA+vuŋa+LU
kalaaliuvoq	kalaaleq-U+vuq
kalaaliuvorli	kalaaleq-U+vuq+LI
kalaaliuvorlu	kalaaleq-U+vuq+LU
kalaaliuvunga	kalaaleq-U+vuŋa
kalaaliuvungali	kalaaleq-U+vuŋa+LI
kalaaliuvungalu	kalaaleq-U+vuŋa+LU
kalaallimi	kalaaleq-mi
kalaallimik	kalaaleq-mik
kalaallimili	kalaaleq-mi+LI
kalaallimilli	kalaaleq-mik+LI
kalaallimillu	kalaaleq-mik+LU
kalaallimilu	kalaaleq-mi+LU
kalaallisulli	kalaallisut+LI
kalaallisullu	kalaallisut+LU
kalaallisut	kalaallisut
najugaavoq	najugaq-U+vuq
najugaavorli	najugaq-U+vuq+LI
najugaavorlu	najugaq-U+vuq+LU
najugaq	najugaq
najugaqarpoq	najugaq-QAR+vuq
najugaqarporli	najugaq-QAR+vuq+LI
najugaqarporlu	najugaq-QAR+vuq+LU
najugaqarpunga	najugaq-QAR+vuŋa
najugaqarpungali	najugaq-QAR+vuŋa+LI
najugaqarpungalu	najugaq-QAR+vuŋa+LU
najugaqassavoq	najugaq-QAR-SSA+vuq
najugaqassavorli	najugaq-QAR-SSA+vuq+LI
najugaqassavorlu	najugaq-QAR-SSA+vuq+LU
najugaqassavunga	najugaq-QAR-SSA+vuŋa
najugaqassavungali	najugaq-QAR-SSA+vuŋa+LI
najugaqassavungalu	najugaq-QAR-SSA+vuŋa+LU
najugara	najugaq+ga
najugarali	najugaq+ga+LI
najugaralu	najugaq+ga+LU
najugarli	najugaq+LI
najugarlu	najugaq+LU
najukkami	najugaq-mi
najukkamik	najugaq-mik
najukkamili	najugaq-mi+LI
najukkamilli	najugaq-mik+LI
najukkamillu	najugaq-mik+LU
najukkamilu	najugaq-mi+LU
nuliaassavoq	nuliaq-U-SSA+vuq
nuliaassavorlu	nuliaq-U-SSA+vuq+LU
nuliaassavunga	nuliaq-U-SSA+vuŋa
nuliaassavungali	nuliaq-U-SSA+vuŋa+LI
nuliaassavungalu	nuliaq-U-SSA+vuŋa+LU
nuliaavoq	nuliaq-U+vuq
nuliaavorli	nuliaq-U+vuq+LI
nuliaavorlu	nuliaq-U+vuq+LU
nuliaavunga	nuliaq-U+vuŋa
nuliaavungalu	nuliaq-U+vuŋa+LU
nuliami	nuliaq-mi
nuliamik	nuliaq-mik
nuliamili	nuliaq-mi+LI
nuliamilli	nuliaq-mik+LI
nuliamillu	nuliaq-mik+LU
nuliamilu	nuliaq-mi+LU
nuliaq	nuliaq
nuliaqarpoq	nuliaq-QAR+vuq
nuliaqarporli	nuliaq-QAR+vuq+LI
nuliaqarporlu	nuliaq-QAR+vuq+LU
nuliaqarpunga	nuliaq-QAR+vuŋa
nuliaqarpungali	nuliaq-QAR+vuŋa+LI
nuliaqarpungalu	nuliaq-QAR+vuŋa+LU
nuliaqassavoq	nuliaq-QAR-SSA+vuq
nuliaqassavorli	nuliaq-QAR-SSA+vuq+LI
nuliaqassavorlu	nuliaq-QAR-SSA+vuq+LU
nuliaqassavunga	nuliaq-QAR-SSA+vuŋa
nuliaqassavungali	nuliaq-QAR-SSA+vuŋa+LI
nuliaqassavungalu	nuliaq-QAR-SSA+vuŋa+LU
nuliara	nuliaq+ga
nuliarali	nuliaq+ga+LI
nuliaralu	nuliaq+ga+LU
nuliarli	nuliaq+LI
nuliarlu	nuliaq+LU
qallunaajussavoq	qallunaaq-U-SSA+vuq
qallunaajussavorli	qallunaaq-U-SSA+vuq+LI
qallunaajussavunga	qallunaaq-U-SSA+vuŋa
qallunaajussavungali	qallunaaq-U-SSA+vuŋa+LI
qallunaajussavungalu	qallunaaq-U-SSA+vuŋa+LU
qallunaajuvoq	qallunaaq-U+vuq
qallunaajuvorli	qallunaaq-U+vuq+LI
qallunaajuvorlu	qallunaaq-U+vuq+LU
qallunaajuvunga	qallunaaq-U+vuŋa
qallunaajuvungali	qallunaaq-U+vuŋa+LI
qallunaajuvungalu	qallunaaq-U+vuŋa+LU
qallunaami	qallunaaq-mi
qallunaamik	qallunaaq-mik
qallunaamili	qallunaaq-mi+LI
qallunaamilli	qallunaaq-mik+LI
qallunaamillu	qallunaaq-mik+LU
qallunaamilu	qallunaaq-mi+LU
qallunaaq	qallunaaq
qallunaaqarpoq	qallunaaq-QAR+vuq
qallunaaqarporli	qallunaaq-QAR+vuq+LI
qallunaaqarporlu	qallunaaq-QAR+vuq+LU
qallunaaqassavoq	qallunaaq-QAR-SSA+vuq
qallunaaqassavorli	qallunaaq-QAR-SSA+vuq+LI
qallunaaqassavorlu	qallunaaq-QAR-SSA+vuq+LU
qallunaarli	qallunaaq+LI
qallunaarlu	qallunaaq+LU
sulissavoq	suli-SSA+vuq
sulissavorli	suli-SSA+vuq+LI
sulissavorlu	suli-SSA+vuq+LU
sulissavunga	suli-SSA+vuŋa
sulissavungali	suli-SSA+vuŋa+LI
sulissavungalu	suli-SSA+vuŋa+LU
sulivoq	suli+vuq
sulivorli	suli+vuq+LI
sulivorlu	suli+vuq+LU
sulivunga	suli+vuŋa
sulivungali	suli+vuŋa+LI
sulivungalu	suli+vuŋa+LU
taanna	taanna
taannali	taanna+LI
taannalu	taanna+LU
uanga	uanga
uangali	uanga+LI
uangalu	uanga+LU
