#Corpus til tredie øvelse - Nyt i lektion 5. Som ovenstående plus to Int-fleksiver og GUSUP
ateq+QAR+Sem/be_name+GUSUP+V+Ind+1Sg	ateqarusuppunga
ateq+QAR+Sem/be_name+GUSUP+V+Ind+3Sg	ateqarusuppoq
ateq+QAR+Sem/be_name+V+Int+2Sg	ateqarpit
ateq+QAR+Sem/be_name+GUSUP+V+Int+2Sg	ateqarusuppit
illu+iSem/build+QAR+Sem/lodge+GUSUP+V+Ind+1Sg	illoqarusuppunga
illu+iSem/build+QAR+Sem/lodge+GUSUP+V+Ind+3Sg	illoqarusuppoq
illu+iSem/build+QAR+Sem/lodge+V+Int+2Sg	illoqarpit
illu+iSem/build+QAR+Sem/lodge+GUSUP+V+Int+2Sg	illoqarusuppit
najugaq+QAR+Sem/lodge+GUSUP+V+Ind+1Sg	najugaqarusuppunga
najugaq+QAR+Sem/lodge+GUSUP+V+Ind+3Sg	najugaqarusuppoq
najugaq+QAR+Sem/lodge+V+Int+2Sg	najugaqarpit
najugaq+QAR+Sem/lodge+GUSUP+V+Int+2Sg	najugaqarusuppit
nuliaq+iSem/Hfam+QAR+GUSUP+V+Ind+1Sg	nuliaqarusuppunga
nuliaq+iSem/Hfam+QAR+GUSUP+V+Ind+3Sg	nuliaqarusuppoq
nuliaq+iSem/Hfam+QAR+V+Int+2Sg	nuliaqarpit
nuliaq+iSem/Hfam+QAR+GUSUP+V+Int+2Sg	nuliaqarusuppit
suli+Sem/work+GUSUP+V+Ind+1Sg	sulerusuppunga
suli+Sem/work+GUSUP+V+Ind+3Sg	sulerusuppoq
suli+Sem/work+V+Int+2Sg	sulivit
suli+Sem/work+GUSUP+V+Int+2Sg	sulerusuppit
taku+iSem/see+GUSUP+V+Ind+1Sg+3SgO	takorusuppara
taku+iSem/see+GUSUP+V+Int+2Sg+3SgO	takorusuppiuk
taku+Sem/see+V+Ind+1Sg+3SgO	takuara
taku+Sem/see+V+Int+2Sg+3Sg	takuiuk
ilinniar+TIP+iSem/teach+GUSUP+V+Ind+1Sg+3SgO	ilinniartikkusuppara
ilinniar+TIP+iSem/teach+GUSUP+V+Int+2Sg+3SgO	ilinniartikkusuppiuk
ilinniar+TIP+Sem/teach+V+Ind+1Sg+3SgO	ilinniartippara
ilinniar+TIP+Sem/teach+V+Int+2Sg+3SgO	ilinniartippiuk
naapip+iSem/encounter+GUSUP+V+Ind+1Sg+3SgO	naapikkusuppara
naapip+iSem/encounter+GUSUP+V+Int+2Sg+3SgO	naapikkusuppiuk
naapip+Sem/encounter+V+Ind+1Sg+3SgO	naapippara
naapip+Sem/encounter+V+Int+2Sg+3SgO	naapippiuk
