aappaagu	aappaagu<Partikel
aap	aap<Partikel
anaana	anaana<Ental<Absolut
anaanamut	anaana<Ental<Terminalis
anaananik	anaana<Flertal<Instrumentalis
anaanani	anaana<Flertal<Lokalis
anaanalerigaluarpugut	anaana-LIRI+GALUAR<Indikativ<vi
anaanalerigaluarpit	anaana-LIRI+GALUAR<Interrogativ<du
anaanalerigaluartunga	anaana-LIRI+GALUAR<Participium<jeg
anaanalerivoq	anaana-LIRI<Indikativ<han
anaanalerivunga	anaana-LIRI<Indikativ<jeg
anaanalerivugut	anaana-LIRI<Indikativ<vi
anaanalerivit	anaana-LIRI<Interrogativ<du
anaanalerisunga	anaana-LIRI<Participium<jeg
anaanalerisaraluarpoq	anaana-LIRI+TAR+GALUAR<Indikativ<han
anaanalerisaraluarpunga	anaana-LIRI+TAR+GALUAR<Indikativ<jeg
anaanalerisaraluarpugut	anaana-LIRI+TAR+GALUAR<Indikativ<vi
anaanalerisaraluarpit	anaana-LIRI+TAR+GALUAR<Interrogativ<du
anaanalerisaraluartunga	anaana-LIRI+TAR+GALUAR<Participium<jeg
anaanalerisarpoq	anaana-LIRI+TAR<Indikativ<han
anaanalerisarpunga	anaana-LIRI+TAR<Indikativ<jeg
anaanalerisarpugut	anaana-LIRI+TAR<Indikativ<vi
anaanalerisarpit	anaana-LIRI+TAR<Interrogativ<du
anaanalerisartunga	anaana-LIRI+TAR<Participium<jeg
anaananngoraluarpit	anaana-NNGUR+GALUAR<Interrogativ<du
anaananngoraluartunga	anaana-NNGUR+GALUAR<Participium<jeg
anaananngorpoq	anaana-NNGUR<Indikativ<han
anaananngorpunga	anaana-NNGUR<Indikativ<jeg
anaananngorpit	anaana-NNGUR<Interrogativ<du
anaananngortunga	anaana-NNGUR<Participium<jeg
anaananngortaraluarpoq	anaana-NNGUR+TAR+GALUAR<Indikativ<han
anaananngortaraluarpugut	anaana-NNGUR+TAR+GALUAR<Indikativ<vi
anaananngortaraluarpit	anaana-NNGUR+TAR+GALUAR<Interrogativ<du
anaananngortaraluartunga	anaana-NNGUR+TAR+GALUAR<Participium<jeg
anaananngortarpugut	anaana-NNGUR+TAR<Indikativ<vi
anaananngortarpit	anaana-NNGUR+TAR<Interrogativ<du
anaananngortartunga	anaana-NNGUR+TAR<Participium<jeg
ataata	ataata<Ental<Absolut
ataatamut	ataata<Ental<Terminalis
ataatanik	ataata<Flertal<Instrumentalis
ataatani	ataata<Flertal<Lokalis
ataatalerigaluarpoq	ataata-LIRI+GALUAR<Indikativ<han
ataatalerigaluarpunga	ataata-LIRI+GALUAR<Indikativ<jeg
ataatalerigaluarpit	ataata-LIRI+GALUAR<Interrogativ<du
ataatalerigaluartunga	ataata-LIRI+GALUAR<Participium<jeg
ataatalerivoq	ataata-LIRI<Indikativ<han
ataatalerivunga	ataata-LIRI<Indikativ<jeg
ataatalerivugut	ataata-LIRI<Indikativ<vi
ataatalerivit	ataata-LIRI<Interrogativ<du
ataatalerisunga	ataata-LIRI<Participium<jeg
ataatalerisaraluarpunga	ataata-LIRI+TAR+GALUAR<Indikativ<jeg
ataatalerisaraluarpugut	ataata-LIRI+TAR+GALUAR<Indikativ<vi
ataatalerisaraluarpit	ataata-LIRI+TAR+GALUAR<Interrogativ<du
ataatalerisaraluartunga	ataata-LIRI+TAR+GALUAR<Participium<jeg
ataatalerisarpit	ataata-LIRI+TAR<Interrogativ<du
ataatalerisartunga	ataata-LIRI+TAR<Participium<jeg
ataatanngoraluarpoq	ataata-NNGUR+GALUAR<Indikativ<han
ataatanngoraluarpit	ataata-NNGUR+GALUAR<Interrogativ<du
ataatanngoraluartunga	ataata-NNGUR+GALUAR<Participium<jeg
ataatanngorpunga	ataata-NNGUR<Indikativ<jeg
ataatanngorpugut	ataata-NNGUR<Indikativ<vi
ataatanngorpit	ataata-NNGUR<Interrogativ<du
ataatanngortunga	ataata-NNGUR<Participium<jeg
ataatanngortaraluarpoq	ataata-NNGUR+TAR+GALUAR<Indikativ<han
ataatanngortaraluarpunga	ataata-NNGUR+TAR+GALUAR<Indikativ<jeg
ataatanngortaraluarpugut	ataata-NNGUR+TAR+GALUAR<Indikativ<vi
ataatanngortaraluartunga	ataata-NNGUR+TAR+GALUAR<Participium<jeg
ataatanngortarpunga	ataata-NNGUR+TAR<Indikativ<jeg
ataatanngortarpugut	ataata-NNGUR+TAR<Indikativ<vi
ataatanngortarpit	ataata-NNGUR+TAR<Interrogativ<du
ataatanngortartunga	ataata-NNGUR+TAR<Participium<jeg
eqqaamagaluarpaat	eqqaama+GALUAR<Indikativ<DeHam
eqqaamagaluarpaannga	eqqaama+GALUAR<Indikativ<DeMig
eqqaamagaluarpiuk	eqqaama+GALUAR<Interrogativ<DuHam
eqqaamavaat	eqqaama<Indikativ<DeHam
eqqaamavaannga	eqqaama<Indikativ<DeMig
eqqaamaviuk	eqqaama<Interrogativ<DuHam
eqqaamasaraluarpaat	eqqaama+TAR+GALUAR<Indikativ<DeHam
eqqaamasaraluarpaannga	eqqaama+TAR+GALUAR<Indikativ<DeMig
eqqaamasaraluarpiuk	eqqaama+TAR+GALUAR<Interrogativ<DuHam
eqqaamasarpaat	eqqaama+TAR<Indikativ<DeHam
eqqaamasarpaannga	eqqaama+TAR<Indikativ<DeMig
eqqaamasarpiuk	eqqaama+TAR<Interrogativ<DuHam
eqqumiitsuliortoq	eqqumiitsuliortoq<Ental<Absolut
eqqumiitsuliortumut	eqqumiitsuliortoq<Ental<Terminalis
eqqumiitsuliortunik	eqqumiitsuliortoq<Flertal<Instrumentalis
eqqumiitsuliortuni	eqqumiitsuliortoq<Flertal<Lokalis
eqqumiitsuliortulerigaluarpunga	eqqumiitsuliortoq-LIRI+GALUAR<Indikativ<jeg
eqqumiitsuliortulerigaluarpugut	eqqumiitsuliortoq-LIRI+GALUAR<Indikativ<vi
eqqumiitsuliortulerigaluarpit	eqqumiitsuliortoq-LIRI+GALUAR<Interrogativ<du
eqqumiitsuliortulerigaluartunga	eqqumiitsuliortoq-LIRI+GALUAR<Participium<jeg
eqqumiitsuliortulerivoq	eqqumiitsuliortoq-LIRI<Indikativ<han
eqqumiitsuliortulerivunga	eqqumiitsuliortoq-LIRI<Indikativ<jeg
eqqumiitsuliortulerivugut	eqqumiitsuliortoq-LIRI<Indikativ<vi
eqqumiitsuliortulerivit	eqqumiitsuliortoq-LIRI<Interrogativ<du
eqqumiitsuliortulerisunga	eqqumiitsuliortoq-LIRI<Participium<jeg
eqqumiitsuliortulerisaraluarpunga	eqqumiitsuliortoq-LIRI+TAR+GALUAR<Indikativ<jeg
eqqumiitsuliortulerisaraluarpit	eqqumiitsuliortoq-LIRI+TAR+GALUAR<Interrogativ<du
eqqumiitsuliortulerisaraluartunga	eqqumiitsuliortoq-LIRI+TAR+GALUAR<Participium<jeg
eqqumiitsuliortulerisarpoq	eqqumiitsuliortoq-LIRI+TAR<Indikativ<han
eqqumiitsuliortulerisarpunga	eqqumiitsuliortoq-LIRI+TAR<Indikativ<jeg
eqqumiitsuliortulerisarpugut	eqqumiitsuliortoq-LIRI+TAR<Indikativ<vi
eqqumiitsuliortulerisartunga	eqqumiitsuliortoq-LIRI+TAR<Participium<jeg
eqqumiitsuliortunngoraluarpoq	eqqumiitsuliortoq-NNGUR+GALUAR<Indikativ<han
eqqumiitsuliortunngoraluarpunga	eqqumiitsuliortoq-NNGUR+GALUAR<Indikativ<jeg
eqqumiitsuliortunngoraluarpit	eqqumiitsuliortoq-NNGUR+GALUAR<Interrogativ<du
eqqumiitsuliortunngoraluartunga	eqqumiitsuliortoq-NNGUR+GALUAR<Participium<jeg
eqqumiitsuliortunngorpoq	eqqumiitsuliortoq-NNGUR<Indikativ<han
eqqumiitsuliortunngorpunga	eqqumiitsuliortoq-NNGUR<Indikativ<jeg
eqqumiitsuliortunngorpugut	eqqumiitsuliortoq-NNGUR<Indikativ<vi
eqqumiitsuliortunngorpit	eqqumiitsuliortoq-NNGUR<Interrogativ<du
eqqumiitsuliortunngortunga	eqqumiitsuliortoq-NNGUR<Participium<jeg
eqqumiitsuliortunngortaraluarpoq	eqqumiitsuliortoq-NNGUR+TAR+GALUAR<Indikativ<han
eqqumiitsuliortunngortaraluarpunga	eqqumiitsuliortoq-NNGUR+TAR+GALUAR<Indikativ<jeg
eqqumiitsuliortunngortaraluarpugut	eqqumiitsuliortoq-NNGUR+TAR+GALUAR<Indikativ<vi
eqqumiitsuliortunngortaraluarpit	eqqumiitsuliortoq-NNGUR+TAR+GALUAR<Interrogativ<du
eqqumiitsuliortunngortaraluartunga	eqqumiitsuliortoq-NNGUR+TAR+GALUAR<Participium<jeg
eqqumiitsuliortunngortarpoq	eqqumiitsuliortoq-NNGUR+TAR<Indikativ<han
eqqumiitsuliortunngortarpunga	eqqumiitsuliortoq-NNGUR+TAR<Indikativ<jeg
eqqumiitsuliortunngortarpugut	eqqumiitsuliortoq-NNGUR+TAR<Indikativ<vi
eqqumiitsuliortunngortarpit	eqqumiitsuliortoq-NNGUR+TAR<Interrogativ<du
eqqumiitsuliortunngortartunga	eqqumiitsuliortoq-NNGUR+TAR<Participium<jeg
ilinniaraluarpoq	ilinniar+GALUAR<Indikativ<han
ilinniaraluarpunga	ilinniar+GALUAR<Indikativ<jeg
ilinniaraluarpugut	ilinniar+GALUAR<Indikativ<vi
ilinniaraluarpit	ilinniar+GALUAR<Interrogativ<du
ilinniaraluartunga	ilinniar+GALUAR<Participium<jeg
ilinniarpoq	ilinniar<Indikativ<han
ilinniarpunga	ilinniar<Indikativ<jeg
ilinniarpugut	ilinniar<Indikativ<vi
ilinniarpit	ilinniar<Interrogativ<du
ilinniartunga	ilinniar<Participium<jeg
ilinniartaraluarpoq	ilinniar+TAR+GALUAR<Indikativ<han
ilinniartaraluarpunga	ilinniar+TAR+GALUAR<Indikativ<jeg
ilinniartaraluarpugut	ilinniar+TAR+GALUAR<Indikativ<vi
ilinniartaraluarpit	ilinniar+TAR+GALUAR<Interrogativ<du
ilinniartaraluartunga	ilinniar+TAR+GALUAR<Participium<jeg
ilinniartarpoq	ilinniar+TAR<Indikativ<han
ilinniartarpunga	ilinniar+TAR<Indikativ<jeg
ilinniartarpugut	ilinniar+TAR<Indikativ<vi
ilinniartarpit	ilinniar+TAR<Interrogativ<du
ilinniartartunga	ilinniar+TAR<Participium<jeg
ilinniartitsisoq	ilinniartitsisoq<Ental<Absolut
ilinniartitsisumut	ilinniartitsisoq<Ental<Terminalis
ilinniartitsisunik	ilinniartitsisoq<Flertal<Instrumentalis
ilinniartitsisuni	ilinniartitsisoq<Flertal<Lokalis
ilinniartitsisulerigaluarpit	ilinniartitsisoq-LIRI+GALUAR<Interrogativ<du
ilinniartitsisulerigaluartunga	ilinniartitsisoq-LIRI+GALUAR<Participium<jeg
ilinniartitsisulerivoq	ilinniartitsisoq-LIRI<Indikativ<han
ilinniartitsisulerivunga	ilinniartitsisoq-LIRI<Indikativ<jeg
ilinniartitsisulerivugut	ilinniartitsisoq-LIRI<Indikativ<vi
ilinniartitsisulerisunga	ilinniartitsisoq-LIRI<Participium<jeg
ilinniartitsisulerisaraluarpunga	ilinniartitsisoq-LIRI+TAR+GALUAR<Indikativ<jeg
ilinniartitsisunngoraluarpit	ilinniartitsisoq-NNGUR+GALUAR<Interrogativ<du
ilinniartitsisunngorpunga	ilinniartitsisoq-NNGUR<Indikativ<jeg
ilinniartitsisunngorpit	ilinniartitsisoq-NNGUR<Interrogativ<du
ilinniartitsisunngortunga	ilinniartitsisoq-NNGUR<Participium<jeg
ilinniartitsisunngortartunga	ilinniartitsisoq-NNGUR+TAR<Participium<jeg
Ilisimatusarfik	Ilisimatusarfik<Ental<Absolut
Ilisimatusarfimmut	Ilisimatusarfik<Ental<Terminalis
Ilisimatusarfinnik	Ilisimatusarfik<Flertal<Instrumentalis
Ilisimatusarfinni	Ilisimatusarfik<Flertal<Lokalis
Ilisimatusarfilerigaluarpoq	Ilisimatusarfik-LIRI+GALUAR<Indikativ<han
Ilisimatusarfilerigaluarpunga	Ilisimatusarfik-LIRI+GALUAR<Indikativ<jeg
Ilisimatusarfilerigaluarpugut	Ilisimatusarfik-LIRI+GALUAR<Indikativ<vi
Ilisimatusarfilerigaluarpit	Ilisimatusarfik-LIRI+GALUAR<Interrogativ<du
Ilisimatusarfilerigaluartunga	Ilisimatusarfik-LIRI+GALUAR<Participium<jeg
Ilisimatusarfilerivoq	Ilisimatusarfik-LIRI<Indikativ<han
Ilisimatusarfilerivunga	Ilisimatusarfik-LIRI<Indikativ<jeg
Ilisimatusarfilerivugut	Ilisimatusarfik-LIRI<Indikativ<vi
Ilisimatusarfilerivit	Ilisimatusarfik-LIRI<Interrogativ<du
Ilisimatusarfilerisunga	Ilisimatusarfik-LIRI<Participium<jeg
Ilisimatusarfilerisaraluarpoq	Ilisimatusarfik-LIRI+TAR+GALUAR<Indikativ<han
Ilisimatusarfilerisaraluarpunga	Ilisimatusarfik-LIRI+TAR+GALUAR<Indikativ<jeg
Ilisimatusarfilerisaraluarpugut	Ilisimatusarfik-LIRI+TAR+GALUAR<Indikativ<vi
Ilisimatusarfilerisaraluarpit	Ilisimatusarfik-LIRI+TAR+GALUAR<Interrogativ<du
Ilisimatusarfilerisaraluartunga	Ilisimatusarfik-LIRI+TAR+GALUAR<Participium<jeg
Ilisimatusarfilerisarpoq	Ilisimatusarfik-LIRI+TAR<Indikativ<han
Ilisimatusarfilerisarpunga	Ilisimatusarfik-LIRI+TAR<Indikativ<jeg
Ilisimatusarfilerisarpugut	Ilisimatusarfik-LIRI+TAR<Indikativ<vi
Ilisimatusarfilerisarpit	Ilisimatusarfik-LIRI+TAR<Interrogativ<du
Ilisimatusarfilerisartunga	Ilisimatusarfik-LIRI+TAR<Participium<jeg
Ilisimatusarfinngoraluarpoq	Ilisimatusarfik-NNGUR+GALUAR<Indikativ<han
Ilisimatusarfinngorpoq	Ilisimatusarfik-NNGUR<Indikativ<han
Ilisimatusarfinngortaraluarpoq	Ilisimatusarfik-NNGUR+TAR+GALUAR<Indikativ<han
Ilisimatusarfinngortarpoq	Ilisimatusarfik-NNGUR+TAR<Indikativ<han
kunngi	kunngi<Ental<Absolut
kunngimut	kunngi<Ental<Terminalis
kunnginik	kunngi<Flertal<Instrumentalis
kunngini	kunngi<Flertal<Lokalis
kunngilerigaluarpunga	kunngi-LIRI+GALUAR<Indikativ<jeg
kunngilerigaluarpugut	kunngi-LIRI+GALUAR<Indikativ<vi
kunngilerigaluarpit	kunngi-LIRI+GALUAR<Interrogativ<du
kunngilerigaluartunga	kunngi-LIRI+GALUAR<Participium<jeg
kunngilerivoq	kunngi-LIRI<Indikativ<han
kunngilerivunga	kunngi-LIRI<Indikativ<jeg
kunngilerivugut	kunngi-LIRI<Indikativ<vi
kunngilerivit	kunngi-LIRI<Interrogativ<du
kunngilerisunga	kunngi-LIRI<Participium<jeg
kunngilerisaraluarpoq	kunngi-LIRI+TAR+GALUAR<Indikativ<han
kunngilerisaraluarpunga	kunngi-LIRI+TAR+GALUAR<Indikativ<jeg
kunngilerisaraluarpugut	kunngi-LIRI+TAR+GALUAR<Indikativ<vi
kunngilerisaraluarpit	kunngi-LIRI+TAR+GALUAR<Interrogativ<du
kunngilerisaraluartunga	kunngi-LIRI+TAR+GALUAR<Participium<jeg
kunngilerisarpoq	kunngi-LIRI+TAR<Indikativ<han
kunngilerisarpunga	kunngi-LIRI+TAR<Indikativ<jeg
kunngilerisarpugut	kunngi-LIRI+TAR<Indikativ<vi
kunngilerisarpit	kunngi-LIRI+TAR<Interrogativ<du
kunngilerisartunga	kunngi-LIRI+TAR<Participium<jeg
kunnginngoraluarpoq	kunngi-NNGUR+GALUAR<Indikativ<han
kunnginngoraluarpunga	kunngi-NNGUR+GALUAR<Indikativ<jeg
kunnginngoraluarpugut	kunngi-NNGUR+GALUAR<Indikativ<vi
kunnginngoraluarpit	kunngi-NNGUR+GALUAR<Interrogativ<du
kunnginngoraluartunga	kunngi-NNGUR+GALUAR<Participium<jeg
kunnginngorpoq	kunngi-NNGUR<Indikativ<han
kunnginngorpunga	kunngi-NNGUR<Indikativ<jeg
kunnginngorpugut	kunngi-NNGUR<Indikativ<vi
kunnginngorpit	kunngi-NNGUR<Interrogativ<du
kunnginngortunga	kunngi-NNGUR<Participium<jeg
kunnginngortaraluarpoq	kunngi-NNGUR+TAR+GALUAR<Indikativ<han
kunnginngortaraluarpunga	kunngi-NNGUR+TAR+GALUAR<Indikativ<jeg
kunnginngortaraluarpugut	kunngi-NNGUR+TAR+GALUAR<Indikativ<vi
kunnginngortaraluarpit	kunngi-NNGUR+TAR+GALUAR<Interrogativ<du
kunnginngortaraluartunga	kunngi-NNGUR+TAR+GALUAR<Participium<jeg
kunnginngortarpoq	kunngi-NNGUR+TAR<Indikativ<han
kunnginngortarpunga	kunngi-NNGUR+TAR<Indikativ<jeg
kunnginngortarpit	kunngi-NNGUR+TAR<Interrogativ<du
kunnginngortartunga	kunngi-NNGUR+TAR<Participium<jeg
oqaaseq	oqaaseq<Ental<Absolut
oqaatsimut	oqaaseq<Ental<Terminalis
oqaatsinik	oqaaseq<Flertal<Instrumentalis
oqaatsini	oqaaseq<Flertal<Lokalis
oqaasilerigaluarpoq	oqaaseq-LIRI+GALUAR<Indikativ<han
oqaasilerigaluarpunga	oqaaseq-LIRI+GALUAR<Indikativ<jeg
oqaasilerigaluarpugut	oqaaseq-LIRI+GALUAR<Indikativ<vi
oqaasilerigaluarpit	oqaaseq-LIRI+GALUAR<Interrogativ<du
oqaasilerigaluartunga	oqaaseq-LIRI+GALUAR<Participium<jeg
oqaasilerivoq	oqaaseq-LIRI<Indikativ<han
oqaasilerivunga	oqaaseq-LIRI<Indikativ<jeg
oqaasilerivugut	oqaaseq-LIRI<Indikativ<vi
oqaasilerivit	oqaaseq-LIRI<Interrogativ<du
oqaasilerisunga	oqaaseq-LIRI<Participium<jeg
oqaasilerisaraluarpunga	oqaaseq-LIRI+TAR+GALUAR<Indikativ<jeg
oqaasilerisaraluarpugut	oqaaseq-LIRI+TAR+GALUAR<Indikativ<vi
oqaasilerisaraluarpit	oqaaseq-LIRI+TAR+GALUAR<Interrogativ<du
oqaasilerisaraluartunga	oqaaseq-LIRI+TAR+GALUAR<Participium<jeg
oqaasilerisarpunga	oqaaseq-LIRI+TAR<Indikativ<jeg
oqaasilerisarpugut	oqaaseq-LIRI+TAR<Indikativ<vi
oqaasilerisarpit	oqaaseq-LIRI+TAR<Interrogativ<du
oqaasilerisartunga	oqaaseq-LIRI+TAR<Participium<jeg
oqaasinngoraluarpoq	oqaaseq-NNGUR+GALUAR<Indikativ<han
oqaasinngoraluarpunga	oqaaseq-NNGUR+GALUAR<Indikativ<jeg
oqaasinngoraluarpugut	oqaaseq-NNGUR+GALUAR<Indikativ<vi
oqaasinngoraluarpit	oqaaseq-NNGUR+GALUAR<Interrogativ<du
oqaasinngoraluartunga	oqaaseq-NNGUR+GALUAR<Participium<jeg
oqaasinngorpunga	oqaaseq-NNGUR<Indikativ<jeg
oqaasinngorpugut	oqaaseq-NNGUR<Indikativ<vi
oqaasinngorpit	oqaaseq-NNGUR<Interrogativ<du
oqaasinngortunga	oqaaseq-NNGUR<Participium<jeg
oqaasinngortaraluarpoq	oqaaseq-NNGUR+TAR+GALUAR<Indikativ<han
oqaasinngortaraluarpunga	oqaaseq-NNGUR+TAR+GALUAR<Indikativ<jeg
oqaasinngortaraluarpugut	oqaaseq-NNGUR+TAR+GALUAR<Indikativ<vi
oqaasinngortaraluarpit	oqaaseq-NNGUR+TAR+GALUAR<Interrogativ<du
oqaasinngortaraluartunga	oqaaseq-NNGUR+TAR+GALUAR<Participium<jeg
oqaasinngortarpoq	oqaaseq-NNGUR+TAR<Indikativ<han
oqaasinngortarpunga	oqaaseq-NNGUR+TAR<Indikativ<jeg
oqaasinngortarpugut	oqaaseq-NNGUR+TAR<Indikativ<vi
oqaasinngortarpit	oqaaseq-NNGUR+TAR<Interrogativ<du
oqaasinngortartunga	oqaaseq-NNGUR+TAR<Participium<jeg
oqaasilerisoq	oqaasilerisoq<Ental<Absolut
oqaasilerisumut	oqaasilerisoq<Ental<Terminalis
oqaasilerisunik	oqaasilerisoq<Flertal<Instrumentalis
oqaasilerisuni	oqaasilerisoq<Flertal<Lokalis
oqaasilerisulerigaluartunga	oqaasilerisoq-LIRI+GALUAR<Participium<jeg
oqaasilerisulerivoq	oqaasilerisoq-LIRI<Indikativ<han
oqaasilerisulerivunga	oqaasilerisoq-LIRI<Indikativ<jeg
oqaasilerisulerivugut	oqaasilerisoq-LIRI<Indikativ<vi
oqaasilerisulerivit	oqaasilerisoq-LIRI<Interrogativ<du
oqaasilerisulerisunga	oqaasilerisoq-LIRI<Participium<jeg
oqaasilerisulerisaraluarpit	oqaasilerisoq-LIRI+TAR+GALUAR<Interrogativ<du
oqaasilerisulerisarpugut	oqaasilerisoq-LIRI+TAR<Indikativ<vi
oqaasilerisulerisarpit	oqaasilerisoq-LIRI+TAR<Interrogativ<du
oqaasilerisulerisartunga	oqaasilerisoq-LIRI+TAR<Participium<jeg
oqaasilerisunngoraluarpit	oqaasilerisoq-NNGUR+GALUAR<Interrogativ<du
oqaasilerisunngorpugut	oqaasilerisoq-NNGUR<Indikativ<vi
oqaasilerisunngorpit	oqaasilerisoq-NNGUR<Interrogativ<du
oqaasilerisunngortunga	oqaasilerisoq-NNGUR<Participium<jeg
oqaasilerisunngortaraluarpoq	oqaasilerisoq-NNGUR+TAR+GALUAR<Indikativ<han
oqaasilerisunngortaraluartunga	oqaasilerisoq-NNGUR+TAR+GALUAR<Participium<jeg
oqaasilerisunngortarpunga	oqaasilerisoq-NNGUR+TAR<Indikativ<jeg
oqaasilerisunngortarpit	oqaasilerisoq-NNGUR+TAR<Interrogativ<du
oqaasilerisunngortartunga	oqaasilerisoq-NNGUR+TAR<Participium<jeg
piareeraluarpoq	piareer+GALUAR<Indikativ<han
piareeraluarpunga	piareer+GALUAR<Indikativ<jeg
piareeraluarpugut	piareer+GALUAR<Indikativ<vi
piareeraluarpit	piareer+GALUAR<Interrogativ<du
piareeraluartunga	piareer+GALUAR<Participium<jeg
piareerpoq	piareer<Indikativ<han
piareerpunga	piareer<Indikativ<jeg
piareerpugut	piareer<Indikativ<vi
piareerpit	piareer<Interrogativ<du
piareertunga	piareer<Participium<jeg
piareertaraluarpoq	piareer+TAR+GALUAR<Indikativ<han
piareertaraluarpunga	piareer+TAR+GALUAR<Indikativ<jeg
piareertaraluarpugut	piareer+TAR+GALUAR<Indikativ<vi
piareertaraluarpit	piareer+TAR+GALUAR<Interrogativ<du
piareertaraluartunga	piareer+TAR+GALUAR<Participium<jeg
piareertarpoq	piareer+TAR<Indikativ<han
piareertarpunga	piareer+TAR<Indikativ<jeg
piareertarpugut	piareer+TAR<Indikativ<vi
piareertarpit	piareer+TAR<Interrogativ<du
piareertartunga	piareer+TAR<Participium<jeg
SULI	SULI<Partikel
taagaluarpaat	taa+GALUAR<Indikativ<DeHam
taagaluarpaannga	taa+GALUAR<Indikativ<DeMig
taagaluarpiuk	taa+GALUAR<Interrogativ<DuHam
taavaat	taa<Indikativ<DeHam
taavaannga	taa<Indikativ<DeMig
taaviuk	taa<Interrogativ<DuHam
taasaraluarpaat	taa+TAR+GALUAR<Indikativ<DeHam
taasaraluarpaannga	taa+TAR+GALUAR<Indikativ<DeMig
taasaraluarpiuk	taa+TAR+GALUAR<Interrogativ<DuHam
taasarpaat	taa+TAR<Indikativ<DeHam
taasarpaannga	taa+TAR<Indikativ<DeMig
taasarpiuk	taa+TAR<Interrogativ<DuHam
tamarmik	tamarmik<Adjektiv
tassa	tassa<Partikel
tutsiuteqqikkaluarpoq	tutsiuteqqip+GALUAR<Indikativ<han
tutsiuteqqikkaluarpunga	tutsiuteqqip+GALUAR<Indikativ<jeg
tutsiuteqqikkaluarpugut	tutsiuteqqip+GALUAR<Indikativ<vi
tutsiuteqqikkaluarpit	tutsiuteqqip+GALUAR<Interrogativ<du
tutsiuteqqikkaluartunga	tutsiuteqqip+GALUAR<Participium<jeg
tutsiuteqqippoq	tutsiuteqqip<Indikativ<han
tutsiuteqqippunga	tutsiuteqqip<Indikativ<jeg
tutsiuteqqippugut	tutsiuteqqip<Indikativ<vi
tutsiuteqqippit	tutsiuteqqip<Interrogativ<du
tutsiuteqqittunga	tutsiuteqqip<Participium<jeg
tutsiuteqqittaraluarpoq	tutsiuteqqip+TAR+GALUAR<Indikativ<han
tutsiuteqqittaraluarpunga	tutsiuteqqip+TAR+GALUAR<Indikativ<jeg
tutsiuteqqittaraluarpugut	tutsiuteqqip+TAR+GALUAR<Indikativ<vi
tutsiuteqqittaraluarpit	tutsiuteqqip+TAR+GALUAR<Interrogativ<du
tutsiuteqqittaraluartunga	tutsiuteqqip+TAR+GALUAR<Participium<jeg
tutsiuteqqittarpoq	tutsiuteqqip+TAR<Indikativ<han
tutsiuteqqittarpunga	tutsiuteqqip+TAR<Indikativ<jeg
tutsiuteqqittarpugut	tutsiuteqqip+TAR<Indikativ<vi
tutsiuteqqittarpit	tutsiuteqqip+TAR<Interrogativ<du
tutsiuteqqittartunga	tutsiuteqqip+TAR<Participium<jeg
ukioq	ukioq<Ental<Absolut
ukiumut	ukioq<Ental<Terminalis
ukiunik	ukioq<Flertal<Instrumentalis
ukiuni	ukioq<Flertal<Lokalis
ukiulerigaluarpoq	ukioq-LIRI+GALUAR<Indikativ<han
ukiulerigaluarpunga	ukioq-LIRI+GALUAR<Indikativ<jeg
ukiulerigaluarpugut	ukioq-LIRI+GALUAR<Indikativ<vi
ukiulerigaluarpit	ukioq-LIRI+GALUAR<Interrogativ<du
ukiulerigaluartunga	ukioq-LIRI+GALUAR<Participium<jeg
ukiulerivoq	ukioq-LIRI<Indikativ<han
ukiulerivunga	ukioq-LIRI<Indikativ<jeg
ukiulerivugut	ukioq-LIRI<Indikativ<vi
ukiulerivit	ukioq-LIRI<Interrogativ<du
ukiulerisunga	ukioq-LIRI<Participium<jeg
ukiulerisaraluarpunga	ukioq-LIRI+TAR+GALUAR<Indikativ<jeg
ukiulerisaraluarpugut	ukioq-LIRI+TAR+GALUAR<Indikativ<vi
ukiulerisaraluarpit	ukioq-LIRI+TAR+GALUAR<Interrogativ<du
ukiulerisaraluartunga	ukioq-LIRI+TAR+GALUAR<Participium<jeg
ukiulerisarpoq	ukioq-LIRI+TAR<Indikativ<han
ukiulerisarpunga	ukioq-LIRI+TAR<Indikativ<jeg
ukiulerisarpugut	ukioq-LIRI+TAR<Indikativ<vi
ukiulerisarpit	ukioq-LIRI+TAR<Interrogativ<du
ukiulerisartunga	ukioq-LIRI+TAR<Participium<jeg
ukiunngoraluarpoq	ukioq-NNGUR+GALUAR<Indikativ<han
ukiunngorpoq	ukioq-NNGUR<Indikativ<han
ukiunngortaraluarpoq	ukioq-NNGUR+TAR+GALUAR<Indikativ<han
ukiunngortarpoq	ukioq-NNGUR+TAR<Indikativ<han
