aamma	aamma<Partikel
aammali	aamma<Partikel+LI
aammalu	aamma<Partikel+LU
aappaagu	aappaagu<Partikel
aappaaguli	aappaagu<Partikel+LI
aap	aap<Partikel
aalli	aap<Partikel+LI
aallu	aap<Partikel+LU
Aasiaat	Aasiaat<Absolut
Aasiaalli	Aasiaat<Absolut+LI
Aasiaallu	Aasiaat<Absolut+LU
Aasiannik	Aasiaat<Instrumentalis
Aasiannilli	Aasiaat<Instrumentalis+LI
Aasiannillu	Aasiaat<Instrumentalis+LU
Aasianni	Aasiaat<Lokalis
Aasiannili	Aasiaat<Lokalis+LI
Aasiannilu	Aasiaat<Lokalis+LU
Aasiammiulu	Aasiaat+MIU<ental<Absolut+LU
Aasiammiumi	Aasiaat+MIU<ental<Lokalis
Aasiammiunik	Aasiaat+MIU<flertal<Instrumentalis
Aasiammiunilli	Aasiaat+MIU<flertal<Instrumentalis+LI
Aasiammiuni	Aasiaat+MIU<flertal<Lokalis
Aasiammiulerigaluarpit	Aasiaat+MIU-LIRI+GALUAR<Interrogativ<du
Aasiammiulerivunga	Aasiaat+MIU-LIRI<Indikativ<jeg
Aasiammiulerivit	Aasiaat+MIU-LIRI<Interrogativ<du
Aasiammiulerissasunga	Aasiaat+MIU-LIRI-SSA<Participium<jeg
Aasiammiulerisaraluartunga	Aasiaat+MIU-LIRI+TAR+GALUAR<Participium<jeg
Aasiammiulerisassavit	Aasiaat+MIU-LIRI+TAR-SSA<Interrogativ<du
Aasiammiulerisassasunga	Aasiaat+MIU-LIRI+TAR-SSA<Participium<jeg
Aasiammiunngortassagaluartunga	Aasiaat+MIU-NNGUR+TAR-SSA+GALUAR<Participium<jeg
Aasiammioqarpoq	Aasiaat+MIU-QAR<Indikativ<han
Aasiammioqarporli	Aasiaat+MIU-QAR<Indikativ<han+LI
Aasiammioqarporlu	Aasiaat+MIU-QAR<Indikativ<han+LU
Aasiammiuugaluarpoq	Aasiaat+MIU-U+GALUAR<Indikativ<han
Aasiammiuuvugulli	Aasiaat+MIU-U<Indikativ<vi+LI
Aasiammiuuit	Aasiaat+MIU-U<Interrogativ<du
Aasiammiuusungali	Aasiaat+MIU-U<Participium<jeg+LI
Aasiammiuussavit	Aasiaat+MIU-U-SSA<Interrogativ<du
Aasiammiuusartunga	Aasiaat+MIU-U+TAR<Participium<jeg
Aasiammiuusassagaluartungali	Aasiaat+MIU-U+TAR-SSA+GALUAR<Participium<jeg+LI
Aasiammiuusassavit	Aasiaat+MIU-U+TAR-SSA<Interrogativ<du
akisooq	akisooq<ental<Absolut
akisoorli	akisooq<ental<Absolut+LI
akisoorlu	akisooq<ental<Absolut+LU
akisuumik	akisooq<ental<Instrumentalis
akisuumilli	akisooq<ental<Instrumentalis+LI
akisuumi	akisooq<ental<Lokalis
akisuumili	akisooq<ental<Lokalis+LI
akisuumullu	akisooq<ental<Terminalis+LU
akisuunik	akisooq<flertal<Instrumentalis
akisuunilli	akisooq<flertal<Instrumentalis+LI
akisuunillu	akisooq<flertal<Instrumentalis+LU
akisuuni	akisooq<flertal<Lokalis
akisuunili	akisooq<flertal<Lokalis+LI
akisuunngoraluarpoq	akisooq-NNGUR+GALUAR<Indikativ<han
akisuunngoraluarporli	akisooq-NNGUR+GALUAR<Indikativ<han+LI
akisuunngussagaluarporli	akisooq-NNGUR-SSA+GALUAR<Indikativ<han+LI
akisuunngussavorli	akisooq-NNGUR-SSA<Indikativ<han+LI
akisuunngortassasungali	akisooq-NNGUR+TAR-SSA<Participium<jeg+LI
akisooqaraluarporli	akisooq-QAR+GALUAR<Indikativ<han+LI
akisooqarporli	akisooq-QAR<Indikativ<han+LI
akisooqassagaluarpoq	akisooq-QAR-SSA+GALUAR<Indikativ<han
akisooqassagaluarporli	akisooq-QAR-SSA+GALUAR<Indikativ<han+LI
akisooqassagaluarporlu	akisooq-QAR-SSA+GALUAR<Indikativ<han+LU
akisooqassavorli	akisooq-QAR-SSA<Indikativ<han+LI
akisooqartaraluarpoq	akisooq-QAR+TAR+GALUAR<Indikativ<han
akisooqartassagaluarpit	akisooq-QAR+TAR-SSA+GALUAR<Interrogativ<du
akisooqartassagaluartunga	akisooq-QAR+TAR-SSA+GALUAR<Participium<jeg
akisooqartassavit	akisooq-QAR+TAR-SSA<Interrogativ<du
akisuujugaluarporlu	akisooq-U+GALUAR<Indikativ<han+LU
akisuujugaluartunga	akisooq-U+GALUAR<Participium<jeg
akisuujuvorli	akisooq-U<Indikativ<han+LI
akisuujuvunga	akisooq-U<Indikativ<jeg
akisuujussagaluarpit	akisooq-U-SSA+GALUAR<Interrogativ<du
akisuujussavorli	akisooq-U-SSA<Indikativ<han+LI
akisuujussasunga	akisooq-U-SSA<Participium<jeg
akisuujusaraluarporli	akisooq-U+TAR+GALUAR<Indikativ<han+LI
akisuujusaraluartunga	akisooq-U+TAR+GALUAR<Participium<jeg
akisuujusarpugut	akisooq-U+TAR<Indikativ<vi
akisuujusassagaluartunga	akisooq-U+TAR-SSA+GALUAR<Participium<jeg
anaanagali	anaana<ental<Absolut<min+LI
anaanamilli	anaana<ental<Instrumentalis+LI
anaanamili	anaana<ental<Lokalis+LI
anaanani	anaana<flertal<Lokalis
anaananili	anaana<flertal<Lokalis+LI
anaanalerigaluarpit	anaana-LIRI+GALUAR<Interrogativ<du
anaanalerivungali	anaana-LIRI<Indikativ<jeg+LI
anaanalerisungalu	anaana-LIRI<Participium<jeg+LU
anaanalerisartunga	anaana-LIRI+TAR<Participium<jeg
anaanamiuni	anaana+MIU<flertal<Lokalis
anaanamiunilu	anaana+MIU<flertal<Lokalis+LU
anaanamiulerigaluarpungalu	anaana+MIU-LIRI+GALUAR<Indikativ<jeg+LU
anaanamiunngoraluartunga	anaana+MIU-NNGUR+GALUAR<Participium<jeg
anaanamioqarpoq	anaana+MIU-QAR<Indikativ<han
anaanamioqarporli	anaana+MIU-QAR<Indikativ<han+LI
anaanamiuugaluartunga	anaana+MIU-U+GALUAR<Participium<jeg
anaanamiuuvorli	anaana+MIU-U<Indikativ<han+LI
anaanamiuuvunga	anaana+MIU-U<Indikativ<jeg
anaanamiuussagaluartunga	anaana+MIU-U-SSA+GALUAR<Participium<jeg
anaanamiuussavunga	anaana+MIU-U-SSA<Indikativ<jeg
anaanamiuussavugulli	anaana+MIU-U-SSA<Indikativ<vi+LI
anaanamiuusarpit	anaana+MIU-U+TAR<Interrogativ<du
anaanamiuusassagaluartungalu	anaana+MIU-U+TAR-SSA+GALUAR<Participium<jeg+LU
anaanamiuusassavit	anaana+MIU-U+TAR-SSA<Interrogativ<du
anaananngoraluarpit	anaana-NNGUR+GALUAR<Interrogativ<du
anaananngussagaluarpit	anaana-NNGUR-SSA+GALUAR<Interrogativ<du
anaananngortassavorli	anaana-NNGUR+TAR-SSA<Indikativ<han+LI
anaanaqaraluartunga	anaana-QAR+GALUAR<Participium<jeg
anaanaqartunga	anaana-QAR<Participium<jeg
anaanaqassagaluartunga	anaana-QAR-SSA+GALUAR<Participium<jeg
anaanaqassavungali	anaana-QAR-SSA<Indikativ<jeg+LI
anaanaqassasunga	anaana-QAR-SSA<Participium<jeg
anaanaqartaraluarpunga	anaana-QAR+TAR+GALUAR<Indikativ<jeg
anaanaasunga	anaana-U<Participium<jeg
anaanaassagaluarpugullu	anaana-U-SSA+GALUAR<Indikativ<vi+LU
ataata	ataata<ental<Absolut
ataatagali	ataata<ental<Absolut<min+LI
ataatagalu	ataata<ental<Absolut<min+LU
ataatanik	ataata<flertal<Instrumentalis
ataatanillu	ataata<flertal<Instrumentalis+LU
ataatani	ataata<flertal<Lokalis
ataatanili	ataata<flertal<Lokalis+LI
ataatalerisaraluarpit	ataata-LIRI+TAR+GALUAR<Interrogativ<du
ataatalerisassasunga	ataata-LIRI+TAR-SSA<Participium<jeg
ataatamiumut	ataata+MIU<ental<Terminalis
ataatamiulerivugullu	ataata+MIU-LIRI<Indikativ<vi+LU
ataatamiulerisarpugut	ataata+MIU-LIRI+TAR<Indikativ<vi
ataatamioqarporli	ataata+MIU-QAR<Indikativ<han+LI
ataatamioqarporlu	ataata+MIU-QAR<Indikativ<han+LU
ataatamiuuvunga	ataata+MIU-U<Indikativ<jeg
ataatamiuusaraluarpit	ataata+MIU-U+TAR+GALUAR<Interrogativ<du
ataatamiuusartunga	ataata+MIU-U+TAR<Participium<jeg
ataatanngorpugulli	ataata-NNGUR<Indikativ<vi+LI
ataatanngussagaluarporlu	ataata-NNGUR-SSA+GALUAR<Indikativ<han+LU
ataatanngussavorlu	ataata-NNGUR-SSA<Indikativ<han+LU
ataataqartunga	ataata-QAR<Participium<jeg
ataataagaluartungalu	ataata-U+GALUAR<Participium<jeg+LU
ataataavugut	ataata-U<Indikativ<vi
ateqartungali	ateqar<Participium<jeg+LI
ateqassavit	ateqar-SSA<Interrogativ<du
ateq	ateq<ental<Absolut
atermi	ateq<ental<Lokalis
atermulli	ateq<ental<Terminalis+LI
aterni	ateq<flertal<Lokalis
atilerigaluarpoq	ateq-LIRI+GALUAR<Indikativ<han
atilerigaluarpunga	ateq-LIRI+GALUAR<Indikativ<jeg
atilerivungali	ateq-LIRI<Indikativ<jeg+LI
atilerissasungali	ateq-LIRI-SSA<Participium<jeg+LI
atilerisaraluarpit	ateq-LIRI+TAR+GALUAR<Interrogativ<du
atilerisarpit	ateq-LIRI+TAR<Interrogativ<du
atermiunngortassagaluarpoq	ateq+MIU-NNGUR+TAR-SSA+GALUAR<Indikativ<han
atermiuuit	ateq+MIU-U<Interrogativ<du
atinngussagaluartungalu	ateq-NNGUR-SSA+GALUAR<Participium<jeg+LU
atinngussavunga	ateq-NNGUR-SSA<Indikativ<jeg
ateqartunga	ateq-QAR<Participium<jeg
ateqassagaluarpungali	ateq-QAR-SSA+GALUAR<Indikativ<jeg+LI
ateqassagaluarpugulli	ateq-QAR-SSA+GALUAR<Indikativ<vi+LI
ateqassavit	ateq-QAR-SSA<Interrogativ<du
ateqassasunga	ateq-QAR-SSA<Participium<jeg
ateqartaraluarpit	ateq-QAR+TAR+GALUAR<Interrogativ<du
atiuvungali	ateq-U<Indikativ<jeg+LI
atiuit	ateq-U<Interrogativ<du
atiussagaluartungali	ateq-U-SSA+GALUAR<Participium<jeg+LI
atiussavit	ateq-U-SSA<Interrogativ<du
atiusaraluarpit	ateq-U+TAR+GALUAR<Interrogativ<du
atiusarpunga	ateq-U+TAR<Indikativ<jeg
atiusarpit	ateq-U+TAR<Interrogativ<du
atiusassasungali	ateq-U+TAR-SSA<Participium<jeg+LI
Avanersuaq	Avanersuaq<Absolut
Avanersuarli	Avanersuaq<Absolut+LI
Avanersuarlu	Avanersuaq<Absolut+LU
Avanersuarmik	Avanersuaq<Instrumentalis
Avanersuarmilli	Avanersuaq<Instrumentalis+LI
Avanersuarmillu	Avanersuaq<Instrumentalis+LU
Avanersuarmi	Avanersuaq<Lokalis
Avanersuarmili	Avanersuaq<Lokalis+LI
Avanersuarmiuli	Avanersuaq+MIU<ental<Absolut+LI
Avanersuarmiunik	Avanersuaq+MIU<flertal<Instrumentalis
Avanersuarmiuni	Avanersuaq+MIU<flertal<Lokalis
Avanersuarmiunili	Avanersuaq+MIU<flertal<Lokalis+LI
Avanersuarmiulerivit	Avanersuaq+MIU-LIRI<Interrogativ<du
Avanersuarmiulerisaraluartunga	Avanersuaq+MIU-LIRI+TAR+GALUAR<Participium<jeg
Avanersuarmiulerisassavoq	Avanersuaq+MIU-LIRI+TAR-SSA<Indikativ<han
Avanersuarmiunngortunga	Avanersuaq+MIU-NNGUR<Participium<jeg
Avanersuarmiunngussagaluartungali	Avanersuaq+MIU-NNGUR-SSA+GALUAR<Participium<jeg+LI
Avanersuarmiunngussavit	Avanersuaq+MIU-NNGUR-SSA<Interrogativ<du
Avanersuarmiunngortarpugulli	Avanersuaq+MIU-NNGUR+TAR<Indikativ<vi+LI
Avanersuarmioqarpoq	Avanersuaq+MIU-QAR<Indikativ<han
Avanersuarmioqarporli	Avanersuaq+MIU-QAR<Indikativ<han+LI
Avanersuarmiuugaluarpit	Avanersuaq+MIU-U+GALUAR<Interrogativ<du
Avanersuarmiuugaluartunga	Avanersuaq+MIU-U+GALUAR<Participium<jeg
Avanersuarmiuuvunga	Avanersuaq+MIU-U<Indikativ<jeg
Avanersuarmiuuit	Avanersuaq+MIU-U<Interrogativ<du
Avanersuarmiuusunga	Avanersuaq+MIU-U<Participium<jeg
Avanersuarmiuusungali	Avanersuaq+MIU-U<Participium<jeg+LI
Avanersuarmiuussagaluarporlu	Avanersuaq+MIU-U-SSA+GALUAR<Indikativ<han+LU
Avanersuarmiuussagaluarpit	Avanersuaq+MIU-U-SSA+GALUAR<Interrogativ<du
Avanersuarmiuussavungali	Avanersuaq+MIU-U-SSA<Indikativ<jeg+LI
Avanersuarmiuussavit	Avanersuaq+MIU-U-SSA<Interrogativ<du
Avanersuarmiuusaraluarpit	Avanersuaq+MIU-U+TAR+GALUAR<Interrogativ<du
Avanersuarmiuusaraluartunga	Avanersuaq+MIU-U+TAR+GALUAR<Participium<jeg
Avanersuarmiuusarpugulli	Avanersuaq+MIU-U+TAR<Indikativ<vi+LI
Avanersuarmiuusartunga	Avanersuaq+MIU-U+TAR<Participium<jeg
Avanersuarmiuusassagaluarpit	Avanersuaq+MIU-U+TAR-SSA+GALUAR<Interrogativ<du
Avanersuarmiuusassagaluartungalu	Avanersuaq+MIU-U+TAR-SSA+GALUAR<Participium<jeg+LU
Avanersuarmulli	Avanersuaq<Terminalis+LI
Avanersuarmullu	Avanersuaq<Terminalis+LU
eqqaamagaluarpaalli	eqqaama+GALUAR<Indikativ<DeHam+LI
eqqaamagaluarpaannga	eqqaama+GALUAR<Indikativ<DeMig
eqqaamagaluarpaanngali	eqqaama+GALUAR<Indikativ<DeMig+LI
eqqaamagaluarpassi	eqqaama+GALUAR<Indikativ<JegJer
eqqaamagaluarpassili	eqqaama+GALUAR<Indikativ<JegJer+LI
eqqaamagaluarpiuk	eqqaama+GALUAR<Interrogativ<DuHam
eqqaamavaannga	eqqaama<Indikativ<DeMig
eqqaamavaanngali	eqqaama<Indikativ<DeMig+LI
eqqaamavassilu	eqqaama<Indikativ<JegJer+LU
eqqaamaviuk	eqqaama<Interrogativ<DuHam
eqqaamassagaluarpaat	eqqaama-SSA+GALUAR<Indikativ<DeHam
eqqaamassagaluarpassi	eqqaama-SSA+GALUAR<Indikativ<JegJer
eqqaamassagaluarpiuk	eqqaama-SSA+GALUAR<Interrogativ<DuHam
eqqaamassavaat	eqqaama-SSA<Indikativ<DeHam
eqqaamassavaallu	eqqaama-SSA<Indikativ<DeHam+LU
eqqaamassavaannga	eqqaama-SSA<Indikativ<DeMig
eqqaamassavaanngali	eqqaama-SSA<Indikativ<DeMig+LI
eqqaamassavassi	eqqaama-SSA<Indikativ<JegJer
eqqaamassavassili	eqqaama-SSA<Indikativ<JegJer+LI
eqqaamassavassilu	eqqaama-SSA<Indikativ<JegJer+LU
eqqaamassaviuk	eqqaama-SSA<Interrogativ<DuHam
eqqaamasaraluarpaat	eqqaama+TAR+GALUAR<Indikativ<DeHam
eqqaamasaraluarpaanngali	eqqaama+TAR+GALUAR<Indikativ<DeMig+LI
eqqaamasaraluarpaanngalu	eqqaama+TAR+GALUAR<Indikativ<DeMig+LU
eqqaamasaraluarpassi	eqqaama+TAR+GALUAR<Indikativ<JegJer
eqqaamasaraluarpassili	eqqaama+TAR+GALUAR<Indikativ<JegJer+LI
eqqaamasaraluarpassilu	eqqaama+TAR+GALUAR<Indikativ<JegJer+LU
eqqaamasaraluarpiuk	eqqaama+TAR+GALUAR<Interrogativ<DuHam
eqqaamasarpassili	eqqaama+TAR<Indikativ<JegJer+LI
eqqaamasarpassilu	eqqaama+TAR<Indikativ<JegJer+LU
eqqaamasarpiuk	eqqaama+TAR<Interrogativ<DuHam
eqqaamasassagaluarpaat	eqqaama+TAR-SSA+GALUAR<Indikativ<DeHam
eqqaamasassagaluarpaanngali	eqqaama+TAR-SSA+GALUAR<Indikativ<DeMig+LI
eqqaamasassagaluarpassilu	eqqaama+TAR-SSA+GALUAR<Indikativ<JegJer+LU
eqqaamasassavaalli	eqqaama+TAR-SSA<Indikativ<DeHam+LI
eqqaamasassavaannga	eqqaama+TAR-SSA<Indikativ<DeMig
eqqaamasassavaanngali	eqqaama+TAR-SSA<Indikativ<DeMig+LI
eqqaamasassavassilu	eqqaama+TAR-SSA<Indikativ<JegJer+LU
eqqaamasassaviuk	eqqaama+TAR-SSA<Interrogativ<DuHam
eqqumiitsuliortoq	eqqumiitsuliortoq<ental<Absolut
eqqumiitsuliortorli	eqqumiitsuliortoq<ental<Absolut+LI
eqqumiitsuliortorlu	eqqumiitsuliortoq<ental<Absolut+LU
eqqumiitsuliortora	eqqumiitsuliortoq<ental<Absolut<min
eqqumiitsuliortorali	eqqumiitsuliortoq<ental<Absolut<min+LI
eqqumiitsuliortumilli	eqqumiitsuliortoq<ental<Instrumentalis+LI
eqqumiitsuliortumillu	eqqumiitsuliortoq<ental<Instrumentalis+LU
eqqumiitsuliortumi	eqqumiitsuliortoq<ental<Lokalis
eqqumiitsuliortumut	eqqumiitsuliortoq<ental<Terminalis
eqqumiitsuliortunik	eqqumiitsuliortoq<flertal<Instrumentalis
eqqumiitsuliortunilli	eqqumiitsuliortoq<flertal<Instrumentalis+LI
eqqumiitsuliortunillu	eqqumiitsuliortoq<flertal<Instrumentalis+LU
eqqumiitsuliortuni	eqqumiitsuliortoq<flertal<Lokalis
eqqumiitsuliortunili	eqqumiitsuliortoq<flertal<Lokalis+LI
eqqumiitsuliortulerigaluartungali	eqqumiitsuliortoq-LIRI+GALUAR<Participium<jeg+LI
eqqumiitsuliortulerivorli	eqqumiitsuliortoq-LIRI<Indikativ<han+LI
eqqumiitsuliortulerisunga	eqqumiitsuliortoq-LIRI<Participium<jeg
eqqumiitsuliortulerisaraluarpungalu	eqqumiitsuliortoq-LIRI+TAR+GALUAR<Indikativ<jeg+LU
eqqumiitsuliortulerisaraluarpugullu	eqqumiitsuliortoq-LIRI+TAR+GALUAR<Indikativ<vi+LU
eqqumiitsuliortulerisaraluarpit	eqqumiitsuliortoq-LIRI+TAR+GALUAR<Interrogativ<du
eqqumiitsuliortulerisassagaluarpit	eqqumiitsuliortoq-LIRI+TAR-SSA+GALUAR<Interrogativ<du
eqqumiitsuliortulerisassagaluartunga	eqqumiitsuliortoq-LIRI+TAR-SSA+GALUAR<Participium<jeg
eqqumiitsuliortulerisassagaluartungalu	eqqumiitsuliortoq-LIRI+TAR-SSA+GALUAR<Participium<jeg+LU
eqqumiitsuliortulerisassavoq	eqqumiitsuliortoq-LIRI+TAR-SSA<Indikativ<han
eqqumiitsuliortulerisassasunga	eqqumiitsuliortoq-LIRI+TAR-SSA<Participium<jeg
eqqumiitsuliortulerisassasungali	eqqumiitsuliortoq-LIRI+TAR-SSA<Participium<jeg+LI
eqqumiitsuliortormiunilli	eqqumiitsuliortoq+MIU<flertal<Instrumentalis+LI
eqqumiitsuliortormiuni	eqqumiitsuliortoq+MIU<flertal<Lokalis
eqqumiitsuliortormiulerigaluartungali	eqqumiitsuliortoq+MIU-LIRI+GALUAR<Participium<jeg+LI
eqqumiitsuliortormiulerissagaluarpunga	eqqumiitsuliortoq+MIU-LIRI-SSA+GALUAR<Indikativ<jeg
eqqumiitsuliortormiulerisarpungali	eqqumiitsuliortoq+MIU-LIRI+TAR<Indikativ<jeg+LI
eqqumiitsuliortormiunngorpoq	eqqumiitsuliortoq+MIU-NNGUR<Indikativ<han
eqqumiitsuliortormioqarpoq	eqqumiitsuliortoq+MIU-QAR<Indikativ<han
eqqumiitsuliortormioqarporli	eqqumiitsuliortoq+MIU-QAR<Indikativ<han+LI
eqqumiitsuliortormioqarporlu	eqqumiitsuliortoq+MIU-QAR<Indikativ<han+LU
eqqumiitsuliortormiuuvorli	eqqumiitsuliortoq+MIU-U<Indikativ<han+LI
eqqumiitsuliortormiuussagaluarporlu	eqqumiitsuliortoq+MIU-U-SSA+GALUAR<Indikativ<han+LU
eqqumiitsuliortormiuussagaluartungali	eqqumiitsuliortoq+MIU-U-SSA+GALUAR<Participium<jeg+LI
eqqumiitsuliortormiuusaraluarpunga	eqqumiitsuliortoq+MIU-U+TAR+GALUAR<Indikativ<jeg
eqqumiitsuliortormiuusarpoq	eqqumiitsuliortoq+MIU-U+TAR<Indikativ<han
eqqumiitsuliortormiuusassagaluarpugullu	eqqumiitsuliortoq+MIU-U+TAR-SSA+GALUAR<Indikativ<vi+LU
eqqumiitsuliortormiuusassavit	eqqumiitsuliortoq+MIU-U+TAR-SSA<Interrogativ<du
eqqumiitsuliortunngorpoq	eqqumiitsuliortoq-NNGUR<Indikativ<han
eqqumiitsuliortunngorpit	eqqumiitsuliortoq-NNGUR<Interrogativ<du
eqqumiitsuliortunngortunga	eqqumiitsuliortoq-NNGUR<Participium<jeg
eqqumiitsuliortunngussagaluarpunga	eqqumiitsuliortoq-NNGUR-SSA+GALUAR<Indikativ<jeg
eqqumiitsuliortunngussagaluartunga	eqqumiitsuliortoq-NNGUR-SSA+GALUAR<Participium<jeg
eqqumiitsuliortunngortarpungali	eqqumiitsuliortoq-NNGUR+TAR<Indikativ<jeg+LI
eqqumiitsuliortoqaraluarpit	eqqumiitsuliortoq-QAR+GALUAR<Interrogativ<du
eqqumiitsuliortoqartungali	eqqumiitsuliortoq-QAR<Participium<jeg+LI
eqqumiitsuliortoqassagaluarpunga	eqqumiitsuliortoq-QAR-SSA+GALUAR<Indikativ<jeg
eqqumiitsuliortoqassagaluarpungali	eqqumiitsuliortoq-QAR-SSA+GALUAR<Indikativ<jeg+LI
eqqumiitsuliortoqassagaluarpugullu	eqqumiitsuliortoq-QAR-SSA+GALUAR<Indikativ<vi+LU
eqqumiitsuliortoqassagaluarpit	eqqumiitsuliortoq-QAR-SSA+GALUAR<Interrogativ<du
eqqumiitsuliortoqassagaluartunga	eqqumiitsuliortoq-QAR-SSA+GALUAR<Participium<jeg
eqqumiitsuliortoqassavunga	eqqumiitsuliortoq-QAR-SSA<Indikativ<jeg
eqqumiitsuliortoqassavugullu	eqqumiitsuliortoq-QAR-SSA<Indikativ<vi+LU
eqqumiitsuliortoqassavit	eqqumiitsuliortoq-QAR-SSA<Interrogativ<du
eqqumiitsuliortoqassasunga	eqqumiitsuliortoq-QAR-SSA<Participium<jeg
eqqumiitsuliortoqassasungali	eqqumiitsuliortoq-QAR-SSA<Participium<jeg+LI
eqqumiitsuliortoqartaraluarpit	eqqumiitsuliortoq-QAR+TAR+GALUAR<Interrogativ<du
eqqumiitsuliortoqartarporli	eqqumiitsuliortoq-QAR+TAR<Indikativ<han+LI
eqqumiitsuliortoqartartunga	eqqumiitsuliortoq-QAR+TAR<Participium<jeg
eqqumiitsuliortoqartassasunga	eqqumiitsuliortoq-QAR+TAR-SSA<Participium<jeg
eqqumiitsuliortuuvunga	eqqumiitsuliortoq-U<Indikativ<jeg
eqqumiitsuliortuuvungali	eqqumiitsuliortoq-U<Indikativ<jeg+LI
eqqumiitsuliortuuit	eqqumiitsuliortoq-U<Interrogativ<du
eqqumiitsuliortuusunga	eqqumiitsuliortoq-U<Participium<jeg
eqqumiitsuliortuussavoq	eqqumiitsuliortoq-U-SSA<Indikativ<han
eqqumiitsuliortuusaraluarpunga	eqqumiitsuliortoq-U+TAR+GALUAR<Indikativ<jeg
eqqumiitsuliortuusassagaluarpungali	eqqumiitsuliortoq-U+TAR-SSA+GALUAR<Indikativ<jeg+LI
eqqumiitsuliortuusassasungalu	eqqumiitsuliortoq-U+TAR-SSA<Participium<jeg+LU
Esbjerg	Esbjerg<Absolut
Esbjergili	Esbjerg<Absolut+LI
Esbjergilu	Esbjerg<Absolut+LU
Esbjergimik	Esbjerg<Instrumentalis
Esbjergimilli	Esbjerg<Instrumentalis+LI
Esbjergimillu	Esbjerg<Instrumentalis+LU
Esbjergimi	Esbjerg<Lokalis
Esbjergimili	Esbjerg<Lokalis+LI
Esbjergimilu	Esbjerg<Lokalis+LU
Esbjergimiu	Esbjerg+MIU<ental<Absolut
Esbjergimiulu	Esbjerg+MIU<ental<Absolut+LU
Esbjergimiumik	Esbjerg+MIU<ental<Instrumentalis
Esbjergimiumi	Esbjerg+MIU<ental<Lokalis
Esbjergimiumilu	Esbjerg+MIU<ental<Lokalis+LU
Esbjergimiumut	Esbjerg+MIU<ental<Terminalis
Esbjergimiunik	Esbjerg+MIU<flertal<Instrumentalis
Esbjergimiunilli	Esbjerg+MIU<flertal<Instrumentalis+LI
Esbjergimiunillu	Esbjerg+MIU<flertal<Instrumentalis+LU
Esbjergimiuni	Esbjerg+MIU<flertal<Lokalis
Esbjergimiunili	Esbjerg+MIU<flertal<Lokalis+LI
Esbjergimiunilu	Esbjerg+MIU<flertal<Lokalis+LU
Esbjergimiulerigaluarpungalu	Esbjerg+MIU-LIRI+GALUAR<Indikativ<jeg+LU
Esbjergimiulerivoq	Esbjerg+MIU-LIRI<Indikativ<han
Esbjergimiulerivugulli	Esbjerg+MIU-LIRI<Indikativ<vi+LI
Esbjergimiulerisunga	Esbjerg+MIU-LIRI<Participium<jeg
Esbjergimiulerissagaluarpungali	Esbjerg+MIU-LIRI-SSA+GALUAR<Indikativ<jeg+LI
Esbjergimiulerissavit	Esbjerg+MIU-LIRI-SSA<Interrogativ<du
Esbjergimiulerisaraluartunga	Esbjerg+MIU-LIRI+TAR+GALUAR<Participium<jeg
Esbjergimiulerisassasungalu	Esbjerg+MIU-LIRI+TAR-SSA<Participium<jeg+LU
Esbjergimiunngorpungali	Esbjerg+MIU-NNGUR<Indikativ<jeg+LI
Esbjergimiunngussagaluartunga	Esbjerg+MIU-NNGUR-SSA+GALUAR<Participium<jeg
Esbjergimiunngussavoq	Esbjerg+MIU-NNGUR-SSA<Indikativ<han
Esbjergimiunngussavugut	Esbjerg+MIU-NNGUR-SSA<Indikativ<vi
Esbjergimiunngussavit	Esbjerg+MIU-NNGUR-SSA<Interrogativ<du
Esbjergimiunngussasunga	Esbjerg+MIU-NNGUR-SSA<Participium<jeg
Esbjergimiunngortaraluartungali	Esbjerg+MIU-NNGUR+TAR+GALUAR<Participium<jeg+LI
Esbjergimiunngortassagaluarpunga	Esbjerg+MIU-NNGUR+TAR-SSA+GALUAR<Indikativ<jeg
Esbjergimiunngortassagaluarpit	Esbjerg+MIU-NNGUR+TAR-SSA+GALUAR<Interrogativ<du
Esbjergimioqarpoq	Esbjerg+MIU-QAR<Indikativ<han
Esbjergimioqarporli	Esbjerg+MIU-QAR<Indikativ<han+LI
Esbjergimioqarporlu	Esbjerg+MIU-QAR<Indikativ<han+LU
Esbjergimiuugaluarpunga	Esbjerg+MIU-U+GALUAR<Indikativ<jeg
Esbjergimiuugaluarpungalu	Esbjerg+MIU-U+GALUAR<Indikativ<jeg+LU
Esbjergimiuugaluarpugulli	Esbjerg+MIU-U+GALUAR<Indikativ<vi+LI
Esbjergimiuugaluarpit	Esbjerg+MIU-U+GALUAR<Interrogativ<du
Esbjergimiuugaluartunga	Esbjerg+MIU-U+GALUAR<Participium<jeg
Esbjergimiuuvorlu	Esbjerg+MIU-U<Indikativ<han+LU
Esbjergimiuuvunga	Esbjerg+MIU-U<Indikativ<jeg
Esbjergimiuuvungali	Esbjerg+MIU-U<Indikativ<jeg+LI
Esbjergimiuuvungalu	Esbjerg+MIU-U<Indikativ<jeg+LU
Esbjergimiuuvugut	Esbjerg+MIU-U<Indikativ<vi
Esbjergimiuuvugulli	Esbjerg+MIU-U<Indikativ<vi+LI
Esbjergimiuuit	Esbjerg+MIU-U<Interrogativ<du
Esbjergimiuusunga	Esbjerg+MIU-U<Participium<jeg
Esbjergimiuusungali	Esbjerg+MIU-U<Participium<jeg+LI
Esbjergimiuusungalu	Esbjerg+MIU-U<Participium<jeg+LU
Esbjergimiuussagaluarporli	Esbjerg+MIU-U-SSA+GALUAR<Indikativ<han+LI
Esbjergimiuussagaluarpugut	Esbjerg+MIU-U-SSA+GALUAR<Indikativ<vi
Esbjergimiuussavorlu	Esbjerg+MIU-U-SSA<Indikativ<han+LU
Esbjergimiuussavungali	Esbjerg+MIU-U-SSA<Indikativ<jeg+LI
Esbjergimiuussavugullu	Esbjerg+MIU-U-SSA<Indikativ<vi+LU
Esbjergimiuussavit	Esbjerg+MIU-U-SSA<Interrogativ<du
Esbjergimiuussasungalu	Esbjerg+MIU-U-SSA<Participium<jeg+LU
Esbjergimiuusaraluarpungalu	Esbjerg+MIU-U+TAR+GALUAR<Indikativ<jeg+LU
Esbjergimiuusaraluarpit	Esbjerg+MIU-U+TAR+GALUAR<Interrogativ<du
Esbjergimiuusarpunga	Esbjerg+MIU-U+TAR<Indikativ<jeg
Esbjergimiuusartunga	Esbjerg+MIU-U+TAR<Participium<jeg
Esbjergimiuusartungali	Esbjerg+MIU-U+TAR<Participium<jeg+LI
Esbjergimiuusassagaluarpungali	Esbjerg+MIU-U+TAR-SSA+GALUAR<Indikativ<jeg+LI
Esbjergimiuusassagaluarpugut	Esbjerg+MIU-U+TAR-SSA+GALUAR<Indikativ<vi
Esbjergimiuusassagaluarpit	Esbjerg+MIU-U+TAR-SSA+GALUAR<Interrogativ<du
Esbjergimiuusassavit	Esbjerg+MIU-U+TAR-SSA<Interrogativ<du
Esbjergimiuusassasungali	Esbjerg+MIU-U+TAR-SSA<Participium<jeg+LI
Esbjergimut	Esbjerg<Terminalis
Esbjergimulli	Esbjerg<Terminalis+LI
Esbjergimullu	Esbjerg<Terminalis+LU
Finland	Finland<Absolut
Finlandili	Finland<Absolut+LI
Finlandilu	Finland<Absolut+LU
Finlandimik	Finland<Instrumentalis
Finlandimilli	Finland<Instrumentalis+LI
Finlandimillu	Finland<Instrumentalis+LU
Finlandimi	Finland<Lokalis
Finlandimili	Finland<Lokalis+LI
Finlandimilu	Finland<Lokalis+LU
Finlandimiu	Finland+MIU<ental<Absolut
Finlandimiuli	Finland+MIU<ental<Absolut+LI
Finlandimiumik	Finland+MIU<ental<Instrumentalis
Finlandimiumillu	Finland+MIU<ental<Instrumentalis+LU
Finlandimiumi	Finland+MIU<ental<Lokalis
Finlandimiumili	Finland+MIU<ental<Lokalis+LI
Finlandimiumulli	Finland+MIU<ental<Terminalis+LI
Finlandimiunik	Finland+MIU<flertal<Instrumentalis
Finlandimiuni	Finland+MIU<flertal<Lokalis
Finlandimiunilu	Finland+MIU<flertal<Lokalis+LU
Finlandimiulerivit	Finland+MIU-LIRI<Interrogativ<du
Finlandimiulerissagaluarpugut	Finland+MIU-LIRI-SSA+GALUAR<Indikativ<vi
Finlandimiulerissagaluarpugulli	Finland+MIU-LIRI-SSA+GALUAR<Indikativ<vi+LI
Finlandimiulerissagaluartungali	Finland+MIU-LIRI-SSA+GALUAR<Participium<jeg+LI
Finlandimiulerisaraluarpunga	Finland+MIU-LIRI+TAR+GALUAR<Indikativ<jeg
Finlandimiunngussavorlu	Finland+MIU-NNGUR-SSA<Indikativ<han+LU
Finlandimiunngussavunga	Finland+MIU-NNGUR-SSA<Indikativ<jeg
Finlandimiunngussavugut	Finland+MIU-NNGUR-SSA<Indikativ<vi
Finlandimiunngussasunga	Finland+MIU-NNGUR-SSA<Participium<jeg
Finlandimiunngortaraluartunga	Finland+MIU-NNGUR+TAR+GALUAR<Participium<jeg
Finlandimiunngortartunga	Finland+MIU-NNGUR+TAR<Participium<jeg
Finlandimioqarpoq	Finland+MIU-QAR<Indikativ<han
Finlandimioqarporli	Finland+MIU-QAR<Indikativ<han+LI
Finlandimioqarporlu	Finland+MIU-QAR<Indikativ<han+LU
Finlandimiuugaluarpungali	Finland+MIU-U+GALUAR<Indikativ<jeg+LI
Finlandimiuugaluartungalu	Finland+MIU-U+GALUAR<Participium<jeg+LU
Finlandimiuuvorli	Finland+MIU-U<Indikativ<han+LI
Finlandimiuuvunga	Finland+MIU-U<Indikativ<jeg
Finlandimiuuvugut	Finland+MIU-U<Indikativ<vi
Finlandimiuuit	Finland+MIU-U<Interrogativ<du
Finlandimiuusunga	Finland+MIU-U<Participium<jeg
Finlandimiuusungali	Finland+MIU-U<Participium<jeg+LI
Finlandimiuussagaluarpoq	Finland+MIU-U-SSA+GALUAR<Indikativ<han
Finlandimiuussagaluarpunga	Finland+MIU-U-SSA+GALUAR<Indikativ<jeg
Finlandimiuussagaluartunga	Finland+MIU-U-SSA+GALUAR<Participium<jeg
Finlandimiuussagaluartungalu	Finland+MIU-U-SSA+GALUAR<Participium<jeg+LU
Finlandimiuussavugut	Finland+MIU-U-SSA<Indikativ<vi
Finlandimiuusaraluarpugullu	Finland+MIU-U+TAR+GALUAR<Indikativ<vi+LU
Finlandimiuusaraluartunga	Finland+MIU-U+TAR+GALUAR<Participium<jeg
Finlandimiuusarporli	Finland+MIU-U+TAR<Indikativ<han+LI
Finlandimiuusarpugut	Finland+MIU-U+TAR<Indikativ<vi
Finlandimiuusarpit	Finland+MIU-U+TAR<Interrogativ<du
Finlandimiuusassagaluartunga	Finland+MIU-U+TAR-SSA+GALUAR<Participium<jeg
Finlandimiuusassavunga	Finland+MIU-U+TAR-SSA<Indikativ<jeg
Finlandimiuusassavungalu	Finland+MIU-U+TAR-SSA<Indikativ<jeg+LU
Finlandimiuusassasunga	Finland+MIU-U+TAR-SSA<Participium<jeg
Finlandimut	Finland<Terminalis
Finlandimulli	Finland<Terminalis+LI
Finlandimullu	Finland<Terminalis+LU
Gentofte	Gentofte<Absolut
Gentofteli	Gentofte<Absolut+LI
Gentoftelu	Gentofte<Absolut+LU
Gentoftemik	Gentofte<Instrumentalis
Gentoftemilli	Gentofte<Instrumentalis+LI
Gentoftemillu	Gentofte<Instrumentalis+LU
Gentoftemi	Gentofte<Lokalis
Gentoftemili	Gentofte<Lokalis+LI
Gentoftemilu	Gentofte<Lokalis+LU
Gentoftemiulu	Gentofte+MIU<ental<Absolut+LU
Gentoftemiuga	Gentofte+MIU<ental<Absolut<min
Gentoftemiumillu	Gentofte+MIU<ental<Instrumentalis+LU
Gentoftemiumi	Gentofte+MIU<ental<Lokalis
Gentoftemiumilu	Gentofte+MIU<ental<Lokalis+LU
Gentoftemiunik	Gentofte+MIU<flertal<Instrumentalis
Gentoftemiunilli	Gentofte+MIU<flertal<Instrumentalis+LI
Gentoftemiuni	Gentofte+MIU<flertal<Lokalis
Gentoftemiunili	Gentofte+MIU<flertal<Lokalis+LI
Gentoftemiunilu	Gentofte+MIU<flertal<Lokalis+LU
Gentoftemiulerigaluartunga	Gentofte+MIU-LIRI+GALUAR<Participium<jeg
Gentoftemiulerivungali	Gentofte+MIU-LIRI<Indikativ<jeg+LI
Gentoftemiulerivit	Gentofte+MIU-LIRI<Interrogativ<du
Gentoftemiulerisunga	Gentofte+MIU-LIRI<Participium<jeg
Gentoftemiulerissagaluarpit	Gentofte+MIU-LIRI-SSA+GALUAR<Interrogativ<du
Gentoftemiulerissasunga	Gentofte+MIU-LIRI-SSA<Participium<jeg
Gentoftemiulerissasungalu	Gentofte+MIU-LIRI-SSA<Participium<jeg+LU
Gentoftemiulerisaraluartunga	Gentofte+MIU-LIRI+TAR+GALUAR<Participium<jeg
Gentoftemiulerisassagaluarpunga	Gentofte+MIU-LIRI+TAR-SSA+GALUAR<Indikativ<jeg
Gentoftemiunngorpit	Gentofte+MIU-NNGUR<Interrogativ<du
Gentoftemiunngortunga	Gentofte+MIU-NNGUR<Participium<jeg
Gentoftemiunngussagaluarporlu	Gentofte+MIU-NNGUR-SSA+GALUAR<Indikativ<han+LU
Gentoftemiunngussagaluarpunga	Gentofte+MIU-NNGUR-SSA+GALUAR<Indikativ<jeg
Gentoftemiunngussagaluartungali	Gentofte+MIU-NNGUR-SSA+GALUAR<Participium<jeg+LI
Gentoftemiunngussasungalu	Gentofte+MIU-NNGUR-SSA<Participium<jeg+LU
Gentoftemut	Gentofte<Terminalis
Gentoftemulli	Gentofte<Terminalis+LI
Gentoftemullu	Gentofte<Terminalis+LU
ilinniaraluarpunga	ilinniar+GALUAR<Indikativ<jeg
ilinniaraluarpungali	ilinniar+GALUAR<Indikativ<jeg+LI
ilinniaraluarpugulli	ilinniar+GALUAR<Indikativ<vi+LI
ilinniaraluarpit	ilinniar+GALUAR<Interrogativ<du
ilinniarporlu	ilinniar<Indikativ<han+LU
ilinniarpunga	ilinniar<Indikativ<jeg
ilinniarpugulli	ilinniar<Indikativ<vi+LI
ilinniarpugullu	ilinniar<Indikativ<vi+LU
ilinniarpit	ilinniar<Interrogativ<du
ilinniartunga	ilinniar<Participium<jeg
ilinniartungali	ilinniar<Participium<jeg+LI
ilinniassagaluarpoq	ilinniar-SSA+GALUAR<Indikativ<han
ilinniassagaluarporli	ilinniar-SSA+GALUAR<Indikativ<han+LI
ilinniassagaluarpunga	ilinniar-SSA+GALUAR<Indikativ<jeg
ilinniassagaluarpungalu	ilinniar-SSA+GALUAR<Indikativ<jeg+LU
ilinniassagaluarpit	ilinniar-SSA+GALUAR<Interrogativ<du
ilinniassagaluartunga	ilinniar-SSA+GALUAR<Participium<jeg
ilinniassagaluartungali	ilinniar-SSA+GALUAR<Participium<jeg+LI
ilinniassavorli	ilinniar-SSA<Indikativ<han+LI
ilinniassavorlu	ilinniar-SSA<Indikativ<han+LU
ilinniassavunga	ilinniar-SSA<Indikativ<jeg
ilinniassavungali	ilinniar-SSA<Indikativ<jeg+LI
ilinniassavungalu	ilinniar-SSA<Indikativ<jeg+LU
ilinniassavugut	ilinniar-SSA<Indikativ<vi
ilinniassavugulli	ilinniar-SSA<Indikativ<vi+LI
ilinniassavit	ilinniar-SSA<Interrogativ<du
ilinniassasunga	ilinniar-SSA<Participium<jeg
ilinniassasungali	ilinniar-SSA<Participium<jeg+LI
ilinniassasungalu	ilinniar-SSA<Participium<jeg+LU
ilinniartaraluarpunga	ilinniar+TAR+GALUAR<Indikativ<jeg
ilinniartaraluarpit	ilinniar+TAR+GALUAR<Interrogativ<du
ilinniartaraluartunga	ilinniar+TAR+GALUAR<Participium<jeg
ilinniartaraluartungali	ilinniar+TAR+GALUAR<Participium<jeg+LI
ilinniartarpugut	ilinniar+TAR<Indikativ<vi
ilinniartartunga	ilinniar+TAR<Participium<jeg
ilinniartassagaluarporli	ilinniar+TAR-SSA+GALUAR<Indikativ<han+LI
ilinniartassagaluarpunga	ilinniar+TAR-SSA+GALUAR<Indikativ<jeg
ilinniartassagaluarpugut	ilinniar+TAR-SSA+GALUAR<Indikativ<vi
ilinniartassagaluarpit	ilinniar+TAR-SSA+GALUAR<Interrogativ<du
ilinniartassagaluartunga	ilinniar+TAR-SSA+GALUAR<Participium<jeg
ilinniartassagaluartungali	ilinniar+TAR-SSA+GALUAR<Participium<jeg+LI
ilinniartassavunga	ilinniar+TAR-SSA<Indikativ<jeg
ilinniartassavugut	ilinniar+TAR-SSA<Indikativ<vi
ilinniartassavit	ilinniar+TAR-SSA<Interrogativ<du
ilinniartikkaluarpiuk	ilinniartip+GALUAR<Interrogativ<DuHam
ilinniartippaannga	ilinniartip<Indikativ<DeMig
ilinniartippassi	ilinniartip<Indikativ<JegJer
ilinniartippassilu	ilinniartip<Indikativ<JegJer+LU
ilinniartippiuk	ilinniartip<Interrogativ<DuHam
ilinniartittaraluarpiuk	ilinniartip+TAR+GALUAR<Interrogativ<DuHam
ilinniartitsisunngussavugulli	ilinniartitsisoq-NNGUR-SSA<Indikativ<vi+LI
Ilisimatusarfik	Ilisimatusarfik<ental<Absolut
Ilisimatusarfilli	Ilisimatusarfik<ental<Absolut+LI
Ilisimatusarfillu	Ilisimatusarfik<ental<Absolut+LU
Ilisimatusarfinnik	Ilisimatusarfik<flertal<Instrumentalis
Ilisimatusarfinnillu	Ilisimatusarfik<flertal<Instrumentalis+LU
Ilisimatusarfinnilu	Ilisimatusarfik<flertal<Lokalis+LU
Ilisimatusarfimmiunngussagaluartunga	Ilisimatusarfik+MIU-NNGUR-SSA+GALUAR<Participium<jeg
Ilisimatusarfimmioqarporli	Ilisimatusarfik+MIU-QAR<Indikativ<han+LI
Ilisimatusarfinngorporli	Ilisimatusarfik-NNGUR<Indikativ<han+LI
Ilisimatusarfinngortaraluarpoq	Ilisimatusarfik-NNGUR+TAR+GALUAR<Indikativ<han
Ilisimatusarfeqaraluarpoq	Ilisimatusarfik-QAR+GALUAR<Indikativ<han
Ilisimatusarfeqarporli	Ilisimatusarfik-QAR<Indikativ<han+LI
Ilisimatusarfeqarporlu	Ilisimatusarfik-QAR<Indikativ<han+LU
Ilisimatusarfeqassagaluarpoq	Ilisimatusarfik-QAR-SSA+GALUAR<Indikativ<han
Ilisimatusarfeqassavoq	Ilisimatusarfik-QAR-SSA<Indikativ<han
Ilisimatusarfeqassavorli	Ilisimatusarfik-QAR-SSA<Indikativ<han+LI
Ilisimatusarfeqassavorlu	Ilisimatusarfik-QAR-SSA<Indikativ<han+LU
Ilisimatusarfeqartaraluarpoq	Ilisimatusarfik-QAR+TAR+GALUAR<Indikativ<han
Ilisimatusarfeqartarpoq	Ilisimatusarfik-QAR+TAR<Indikativ<han
Ilisimatusarfeqartarporli	Ilisimatusarfik-QAR+TAR<Indikativ<han+LI
Ilisimatusarfeqartassavorlu	Ilisimatusarfik-QAR+TAR-SSA<Indikativ<han+LU
Ilisimatusarfiugaluarpoq	Ilisimatusarfik-U+GALUAR<Indikativ<han
Illoqqortoormiut	Illoqqortoormiut<Absolut
Illoqqortoormiulli	Illoqqortoormiut<Absolut+LI
Illoqqortoormiullu	Illoqqortoormiut<Absolut+LU
Illoqqortoormiunik	Illoqqortoormiut<Instrumentalis
Illoqqortoormiuni	Illoqqortoormiut<Lokalis
Illoqqortoormiunili	Illoqqortoormiut<Lokalis+LI
Illoqqortoormiunilu	Illoqqortoormiut<Lokalis+LU
Illoqqortoormiormiulu	Illoqqortoormiut+MIU<ental<Absolut+LU
Illoqqortoormiormiumi	Illoqqortoormiut+MIU<ental<Lokalis
Illoqqortoormiormiumilu	Illoqqortoormiut+MIU<ental<Lokalis+LU
Illoqqortoormiormiunik	Illoqqortoormiut+MIU<flertal<Instrumentalis
Illoqqortoormiormiunilli	Illoqqortoormiut+MIU<flertal<Instrumentalis+LI
Illoqqortoormiormiunili	Illoqqortoormiut+MIU<flertal<Lokalis+LI
Illoqqortoormiormiulerigaluarpit	Illoqqortoormiut+MIU-LIRI+GALUAR<Interrogativ<du
Illoqqortoormiormiulerivorlu	Illoqqortoormiut+MIU-LIRI<Indikativ<han+LU
Illoqqortoormiormiulerisassagaluartungali	Illoqqortoormiut+MIU-LIRI+TAR-SSA+GALUAR<Participium<jeg+LI
Illoqqortoormiormiulerisassavunga	Illoqqortoormiut+MIU-LIRI+TAR-SSA<Indikativ<jeg
Illoqqortoormiormiunngussagaluartungali	Illoqqortoormiut+MIU-NNGUR-SSA+GALUAR<Participium<jeg+LI
Illoqqortoormiormiunngussavit	Illoqqortoormiut+MIU-NNGUR-SSA<Interrogativ<du
Illoqqortoormiormiunngortaraluartunga	Illoqqortoormiut+MIU-NNGUR+TAR+GALUAR<Participium<jeg
Illoqqortoormiormioqarpoq	Illoqqortoormiut+MIU-QAR<Indikativ<han
Illoqqortoormiormioqarporli	Illoqqortoormiut+MIU-QAR<Indikativ<han+LI
Illoqqortoormiormioqarporlu	Illoqqortoormiut+MIU-QAR<Indikativ<han+LU
Illoqqortoormiormiuugaluarpit	Illoqqortoormiut+MIU-U+GALUAR<Interrogativ<du
Illoqqortoormiormiuuit	Illoqqortoormiut+MIU-U<Interrogativ<du
Illoqqortoormiormiuusarpunga	Illoqqortoormiut+MIU-U+TAR<Indikativ<jeg
Illoqqortoormiormiuusassasunga	Illoqqortoormiut+MIU-U+TAR-SSA<Participium<jeg
illuga	illu<ental<Absolut<min
illumulli	illu<ental<Terminalis+LI
illumullu	illu<ental<Terminalis+LU
illunilli	illu<flertal<Instrumentalis+LI
illuni	illu<flertal<Lokalis
illulerissavit	illu-LIRI-SSA<Interrogativ<du
illulerisassavorli	illu-LIRI+TAR-SSA<Indikativ<han+LI
illumiumi	illu+MIU<ental<Lokalis
illumiuni	illu+MIU<flertal<Lokalis
illumiunili	illu+MIU<flertal<Lokalis+LI
illumiunilu	illu+MIU<flertal<Lokalis+LU
illumiulerivit	illu+MIU-LIRI<Interrogativ<du
illumiunngussagaluartunga	illu+MIU-NNGUR-SSA+GALUAR<Participium<jeg
illumiunngussavoq	illu+MIU-NNGUR-SSA<Indikativ<han
illumioqarpoq	illu+MIU-QAR<Indikativ<han
illumioqarporli	illu+MIU-QAR<Indikativ<han+LI
illumioqarporlu	illu+MIU-QAR<Indikativ<han+LU
illumiuugaluarpugullu	illu+MIU-U+GALUAR<Indikativ<vi+LU
illumiuugaluarpit	illu+MIU-U+GALUAR<Interrogativ<du
illumiuuvugullu	illu+MIU-U<Indikativ<vi+LU
illumiuuit	illu+MIU-U<Interrogativ<du
illumiuussagaluartungalu	illu+MIU-U-SSA+GALUAR<Participium<jeg+LU
illumiuusaraluarpugulli	illu+MIU-U+TAR+GALUAR<Indikativ<vi+LI
illumiuusassagaluarpit	illu+MIU-U+TAR-SSA+GALUAR<Interrogativ<du
illumiuusassagaluartunga	illu+MIU-U+TAR-SSA+GALUAR<Participium<jeg
illunngoraluartunga	illu-NNGUR+GALUAR<Participium<jeg
illunngortunga	illu-NNGUR<Participium<jeg
illunngussavit	illu-NNGUR-SSA<Interrogativ<du
illunngussasunga	illu-NNGUR-SSA<Participium<jeg
illunngortassavit	illu-NNGUR+TAR-SSA<Interrogativ<du
illoqaraluarpoq	illu-QAR+GALUAR<Indikativ<han
illoqaraluarpungali	illu-QAR+GALUAR<Indikativ<jeg+LI
illoqaraluarpugut	illu-QAR+GALUAR<Indikativ<vi
illoqaraluarpit	illu-QAR+GALUAR<Interrogativ<du
illoqarporli	illu-QAR<Indikativ<han+LI
illoqarpunga	illu-QAR<Indikativ<jeg
illoqarpungalu	illu-QAR<Indikativ<jeg+LU
illoqarpit	illu-QAR<Interrogativ<du
illoqartunga	illu-QAR<Participium<jeg
illoqassagaluarporli	illu-QAR-SSA+GALUAR<Indikativ<han+LI
illoqassagaluarporlu	illu-QAR-SSA+GALUAR<Indikativ<han+LU
illoqassagaluarpunga	illu-QAR-SSA+GALUAR<Indikativ<jeg
illoqassagaluarpugut	illu-QAR-SSA+GALUAR<Indikativ<vi
illoqassagaluarpugulli	illu-QAR-SSA+GALUAR<Indikativ<vi+LI
illoqassagaluarpit	illu-QAR-SSA+GALUAR<Interrogativ<du
illoqassagaluartunga	illu-QAR-SSA+GALUAR<Participium<jeg
illoqassagaluartungali	illu-QAR-SSA+GALUAR<Participium<jeg+LI
illoqassavorlu	illu-QAR-SSA<Indikativ<han+LU
illoqassavunga	illu-QAR-SSA<Indikativ<jeg
illoqassavungali	illu-QAR-SSA<Indikativ<jeg+LI
illoqassavit	illu-QAR-SSA<Interrogativ<du
illoqassasunga	illu-QAR-SSA<Participium<jeg
illoqassasungalu	illu-QAR-SSA<Participium<jeg+LU
illoqartaraluarpit	illu-QAR+TAR+GALUAR<Interrogativ<du
illoqartaraluartunga	illu-QAR+TAR+GALUAR<Participium<jeg
illoqartarpunga	illu-QAR+TAR<Indikativ<jeg
illoqartarpit	illu-QAR+TAR<Interrogativ<du
illoqartassagaluartunga	illu-QAR+TAR-SSA+GALUAR<Participium<jeg
illoqartassagaluartungali	illu-QAR+TAR-SSA+GALUAR<Participium<jeg+LI
illoqartassavorlu	illu-QAR+TAR-SSA<Indikativ<han+LU
illoqartassasungali	illu-QAR+TAR-SSA<Participium<jeg+LI
illuugaluarporli	illu-U+GALUAR<Indikativ<han+LI
illuusartunga	illu-U+TAR<Participium<jeg
illuusartungalu	illu-U+TAR<Participium<jeg+LU
Ilulissat	Ilulissat<Absolut
Ilulissalli	Ilulissat<Absolut+LI
Ilulissallu	Ilulissat<Absolut+LU
Ilulissanik	Ilulissat<Instrumentalis
Ilulissanilli	Ilulissat<Instrumentalis+LI
Ilulissanillu	Ilulissat<Instrumentalis+LU
Ilulissani	Ilulissat<Lokalis
Ilulissanili	Ilulissat<Lokalis+LI
Iluliarmiu	Ilulissat+MIU<ental<Absolut
Iluliarmiumillu	Ilulissat+MIU<ental<Instrumentalis+LU
Iluliarmiumilu	Ilulissat+MIU<ental<Lokalis+LU
Iluliarmiunili	Ilulissat+MIU<flertal<Lokalis+LI
Iluliarmiulerisarpoq	Ilulissat+MIU-LIRI+TAR<Indikativ<han
Iluliarmiunngoraluarpit	Ilulissat+MIU-NNGUR+GALUAR<Interrogativ<du
Iluliarmioqarpoq	Ilulissat+MIU-QAR<Indikativ<han
Iluliarmioqarporli	Ilulissat+MIU-QAR<Indikativ<han+LI
Iluliarmiuugaluartunga	Ilulissat+MIU-U+GALUAR<Participium<jeg
Iluliarmiuuvunga	Ilulissat+MIU-U<Indikativ<jeg
Iluliarmiuuit	Ilulissat+MIU-U<Interrogativ<du
Iluliarmiuusunga	Ilulissat+MIU-U<Participium<jeg
Iluliarmiuusungali	Ilulissat+MIU-U<Participium<jeg+LI
Iluliarmiuussavoq	Ilulissat+MIU-U-SSA<Indikativ<han
Iluliarmiuusaraluartunga	Ilulissat+MIU-U+TAR+GALUAR<Participium<jeg
Ivittuut	Ivittuut<Absolut
Ivittuulli	Ivittuut<Absolut+LI
Ivittuullu	Ivittuut<Absolut+LU
Ivittuunik	Ivittuut<Instrumentalis
Ivittuunilli	Ivittuut<Instrumentalis+LI
Ivittuunillu	Ivittuut<Instrumentalis+LU
Ivittuuni	Ivittuut<Lokalis
Ivittuunili	Ivittuut<Lokalis+LI
Ivittuunilu	Ivittuut<Lokalis+LU
Ivittoormiu	Ivittuut+MIU<ental<Absolut
Ivittoormiumilli	Ivittuut+MIU<ental<Instrumentalis+LI
Ivittoormiumi	Ivittuut+MIU<ental<Lokalis
Ivittoormiumilu	Ivittuut+MIU<ental<Lokalis+LU
Ivittoormiumut	Ivittuut+MIU<ental<Terminalis
Ivittoormiunik	Ivittuut+MIU<flertal<Instrumentalis
Ivittoormiuni	Ivittuut+MIU<flertal<Lokalis
Ivittoormiunili	Ivittuut+MIU<flertal<Lokalis+LI
Ivittoormiulerissagaluarpugulli	Ivittuut+MIU-LIRI-SSA+GALUAR<Indikativ<vi+LI
Ivittoormiulerissavit	Ivittuut+MIU-LIRI-SSA<Interrogativ<du
Ivittoormiulerisaraluarpit	Ivittuut+MIU-LIRI+TAR+GALUAR<Interrogativ<du
Ivittoormiulerisassagaluarpugullu	Ivittuut+MIU-LIRI+TAR-SSA+GALUAR<Indikativ<vi+LU
Ivittoormiunngoraluarpit	Ivittuut+MIU-NNGUR+GALUAR<Interrogativ<du
Ivittoormiunngussavunga	Ivittuut+MIU-NNGUR-SSA<Indikativ<jeg
Ivittoormiunngortaraluarpugullu	Ivittuut+MIU-NNGUR+TAR+GALUAR<Indikativ<vi+LU
Ivittoormiunngortassagaluarpungalu	Ivittuut+MIU-NNGUR+TAR-SSA+GALUAR<Indikativ<jeg+LU
Ivittoormiunngortassagaluartungalu	Ivittuut+MIU-NNGUR+TAR-SSA+GALUAR<Participium<jeg+LU
Ivittoormiunngortassasunga	Ivittuut+MIU-NNGUR+TAR-SSA<Participium<jeg
Ivittoormioqarpoq	Ivittuut+MIU-QAR<Indikativ<han
Ivittoormioqarporli	Ivittuut+MIU-QAR<Indikativ<han+LI
Ivittoormioqarporlu	Ivittuut+MIU-QAR<Indikativ<han+LU
Ivittoormiuugaluarpoq	Ivittuut+MIU-U+GALUAR<Indikativ<han
Ivittoormiuugaluarpugulli	Ivittuut+MIU-U+GALUAR<Indikativ<vi+LI
Ivittoormiuugaluarpit	Ivittuut+MIU-U+GALUAR<Interrogativ<du
Ivittoormiuuvoq	Ivittuut+MIU-U<Indikativ<han
Ivittoormiuuit	Ivittuut+MIU-U<Interrogativ<du
Ivittoormiuusungali	Ivittuut+MIU-U<Participium<jeg+LI
Ivittoormiuussagaluarpungali	Ivittuut+MIU-U-SSA+GALUAR<Indikativ<jeg+LI
Ivittoormiuussagaluarpugullu	Ivittuut+MIU-U-SSA+GALUAR<Indikativ<vi+LU
Ivittoormiuussagaluarpit	Ivittuut+MIU-U-SSA+GALUAR<Interrogativ<du
Ivittoormiuussagaluartungali	Ivittuut+MIU-U-SSA+GALUAR<Participium<jeg+LI
Ivittoormiuussavit	Ivittuut+MIU-U-SSA<Interrogativ<du
Ivittoormiuussasunga	Ivittuut+MIU-U-SSA<Participium<jeg
Ivittoormiuussasungali	Ivittuut+MIU-U-SSA<Participium<jeg+LI
Ivittoormiuusaraluarporlu	Ivittuut+MIU-U+TAR+GALUAR<Indikativ<han+LU
Ivittoormiuusaraluarpit	Ivittuut+MIU-U+TAR+GALUAR<Interrogativ<du
Ivittoormiuusarporlu	Ivittuut+MIU-U+TAR<Indikativ<han+LU
Ivittoormiuusassagaluarpit	Ivittuut+MIU-U+TAR-SSA+GALUAR<Interrogativ<du
Ivittoormiuusassagaluartunga	Ivittuut+MIU-U+TAR-SSA+GALUAR<Participium<jeg
Ivittoormiuusassagaluartungalu	Ivittuut+MIU-U+TAR-SSA+GALUAR<Participium<jeg+LU
kalaaleq	kalaaleq<ental<Absolut
kalaalerli	kalaaleq<ental<Absolut+LI
kalaalerlu	kalaaleq<ental<Absolut+LU
kalaallimik	kalaaleq<ental<Instrumentalis
kalaallimillu	kalaaleq<ental<Instrumentalis+LU
kalaallimi	kalaaleq<ental<Lokalis
kalaallimili	kalaaleq<ental<Lokalis+LI
kalaallimut	kalaaleq<ental<Terminalis
kalaallimulli	kalaaleq<ental<Terminalis+LI
kalaallinik	kalaaleq<flertal<Instrumentalis
kalaallinilli	kalaaleq<flertal<Instrumentalis+LI
kalaallinillu	kalaaleq<flertal<Instrumentalis+LU
kalaallini	kalaaleq<flertal<Lokalis
kalaallinili	kalaaleq<flertal<Lokalis+LI
kalaallinilu	kalaaleq<flertal<Lokalis+LU
kalaalinngoraluartunga	kalaaleq-NNGUR+GALUAR<Participium<jeg
kalaalinngorpunga	kalaaleq-NNGUR<Indikativ<jeg
kalaalinngorpungalu	kalaaleq-NNGUR<Indikativ<jeg+LU
kalaalinngortunga	kalaaleq-NNGUR<Participium<jeg
kalaalinngussagaluarpunga	kalaaleq-NNGUR-SSA+GALUAR<Indikativ<jeg
kalaalinngussagaluarpugut	kalaaleq-NNGUR-SSA+GALUAR<Indikativ<vi
kalaalinngussagaluarpugulli	kalaaleq-NNGUR-SSA+GALUAR<Indikativ<vi+LI
kalaalinngussagaluartunga	kalaaleq-NNGUR-SSA+GALUAR<Participium<jeg
kalaalinngussagaluartungalu	kalaaleq-NNGUR-SSA+GALUAR<Participium<jeg+LU
kalaalinngussavoq	kalaaleq-NNGUR-SSA<Indikativ<han
kalaalinngussavunga	kalaaleq-NNGUR-SSA<Indikativ<jeg
kalaalinngussavungalu	kalaaleq-NNGUR-SSA<Indikativ<jeg+LU
kalaalinngussavugulli	kalaaleq-NNGUR-SSA<Indikativ<vi+LI
kalaalinngussavit	kalaaleq-NNGUR-SSA<Interrogativ<du
kalaalinngussasunga	kalaaleq-NNGUR-SSA<Participium<jeg
kalaalinngortaraluartungalu	kalaaleq-NNGUR+TAR+GALUAR<Participium<jeg+LU
kalaalinngortassavugullu	kalaaleq-NNGUR+TAR-SSA<Indikativ<vi+LU
kalaalinngortassasunga	kalaaleq-NNGUR+TAR-SSA<Participium<jeg
kalaalinngortassasungalu	kalaaleq-NNGUR+TAR-SSA<Participium<jeg+LU
kalaaleqassagaluarpoq	kalaaleq-QAR-SSA+GALUAR<Indikativ<han
kalaaleqassagaluarporlu	kalaaleq-QAR-SSA+GALUAR<Indikativ<han+LU
kalaaleqassavoq	kalaaleq-QAR-SSA<Indikativ<han
kalaaleqassavorlu	kalaaleq-QAR-SSA<Indikativ<han+LU
kalaaleqartaraluarpoq	kalaaleq-QAR+TAR+GALUAR<Indikativ<han
kalaaleqartarporli	kalaaleq-QAR+TAR<Indikativ<han+LI
kalaaleqartassagaluartungalu	kalaaleq-QAR+TAR-SSA+GALUAR<Participium<jeg+LU
kalaaliugaluarporli	kalaaleq-U+GALUAR<Indikativ<han+LI
kalaaliugaluarpungali	kalaaleq-U+GALUAR<Indikativ<jeg+LI
kalaaliuvugut	kalaaleq-U<Indikativ<vi
kalaaliuit	kalaaleq-U<Interrogativ<du
kalaaliusunga	kalaaleq-U<Participium<jeg
kalaaliussagaluartunga	kalaaleq-U-SSA+GALUAR<Participium<jeg
kalaaliussavugut	kalaaleq-U-SSA<Indikativ<vi
kalaaliussasunga	kalaaleq-U-SSA<Participium<jeg
kalaaliusarpit	kalaaleq-U+TAR<Interrogativ<du
kalaaliusassagaluarpit	kalaaleq-U+TAR-SSA+GALUAR<Interrogativ<du
kalaaliusassasungali	kalaaleq-U+TAR-SSA<Participium<jeg+LI
kalaallisut	kalaallisut<Partikel
kalaallisulli	kalaallisut<Partikel+LI
kalaallisullu	kalaallisut<Partikel+LU
Kangaatsiaq	Kangaatsiaq<Absolut
Kangaatsiarli	Kangaatsiaq<Absolut+LI
Kangaatsiarlu	Kangaatsiaq<Absolut+LU
Kangaatsiamik	Kangaatsiaq<Instrumentalis
Kangaatsiamilli	Kangaatsiaq<Instrumentalis+LI
Kangaatsiamillu	Kangaatsiaq<Instrumentalis+LU
Kangaatsiami	Kangaatsiaq<Lokalis
Kangaatsiamili	Kangaatsiaq<Lokalis+LI
Kangaatsiamilu	Kangaatsiaq<Lokalis+LU
Kangaatsiarmiu	Kangaatsiaq+MIU<ental<Absolut
Kangaatsiarmiumili	Kangaatsiaq+MIU<ental<Lokalis+LI
Kangaatsiarmiunilli	Kangaatsiaq+MIU<flertal<Instrumentalis+LI
Kangaatsiarmiuni	Kangaatsiaq+MIU<flertal<Lokalis
Kangaatsiarmiulerigaluartunga	Kangaatsiaq+MIU-LIRI+GALUAR<Participium<jeg
Kangaatsiarmiulerivungali	Kangaatsiaq+MIU-LIRI<Indikativ<jeg+LI
Kangaatsiarmiulerivit	Kangaatsiaq+MIU-LIRI<Interrogativ<du
Kangaatsiarmiulerisunga	Kangaatsiaq+MIU-LIRI<Participium<jeg
Kangaatsiarmiulerissagaluarpunga	Kangaatsiaq+MIU-LIRI-SSA+GALUAR<Indikativ<jeg
Kangaatsiarmiulerisassasunga	Kangaatsiaq+MIU-LIRI+TAR-SSA<Participium<jeg
Kangaatsiarmiunngoraluarpoq	Kangaatsiaq+MIU-NNGUR+GALUAR<Indikativ<han
Kangaatsiarmiunngussagaluarpit	Kangaatsiaq+MIU-NNGUR-SSA+GALUAR<Interrogativ<du
Kangaatsiarmiunngussavit	Kangaatsiaq+MIU-NNGUR-SSA<Interrogativ<du
Kangaatsiarmioqarpoq	Kangaatsiaq+MIU-QAR<Indikativ<han
Kangaatsiarmioqarporli	Kangaatsiaq+MIU-QAR<Indikativ<han+LI
Kangaatsiarmioqarporlu	Kangaatsiaq+MIU-QAR<Indikativ<han+LU
Kangaatsiarmiuugaluartunga	Kangaatsiaq+MIU-U+GALUAR<Participium<jeg
Kangaatsiarmiuuvunga	Kangaatsiaq+MIU-U<Indikativ<jeg
Kangaatsiarmiuuvungali	Kangaatsiaq+MIU-U<Indikativ<jeg+LI
Kangaatsiarmiuuvugut	Kangaatsiaq+MIU-U<Indikativ<vi
Kangaatsiarmiuuvugulli	Kangaatsiaq+MIU-U<Indikativ<vi+LI
Kangaatsiarmiuuit	Kangaatsiaq+MIU-U<Interrogativ<du
Kangaatsiarmiuusaraluarporli	Kangaatsiaq+MIU-U+TAR+GALUAR<Indikativ<han+LI
Kangaatsiarmiuusaraluarpunga	Kangaatsiaq+MIU-U+TAR+GALUAR<Indikativ<jeg
Kangaatsiarmiuusaraluartunga	Kangaatsiaq+MIU-U+TAR+GALUAR<Participium<jeg
Kangaatsiarmiuusassagaluartunga	Kangaatsiaq+MIU-U+TAR-SSA+GALUAR<Participium<jeg
Kangaatsiarmiuusassavit	Kangaatsiaq+MIU-U+TAR-SSA<Interrogativ<du
Kangaatsiamut	Kangaatsiaq<Terminalis
Kangaatsiamulli	Kangaatsiaq<Terminalis+LI
Kangaatsiamullu	Kangaatsiaq<Terminalis+LU
Kangerlussuaq	Kangerlussuaq<Absolut
Kangerlussuarli	Kangerlussuaq<Absolut+LI
Kangerlussuarlu	Kangerlussuaq<Absolut+LU
Kangerlussuarmik	Kangerlussuaq<Instrumentalis
Kangerlussuarmilli	Kangerlussuaq<Instrumentalis+LI
Kangerlussuarmillu	Kangerlussuaq<Instrumentalis+LU
Kangerlussuarmi	Kangerlussuaq<Lokalis
Kangerlussuarmili	Kangerlussuaq<Lokalis+LI
Kangerlussuarmiumik	Kangerlussuaq+MIU<ental<Instrumentalis
Kangerlussuarmiunik	Kangerlussuaq+MIU<flertal<Instrumentalis
Kangerlussuarmiunillu	Kangerlussuaq+MIU<flertal<Instrumentalis+LU
Kangerlussuarmiuni	Kangerlussuaq+MIU<flertal<Lokalis
Kangerlussuarmiunili	Kangerlussuaq+MIU<flertal<Lokalis+LI
Kangerlussuarmiunilu	Kangerlussuaq+MIU<flertal<Lokalis+LU
Kangerlussuarmiulerigaluarpugut	Kangerlussuaq+MIU-LIRI+GALUAR<Indikativ<vi
Kangerlussuarmiulerissagaluarpit	Kangerlussuaq+MIU-LIRI-SSA+GALUAR<Interrogativ<du
Kangerlussuarmiulerisaraluarpoq	Kangerlussuaq+MIU-LIRI+TAR+GALUAR<Indikativ<han
Kangerlussuarmiulerisartunga	Kangerlussuaq+MIU-LIRI+TAR<Participium<jeg
Kangerlussuarmiulerisassasungali	Kangerlussuaq+MIU-LIRI+TAR-SSA<Participium<jeg+LI
Kangerlussuarmiunngorpit	Kangerlussuaq+MIU-NNGUR<Interrogativ<du
Kangerlussuarmiunngortunga	Kangerlussuaq+MIU-NNGUR<Participium<jeg
Kangerlussuarmiunngortungalu	Kangerlussuaq+MIU-NNGUR<Participium<jeg+LU
Kangerlussuarmiunngussagaluarporlu	Kangerlussuaq+MIU-NNGUR-SSA+GALUAR<Indikativ<han+LU
Kangerlussuarmiunngussagaluartunga	Kangerlussuaq+MIU-NNGUR-SSA+GALUAR<Participium<jeg
Kangerlussuarmiunngussavugullu	Kangerlussuaq+MIU-NNGUR-SSA<Indikativ<vi+LU
Kangerlussuarmioqarpoq	Kangerlussuaq+MIU-QAR<Indikativ<han
Kangerlussuarmioqarporli	Kangerlussuaq+MIU-QAR<Indikativ<han+LI
Kangerlussuarmioqarporlu	Kangerlussuaq+MIU-QAR<Indikativ<han+LU
Kangerlussuarmiuuvoq	Kangerlussuaq+MIU-U<Indikativ<han
Kangerlussuarmiuuit	Kangerlussuaq+MIU-U<Interrogativ<du
Kangerlussuarmiuussagaluartungalu	Kangerlussuaq+MIU-U-SSA+GALUAR<Participium<jeg+LU
Kangerlussuarmiuusaraluarporli	Kangerlussuaq+MIU-U+TAR+GALUAR<Indikativ<han+LI
Kangerlussuarmiuusaraluarpit	Kangerlussuaq+MIU-U+TAR+GALUAR<Interrogativ<du
Kangerlussuarmiuusarporlu	Kangerlussuaq+MIU-U+TAR<Indikativ<han+LU
Kangerlussuarmut	Kangerlussuaq<Terminalis
Kangerlussuarmulli	Kangerlussuaq<Terminalis+LI
Kangerlussuarmullu	Kangerlussuaq<Terminalis+LU
kunngi	kunngi<ental<Absolut
kunngiga	kunngi<ental<Absolut<min
kunngimik	kunngi<ental<Instrumentalis
kunngimilli	kunngi<ental<Instrumentalis+LI
kunngimi	kunngi<ental<Lokalis
kunngimilu	kunngi<ental<Lokalis+LU
kunngimullu	kunngi<ental<Terminalis+LU
kunnginik	kunngi<flertal<Instrumentalis
kunnginilli	kunngi<flertal<Instrumentalis+LI
kunngini	kunngi<flertal<Lokalis
kunnginili	kunngi<flertal<Lokalis+LI
kunnginilu	kunngi<flertal<Lokalis+LU
kunngilerigaluartungali	kunngi-LIRI+GALUAR<Participium<jeg+LI
kunngilerivunga	kunngi-LIRI<Indikativ<jeg
kunngilerissagaluarporli	kunngi-LIRI-SSA+GALUAR<Indikativ<han+LI
kunngilerissagaluarpugullu	kunngi-LIRI-SSA+GALUAR<Indikativ<vi+LU
kunngilerisaraluartunga	kunngi-LIRI+TAR+GALUAR<Participium<jeg
kunngilerisassavorli	kunngi-LIRI+TAR-SSA<Indikativ<han+LI
kunngilerisassasunga	kunngi-LIRI+TAR-SSA<Participium<jeg
kunngilerisassasungali	kunngi-LIRI+TAR-SSA<Participium<jeg+LI
kunngilerisassasungalu	kunngi-LIRI+TAR-SSA<Participium<jeg+LU
kunngimiulu	kunngi+MIU<ental<Absolut+LU
kunngimiunik	kunngi+MIU<flertal<Instrumentalis
kunngimiuni	kunngi+MIU<flertal<Lokalis
kunngimiulerigaluartunga	kunngi+MIU-LIRI+GALUAR<Participium<jeg
kunngimiunngussagaluarpit	kunngi+MIU-NNGUR-SSA+GALUAR<Interrogativ<du
kunngimiunngussagaluartunga	kunngi+MIU-NNGUR-SSA+GALUAR<Participium<jeg
kunngimiunngussasungali	kunngi+MIU-NNGUR-SSA<Participium<jeg+LI
kunngimioqarpoq	kunngi+MIU-QAR<Indikativ<han
kunngimioqarporlu	kunngi+MIU-QAR<Indikativ<han+LU
kunngimiuuvorli	kunngi+MIU-U<Indikativ<han+LI
kunngimiuuit	kunngi+MIU-U<Interrogativ<du
kunngimiuussagaluarpunga	kunngi+MIU-U-SSA+GALUAR<Indikativ<jeg
kunngimiuussagaluartunga	kunngi+MIU-U-SSA+GALUAR<Participium<jeg
kunngimiuusarpit	kunngi+MIU-U+TAR<Interrogativ<du
kunnginngorpungalu	kunngi-NNGUR<Indikativ<jeg+LU
kunnginngortungalu	kunngi-NNGUR<Participium<jeg+LU
kunnginngussagaluarpunga	kunngi-NNGUR-SSA+GALUAR<Indikativ<jeg
kunnginngussavoq	kunngi-NNGUR-SSA<Indikativ<han
kunnginngussavungali	kunngi-NNGUR-SSA<Indikativ<jeg+LI
kunnginngortassavoq	kunngi-NNGUR+TAR-SSA<Indikativ<han
kunngeqaraluarporli	kunngi-QAR+GALUAR<Indikativ<han+LI
kunngeqaraluarpunga	kunngi-QAR+GALUAR<Indikativ<jeg
kunngeqaraluarpit	kunngi-QAR+GALUAR<Interrogativ<du
kunngeqaraluartunga	kunngi-QAR+GALUAR<Participium<jeg
kunngeqarporli	kunngi-QAR<Indikativ<han+LI
kunngeqarporlu	kunngi-QAR<Indikativ<han+LU
kunngeqarpunga	kunngi-QAR<Indikativ<jeg
kunngeqarpugut	kunngi-QAR<Indikativ<vi
kunngeqarpugulli	kunngi-QAR<Indikativ<vi+LI
kunngeqarpit	kunngi-QAR<Interrogativ<du
kunngeqartunga	kunngi-QAR<Participium<jeg
kunngeqartungali	kunngi-QAR<Participium<jeg+LI
kunngeqartungalu	kunngi-QAR<Participium<jeg+LU
kunngeqassagaluarporli	kunngi-QAR-SSA+GALUAR<Indikativ<han+LI
kunngeqassagaluarpunga	kunngi-QAR-SSA+GALUAR<Indikativ<jeg
kunngeqassagaluarpungali	kunngi-QAR-SSA+GALUAR<Indikativ<jeg+LI
kunngeqassagaluarpungalu	kunngi-QAR-SSA+GALUAR<Indikativ<jeg+LU
kunngeqassagaluarpugut	kunngi-QAR-SSA+GALUAR<Indikativ<vi
kunngeqassagaluarpugulli	kunngi-QAR-SSA+GALUAR<Indikativ<vi+LI
kunngeqassagaluarpit	kunngi-QAR-SSA+GALUAR<Interrogativ<du
kunngeqassagaluartunga	kunngi-QAR-SSA+GALUAR<Participium<jeg
kunngeqassagaluartungali	kunngi-QAR-SSA+GALUAR<Participium<jeg+LI
kunngeqassavoq	kunngi-QAR-SSA<Indikativ<han
kunngeqassavunga	kunngi-QAR-SSA<Indikativ<jeg
kunngeqassavungalu	kunngi-QAR-SSA<Indikativ<jeg+LU
kunngeqassavugulli	kunngi-QAR-SSA<Indikativ<vi+LI
kunngeqassavugullu	kunngi-QAR-SSA<Indikativ<vi+LU
kunngeqassavit	kunngi-QAR-SSA<Interrogativ<du
kunngeqassasunga	kunngi-QAR-SSA<Participium<jeg
kunngeqassasungali	kunngi-QAR-SSA<Participium<jeg+LI
kunngeqartaraluarpugulli	kunngi-QAR+TAR+GALUAR<Indikativ<vi+LI
kunngeqartaraluarpit	kunngi-QAR+TAR+GALUAR<Interrogativ<du
kunngeqartaraluartunga	kunngi-QAR+TAR+GALUAR<Participium<jeg
kunngeqartarpungali	kunngi-QAR+TAR<Indikativ<jeg+LI
kunngeqartarpit	kunngi-QAR+TAR<Interrogativ<du
kunngeqartassagaluarpoq	kunngi-QAR+TAR-SSA+GALUAR<Indikativ<han
kunngeqartassagaluarpunga	kunngi-QAR+TAR-SSA+GALUAR<Indikativ<jeg
kunngeqartassagaluarpungali	kunngi-QAR+TAR-SSA+GALUAR<Indikativ<jeg+LI
kunngeqartassagaluarpit	kunngi-QAR+TAR-SSA+GALUAR<Interrogativ<du
kunngeqartassagaluartunga	kunngi-QAR+TAR-SSA+GALUAR<Participium<jeg
kunngeqartassasunga	kunngi-QAR+TAR-SSA<Participium<jeg
kunngiuvoq	kunngi-U<Indikativ<han
kunngiuit	kunngi-U<Interrogativ<du
kunngiussagaluarpit	kunngi-U-SSA+GALUAR<Interrogativ<du
kunngiussavugut	kunngi-U-SSA<Indikativ<vi
Maniitsoq	Maniitsoq<Absolut
Maniitsorli	Maniitsoq<Absolut+LI
Maniitsorlu	Maniitsoq<Absolut+LU
Maniitsumik	Maniitsoq<Instrumentalis
Maniitsumilli	Maniitsoq<Instrumentalis+LI
Maniitsumillu	Maniitsoq<Instrumentalis+LU
Maniitsumi	Maniitsoq<Lokalis
Maniitsumili	Maniitsoq<Lokalis+LI
Maniitsumilu	Maniitsoq<Lokalis+LU
Maniitsormiumik	Maniitsoq+MIU<ental<Instrumentalis
Maniitsormiumilli	Maniitsoq+MIU<ental<Instrumentalis+LI
Maniitsormiumili	Maniitsoq+MIU<ental<Lokalis+LI
Maniitsormiumulli	Maniitsoq+MIU<ental<Terminalis+LI
Maniitsormiunillu	Maniitsoq+MIU<flertal<Instrumentalis+LU
Maniitsormiuni	Maniitsoq+MIU<flertal<Lokalis
Maniitsormiunilu	Maniitsoq+MIU<flertal<Lokalis+LU
Maniitsormiulerigaluartunga	Maniitsoq+MIU-LIRI+GALUAR<Participium<jeg
Maniitsormiulerivit	Maniitsoq+MIU-LIRI<Interrogativ<du
Maniitsormiulerissagaluartunga	Maniitsoq+MIU-LIRI-SSA+GALUAR<Participium<jeg
Maniitsormiulerissasunga	Maniitsoq+MIU-LIRI-SSA<Participium<jeg
Maniitsormiulerisaraluartunga	Maniitsoq+MIU-LIRI+TAR+GALUAR<Participium<jeg
Maniitsormiulerisartungalu	Maniitsoq+MIU-LIRI+TAR<Participium<jeg+LU
Maniitsormiulerisassagaluartungalu	Maniitsoq+MIU-LIRI+TAR-SSA+GALUAR<Participium<jeg+LU
Maniitsormiunngoraluartungalu	Maniitsoq+MIU-NNGUR+GALUAR<Participium<jeg+LU
Maniitsormiunngussagaluarporlu	Maniitsoq+MIU-NNGUR-SSA+GALUAR<Indikativ<han+LU
Maniitsormiunngussagaluarpunga	Maniitsoq+MIU-NNGUR-SSA+GALUAR<Indikativ<jeg
Maniitsormiunngussavit	Maniitsoq+MIU-NNGUR-SSA<Interrogativ<du
Maniitsormiunngortaraluartungalu	Maniitsoq+MIU-NNGUR+TAR+GALUAR<Participium<jeg+LU
Maniitsormioqarpoq	Maniitsoq+MIU-QAR<Indikativ<han
Maniitsormioqarporli	Maniitsoq+MIU-QAR<Indikativ<han+LI
Maniitsormioqarporlu	Maniitsoq+MIU-QAR<Indikativ<han+LU
Maniitsormiuugaluartunga	Maniitsoq+MIU-U+GALUAR<Participium<jeg
Maniitsormiuuvorli	Maniitsoq+MIU-U<Indikativ<han+LI
Maniitsormiuuvorlu	Maniitsoq+MIU-U<Indikativ<han+LU
Maniitsormiuuvugulli	Maniitsoq+MIU-U<Indikativ<vi+LI
Maniitsormiuuit	Maniitsoq+MIU-U<Interrogativ<du
Maniitsormiuusunga	Maniitsoq+MIU-U<Participium<jeg
Maniitsormiuusungali	Maniitsoq+MIU-U<Participium<jeg+LI
Maniitsormiuussagaluarpungalu	Maniitsoq+MIU-U-SSA+GALUAR<Indikativ<jeg+LU
Maniitsormiuussavoq	Maniitsoq+MIU-U-SSA<Indikativ<han
Maniitsormiuussavungali	Maniitsoq+MIU-U-SSA<Indikativ<jeg+LI
Maniitsormiuussasungali	Maniitsoq+MIU-U-SSA<Participium<jeg+LI
Maniitsormiuusaraluarpit	Maniitsoq+MIU-U+TAR+GALUAR<Interrogativ<du
Maniitsormiuusartungalu	Maniitsoq+MIU-U+TAR<Participium<jeg+LU
Maniitsormiuusassagaluarporli	Maniitsoq+MIU-U+TAR-SSA+GALUAR<Indikativ<han+LI
Maniitsormiuusassagaluarpungalu	Maniitsoq+MIU-U+TAR-SSA+GALUAR<Indikativ<jeg+LU
Maniitsormiuusassagaluarpugullu	Maniitsoq+MIU-U+TAR-SSA+GALUAR<Indikativ<vi+LU
Maniitsormiuusassagaluartungali	Maniitsoq+MIU-U+TAR-SSA+GALUAR<Participium<jeg+LI
Maniitsormiuusassasunga	Maniitsoq+MIU-U+TAR-SSA<Participium<jeg
Maniitsormiuusassasungalu	Maniitsoq+MIU-U+TAR-SSA<Participium<jeg+LU
Maniitsumut	Maniitsoq<Terminalis
Maniitsumulli	Maniitsoq<Terminalis+LI
Maniitsumullu	Maniitsoq<Terminalis+LU
najugaqarpunga	najugaqar<Indikativ<jeg
najugaqarpit	najugaqar<Interrogativ<du
najugaqartunga	najugaqar<Participium<jeg
najugaqartungali	najugaqar<Participium<jeg+LI
najugaqassagaluarpungali	najugaqar-SSA+GALUAR<Indikativ<jeg+LI
najugaqassavit	najugaqar-SSA<Interrogativ<du
najugaq	najugaq<ental<Absolut
najugarli	najugaq<ental<Absolut+LI
najugarlu	najugaq<ental<Absolut+LU
najugara	najugaq<ental<Absolut<min
najugaralu	najugaq<ental<Absolut<min+LU
najukkamik	najugaq<ental<Instrumentalis
najukkamilli	najugaq<ental<Instrumentalis+LI
najukkamillu	najugaq<ental<Instrumentalis+LU
najukkami	najugaq<ental<Lokalis
najukkamili	najugaq<ental<Lokalis+LI
najukkamilu	najugaq<ental<Lokalis+LU
najukkamut	najugaq<ental<Terminalis
najukkamulli	najugaq<ental<Terminalis+LI
najukkamullu	najugaq<ental<Terminalis+LU
najukkanik	najugaq<flertal<Instrumentalis
najukkanilli	najugaq<flertal<Instrumentalis+LI
najukkanillu	najugaq<flertal<Instrumentalis+LU
najukkani	najugaq<flertal<Lokalis
najukkanili	najugaq<flertal<Lokalis+LI
najukkanilu	najugaq<flertal<Lokalis+LU
najugalerisunga	najugaq-LIRI<Participium<jeg
najugalerisarpoq	najugaq-LIRI+TAR<Indikativ<han
najugalerisarpit	najugaq-LIRI+TAR<Interrogativ<du
najugarmiumut	najugaq+MIU<ental<Terminalis
najugarmiulerigaluartunga	najugaq+MIU-LIRI+GALUAR<Participium<jeg
najugarmiulerisassavoq	najugaq+MIU-LIRI+TAR-SSA<Indikativ<han
najugarmiunngortunga	najugaq+MIU-NNGUR<Participium<jeg
najugarmioqarporli	najugaq+MIU-QAR<Indikativ<han+LI
najugarmiuugaluartunga	najugaq+MIU-U+GALUAR<Participium<jeg
najugarmiuuit	najugaq+MIU-U<Interrogativ<du
najugarmiuussagaluarpungalu	najugaq+MIU-U-SSA+GALUAR<Indikativ<jeg+LU
najugarmiuussagaluarpugullu	najugaq+MIU-U-SSA+GALUAR<Indikativ<vi+LU
najugarmiuussagaluarpit	najugaq+MIU-U-SSA+GALUAR<Interrogativ<du
najugarmiuusaraluarpunga	najugaq+MIU-U+TAR+GALUAR<Indikativ<jeg
najugarmiuusaraluarpit	najugaq+MIU-U+TAR+GALUAR<Interrogativ<du
najugarmiuusarpit	najugaq+MIU-U+TAR<Interrogativ<du
najuganngortunga	najugaq-NNGUR<Participium<jeg
najuganngussasunga	najugaq-NNGUR-SSA<Participium<jeg
najuganngortassavugullu	najugaq-NNGUR+TAR-SSA<Indikativ<vi+LU
najugaqassagaluarpunga	najugaq-QAR-SSA+GALUAR<Indikativ<jeg
najugaqassagaluartunga	najugaq-QAR-SSA+GALUAR<Participium<jeg
najugaqartaraluarpungali	najugaq-QAR+TAR+GALUAR<Indikativ<jeg+LI
najugaqartaraluarpit	najugaq-QAR+TAR+GALUAR<Interrogativ<du
najugaasunga	najugaq-U<Participium<jeg
najugaasartunga	najugaq-U+TAR<Participium<jeg
Nanortalik	Nanortalik<Absolut
Nanortalilli	Nanortalik<Absolut+LI
Nanortalillu	Nanortalik<Absolut+LU
Nanortalimmik	Nanortalik<Instrumentalis
Nanortalimmilli	Nanortalik<Instrumentalis+LI
Nanortalimmi	Nanortalik<Lokalis
Nanortalimmiu	Nanortalik+MIU<ental<Absolut
Nanortalimmiulu	Nanortalik+MIU<ental<Absolut+LU
Nanortalimmiumi	Nanortalik+MIU<ental<Lokalis
Nanortalimmiunik	Nanortalik+MIU<flertal<Instrumentalis
Nanortalimmiulerissasungali	Nanortalik+MIU-LIRI-SSA<Participium<jeg+LI
Nanortalimmiulerisaraluarpit	Nanortalik+MIU-LIRI+TAR+GALUAR<Interrogativ<du
Nanortalimmiulerisassagaluarpit	Nanortalik+MIU-LIRI+TAR-SSA+GALUAR<Interrogativ<du
Nanortalimmiunngoraluarpugulli	Nanortalik+MIU-NNGUR+GALUAR<Indikativ<vi+LI
Nanortalimmiunngussagaluarpunga	Nanortalik+MIU-NNGUR-SSA+GALUAR<Indikativ<jeg
Nanortalimmiunngussagaluarpit	Nanortalik+MIU-NNGUR-SSA+GALUAR<Interrogativ<du
Nanortalimmiunngortaraluarpoq	Nanortalik+MIU-NNGUR+TAR+GALUAR<Indikativ<han
Nanortalimmiunngortassagaluartungalu	Nanortalik+MIU-NNGUR+TAR-SSA+GALUAR<Participium<jeg+LU
Nanortalimmioqarpoq	Nanortalik+MIU-QAR<Indikativ<han
Nanortalimmioqarporli	Nanortalik+MIU-QAR<Indikativ<han+LI
Nanortalimmioqarporlu	Nanortalik+MIU-QAR<Indikativ<han+LU
Nanortalimmiuugaluartungali	Nanortalik+MIU-U+GALUAR<Participium<jeg+LI
Nanortalimmiuuvunga	Nanortalik+MIU-U<Indikativ<jeg
Nanortalimmiuusungali	Nanortalik+MIU-U<Participium<jeg+LI
Nanortalimmiuussagaluarpit	Nanortalik+MIU-U-SSA+GALUAR<Interrogativ<du
Nanortalimmiuussagaluartunga	Nanortalik+MIU-U-SSA+GALUAR<Participium<jeg
Nanortalimmiuussasunga	Nanortalik+MIU-U-SSA<Participium<jeg
Nanortalimmiuusassagaluarpit	Nanortalik+MIU-U+TAR-SSA+GALUAR<Interrogativ<du
Nanortalimmut	Nanortalik<Terminalis
Nanortalimmulli	Nanortalik<Terminalis+LI
Narsaq	Narsaq<Absolut
Narsarli	Narsaq<Absolut+LI
Narsamik	Narsaq<Instrumentalis
Narsami	Narsaq<Lokalis
Narsamili	Narsaq<Lokalis+LI
Narsamilu	Narsaq<Lokalis+LU
Narsarmiu	Narsaq+MIU<ental<Absolut
Narsarmiumik	Narsaq+MIU<ental<Instrumentalis
Narsarmiumi	Narsaq+MIU<ental<Lokalis
Narsarmiumulli	Narsaq+MIU<ental<Terminalis+LI
Narsarmiunillu	Narsaq+MIU<flertal<Instrumentalis+LU
Narsarmiulerissagaluarpugullu	Narsaq+MIU-LIRI-SSA+GALUAR<Indikativ<vi+LU
Narsarmiulerisassasunga	Narsaq+MIU-LIRI+TAR-SSA<Participium<jeg
Narsarmiunngussagaluarpit	Narsaq+MIU-NNGUR-SSA+GALUAR<Interrogativ<du
Narsarmiunngussavit	Narsaq+MIU-NNGUR-SSA<Interrogativ<du
Narsarmioqarpoq	Narsaq+MIU-QAR<Indikativ<han
Narsarmioqarporli	Narsaq+MIU-QAR<Indikativ<han+LI
Narsarmiuusunga	Narsaq+MIU-U<Participium<jeg
Narsarmiuusartunga	Narsaq+MIU-U+TAR<Participium<jeg
Narsamut	Narsaq<Terminalis
Narsamullu	Narsaq<Terminalis+LU
Narsarsuaq	Narsarsuaq<Absolut
Narsarsuarlu	Narsarsuaq<Absolut+LU
Narsarsuarmilu	Narsarsuaq<Lokalis+LU
Narsarsuarmiuni	Narsarsuaq+MIU<flertal<Lokalis
Narsarsuarmiunngussagaluartunga	Narsarsuaq+MIU-NNGUR-SSA+GALUAR<Participium<jeg
Narsarsuarmiuusunga	Narsarsuaq+MIU-U<Participium<jeg
Narsarsuarmulli	Narsarsuaq<Terminalis+LI
Narsarsuarmullu	Narsarsuaq<Terminalis+LU
nuliaq	nuliaq<ental<Absolut
nuliarli	nuliaq<ental<Absolut+LI
nuliarlu	nuliaq<ental<Absolut+LU
nuliara	nuliaq<ental<Absolut<min
nuliarali	nuliaq<ental<Absolut<min+LI
nuliaralu	nuliaq<ental<Absolut<min+LU
nuliami	nuliaq<ental<Lokalis
nuliamili	nuliaq<ental<Lokalis+LI
nuliamut	nuliaq<ental<Terminalis
nuliamulli	nuliaq<ental<Terminalis+LI
nulianik	nuliaq<flertal<Instrumentalis
nulianillu	nuliaq<flertal<Instrumentalis+LU
nuliani	nuliaq<flertal<Lokalis
nulianilu	nuliaq<flertal<Lokalis+LU
nulialerivungali	nuliaq-LIRI<Indikativ<jeg+LI
nulialerivit	nuliaq-LIRI<Interrogativ<du
nulialerisartunga	nuliaq-LIRI+TAR<Participium<jeg
nulialerisartungali	nuliaq-LIRI+TAR<Participium<jeg+LI
nulialerisassagaluarpunga	nuliaq-LIRI+TAR-SSA+GALUAR<Indikativ<jeg
nuliarmiumilli	nuliaq+MIU<ental<Instrumentalis+LI
nuliarmiumi	nuliaq+MIU<ental<Lokalis
nuliarmiumut	nuliaq+MIU<ental<Terminalis
nuliarmiulerissasungalu	nuliaq+MIU-LIRI-SSA<Participium<jeg+LU
nuliarmiunngorpit	nuliaq+MIU-NNGUR<Interrogativ<du
nuliarmiunngussavorli	nuliaq+MIU-NNGUR-SSA<Indikativ<han+LI
nuliarmiunngussavunga	nuliaq+MIU-NNGUR-SSA<Indikativ<jeg
nuliarmiunngortassagaluarpungalu	nuliaq+MIU-NNGUR+TAR-SSA+GALUAR<Indikativ<jeg+LU
nuliarmioqarpoq	nuliaq+MIU-QAR<Indikativ<han
nuliarmioqarporli	nuliaq+MIU-QAR<Indikativ<han+LI
nuliarmioqarporlu	nuliaq+MIU-QAR<Indikativ<han+LU
nuliarmiuugaluarpungali	nuliaq+MIU-U+GALUAR<Indikativ<jeg+LI
nuliarmiuuvorlu	nuliaq+MIU-U<Indikativ<han+LU
nuliarmiuuit	nuliaq+MIU-U<Interrogativ<du
nuliarmiuussagaluarpugulli	nuliaq+MIU-U-SSA+GALUAR<Indikativ<vi+LI
nuliarmiuusarpoq	nuliaq+MIU-U+TAR<Indikativ<han
nuliarmiuusassagaluarpit	nuliaq+MIU-U+TAR-SSA+GALUAR<Interrogativ<du
nulianngoraluartunga	nuliaq-NNGUR+GALUAR<Participium<jeg
nulianngussagaluartunga	nuliaq-NNGUR-SSA+GALUAR<Participium<jeg
nulianngussavunga	nuliaq-NNGUR-SSA<Indikativ<jeg
nulianngussasunga	nuliaq-NNGUR-SSA<Participium<jeg
nulianngussasungali	nuliaq-NNGUR-SSA<Participium<jeg+LI
nuliaqarpit	nuliaq-QAR<Interrogativ<du
nuliaqassagaluarpit	nuliaq-QAR-SSA+GALUAR<Interrogativ<du
nuliaqassasungalu	nuliaq-QAR-SSA<Participium<jeg+LU
nuliaagaluartungalu	nuliaq-U+GALUAR<Participium<jeg+LU
nuliaavugut	nuliaq-U<Indikativ<vi
nuliaasungali	nuliaq-U<Participium<jeg+LI
nuliaassasunga	nuliaq-U-SSA<Participium<jeg
nuliaasaraluartungali	nuliaq-U+TAR+GALUAR<Participium<jeg+LI
Nuuk	Nuuk<Absolut
Nuulli	Nuuk<Absolut+LI
Nuullu	Nuuk<Absolut+LU
Nuummik	Nuuk<Instrumentalis
Nuummilli	Nuuk<Instrumentalis+LI
Nuummi	Nuuk<Lokalis
Nuummili	Nuuk<Lokalis+LI
Nuummilu	Nuuk<Lokalis+LU
Nuummiumik	Nuuk+MIU<ental<Instrumentalis
Nuummiumillu	Nuuk+MIU<ental<Instrumentalis+LU
Nuummiumili	Nuuk+MIU<ental<Lokalis+LI
Nuummiunik	Nuuk+MIU<flertal<Instrumentalis
Nuummiulerigaluartunga	Nuuk+MIU-LIRI+GALUAR<Participium<jeg
Nuummiulerisassasunga	Nuuk+MIU-LIRI+TAR-SSA<Participium<jeg
Nuummiunngoraluartungalu	Nuuk+MIU-NNGUR+GALUAR<Participium<jeg+LU
Nuummiunngorpit	Nuuk+MIU-NNGUR<Interrogativ<du
Nuummioqarpoq	Nuuk+MIU-QAR<Indikativ<han
Nuummioqarporli	Nuuk+MIU-QAR<Indikativ<han+LI
Nuummioqarporlu	Nuuk+MIU-QAR<Indikativ<han+LU
Nuummiuugaluartunga	Nuuk+MIU-U+GALUAR<Participium<jeg
Nuummiuugaluartungali	Nuuk+MIU-U+GALUAR<Participium<jeg+LI
Nuummiuuvungali	Nuuk+MIU-U<Indikativ<jeg+LI
Nuummiuuvugulli	Nuuk+MIU-U<Indikativ<vi+LI
Nuummiuuvugullu	Nuuk+MIU-U<Indikativ<vi+LU
Nuummiuuit	Nuuk+MIU-U<Interrogativ<du
Nuummiuusungali	Nuuk+MIU-U<Participium<jeg+LI
Nuummiuussagaluarpunga	Nuuk+MIU-U-SSA+GALUAR<Indikativ<jeg
Nuummiuussagaluarpugut	Nuuk+MIU-U-SSA+GALUAR<Indikativ<vi
Nuummiuussavungali	Nuuk+MIU-U-SSA<Indikativ<jeg+LI
Nuummiuussasungalu	Nuuk+MIU-U-SSA<Participium<jeg+LU
Nuummiuusaraluarpugulli	Nuuk+MIU-U+TAR+GALUAR<Indikativ<vi+LI
Nuummut	Nuuk<Terminalis
Nuummulli	Nuuk<Terminalis+LI
oqaaseq	oqaaseq<ental<Absolut
oqaaserli	oqaaseq<ental<Absolut+LI
oqaaserlu	oqaaseq<ental<Absolut+LU
oqaasera	oqaaseq<ental<Absolut<min
oqaaserali	oqaaseq<ental<Absolut<min+LI
oqaaseralu	oqaaseq<ental<Absolut<min+LU
oqaatsimik	oqaaseq<ental<Instrumentalis
oqaatsimilli	oqaaseq<ental<Instrumentalis+LI
oqaatsimillu	oqaaseq<ental<Instrumentalis+LU
oqaatsimi	oqaaseq<ental<Lokalis
oqaatsimili	oqaaseq<ental<Lokalis+LI
oqaatsimilu	oqaaseq<ental<Lokalis+LU
oqaatsimut	oqaaseq<ental<Terminalis
oqaatsimulli	oqaaseq<ental<Terminalis+LI
oqaatsimullu	oqaaseq<ental<Terminalis+LU
oqaatsinik	oqaaseq<flertal<Instrumentalis
oqaatsinilli	oqaaseq<flertal<Instrumentalis+LI
oqaatsinillu	oqaaseq<flertal<Instrumentalis+LU
oqaatsini	oqaaseq<flertal<Lokalis
oqaatsinili	oqaaseq<flertal<Lokalis+LI
oqaatsinilu	oqaaseq<flertal<Lokalis+LU
oqaasilerigaluarpit	oqaaseq-LIRI+GALUAR<Interrogativ<du
oqaasilerivoq	oqaaseq-LIRI<Indikativ<han
oqaasilerivunga	oqaaseq-LIRI<Indikativ<jeg
oqaasilerivungalu	oqaaseq-LIRI<Indikativ<jeg+LU
oqaasilerivit	oqaaseq-LIRI<Interrogativ<du
oqaasilerisunga	oqaaseq-LIRI<Participium<jeg
oqaasilerisungali	oqaaseq-LIRI<Participium<jeg+LI
oqaasilerisungalu	oqaaseq-LIRI<Participium<jeg+LU
oqaasilerissagaluarpunga	oqaaseq-LIRI-SSA+GALUAR<Indikativ<jeg
oqaasilerissagaluarpit	oqaaseq-LIRI-SSA+GALUAR<Interrogativ<du
oqaasilerissavit	oqaaseq-LIRI-SSA<Interrogativ<du
oqaasilerissasungali	oqaaseq-LIRI-SSA<Participium<jeg+LI
oqaasilerisaraluarpugut	oqaaseq-LIRI+TAR+GALUAR<Indikativ<vi
oqaasilerisaraluartungali	oqaaseq-LIRI+TAR+GALUAR<Participium<jeg+LI
oqaasilerisarpunga	oqaaseq-LIRI+TAR<Indikativ<jeg
oqaasilerisartunga	oqaaseq-LIRI+TAR<Participium<jeg
oqaasilerisassagaluarporli	oqaaseq-LIRI+TAR-SSA+GALUAR<Indikativ<han+LI
oqaasilerisassagaluarpit	oqaaseq-LIRI+TAR-SSA+GALUAR<Interrogativ<du
oqaasilerisassasunga	oqaaseq-LIRI+TAR-SSA<Participium<jeg
oqaasermioqarpoq	oqaaseq+MIU-QAR<Indikativ<han
oqaasermioqarporli	oqaaseq+MIU-QAR<Indikativ<han+LI
oqaasermiuuvoq	oqaaseq+MIU-U<Indikativ<han
oqaasermiuussagaluarpungali	oqaaseq+MIU-U-SSA+GALUAR<Indikativ<jeg+LI
oqaasermiuussavoq	oqaaseq+MIU-U-SSA<Indikativ<han
oqaasermiuussavunga	oqaaseq+MIU-U-SSA<Indikativ<jeg
oqaasermiuusarpungali	oqaaseq+MIU-U+TAR<Indikativ<jeg+LI
oqaasermiuusarpit	oqaaseq+MIU-U+TAR<Interrogativ<du
oqaasermiuusassavit	oqaaseq+MIU-U+TAR-SSA<Interrogativ<du
oqaasinngortungali	oqaaseq-NNGUR<Participium<jeg+LI
oqaasinngussagaluarpungali	oqaaseq-NNGUR-SSA+GALUAR<Indikativ<jeg+LI
oqaasinngussagaluarpit	oqaaseq-NNGUR-SSA+GALUAR<Interrogativ<du
oqaasinngussagaluartunga	oqaaseq-NNGUR-SSA+GALUAR<Participium<jeg
oqaasinngussavunga	oqaaseq-NNGUR-SSA<Indikativ<jeg
oqaasinngussasunga	oqaaseq-NNGUR-SSA<Participium<jeg
oqaasinngortassasungalu	oqaaseq-NNGUR+TAR-SSA<Participium<jeg+LU
oqaaseqarpoq	oqaaseq-QAR<Indikativ<han
oqaaseqarpugullu	oqaaseq-QAR<Indikativ<vi+LU
oqaaseqartunga	oqaaseq-QAR<Participium<jeg
oqaaseqassagaluarpunga	oqaaseq-QAR-SSA+GALUAR<Indikativ<jeg
oqaaseqassagaluarpugulli	oqaaseq-QAR-SSA+GALUAR<Indikativ<vi+LI
oqaaseqassagaluarpit	oqaaseq-QAR-SSA+GALUAR<Interrogativ<du
oqaaseqassagaluartunga	oqaaseq-QAR-SSA+GALUAR<Participium<jeg
oqaaseqassavunga	oqaaseq-QAR-SSA<Indikativ<jeg
oqaaseqassavugut	oqaaseq-QAR-SSA<Indikativ<vi
oqaaseqassavugullu	oqaaseq-QAR-SSA<Indikativ<vi+LU
oqaaseqassavit	oqaaseq-QAR-SSA<Interrogativ<du
oqaaseqassasunga	oqaaseq-QAR-SSA<Participium<jeg
oqaaseqassasungali	oqaaseq-QAR-SSA<Participium<jeg+LI
oqaasiugaluarpit	oqaaseq-U+GALUAR<Interrogativ<du
oqaasiugaluartungalu	oqaaseq-U+GALUAR<Participium<jeg+LU
oqaasiuvunga	oqaaseq-U<Indikativ<jeg
oqaasiuvugulli	oqaaseq-U<Indikativ<vi+LI
oqaasiusunga	oqaaseq-U<Participium<jeg
oqaasiusungali	oqaaseq-U<Participium<jeg+LI
oqaasiussasunga	oqaaseq-U-SSA<Participium<jeg
oqaasiusaraluartungali	oqaaseq-U+TAR+GALUAR<Participium<jeg+LI
oqaasiusassagaluarpugullu	oqaaseq-U+TAR-SSA+GALUAR<Indikativ<vi+LU
oqaasilerisoq	oqaasilerisoq<ental<Absolut
oqaasilerisorli	oqaasilerisoq<ental<Absolut+LI
oqaasilerisorlu	oqaasilerisoq<ental<Absolut+LU
oqaasilerisorali	oqaasilerisoq<ental<Absolut<min+LI
oqaasilerisoralu	oqaasilerisoq<ental<Absolut<min+LU
oqaasilerisumik	oqaasilerisoq<ental<Instrumentalis
oqaasilerisumi	oqaasilerisoq<ental<Lokalis
oqaasilerisumili	oqaasilerisoq<ental<Lokalis+LI
oqaasilerisumulli	oqaasilerisoq<ental<Terminalis+LI
oqaasilerisunilli	oqaasilerisoq<flertal<Instrumentalis+LI
oqaasilerisunillu	oqaasilerisoq<flertal<Instrumentalis+LU
oqaasilerisulerisarpungali	oqaasilerisoq-LIRI+TAR<Indikativ<jeg+LI
oqaasilerisulerisassagaluarpugut	oqaasilerisoq-LIRI+TAR-SSA+GALUAR<Indikativ<vi
oqaasilerisulerisassagaluarpit	oqaasilerisoq-LIRI+TAR-SSA+GALUAR<Interrogativ<du
oqaasilerisulerisassavunga	oqaasilerisoq-LIRI+TAR-SSA<Indikativ<jeg
oqaasilerisormiulu	oqaasilerisoq+MIU<ental<Absolut+LU
oqaasilerisormiulerivunga	oqaasilerisoq+MIU-LIRI<Indikativ<jeg
oqaasilerisormiuusarpit	oqaasilerisoq+MIU-U+TAR<Interrogativ<du
oqaasilerisormiuusartunga	oqaasilerisoq+MIU-U+TAR<Participium<jeg
oqaasilerisormiuusassagaluartunga	oqaasilerisoq+MIU-U+TAR-SSA+GALUAR<Participium<jeg
oqaasilerisormiuusassavit	oqaasilerisoq+MIU-U+TAR-SSA<Interrogativ<du
oqaasilerisunngussagaluarporlu	oqaasilerisoq-NNGUR-SSA+GALUAR<Indikativ<han+LU
oqaasilerisoqarpungali	oqaasilerisoq-QAR<Indikativ<jeg+LI
oqaasilerisoqarpit	oqaasilerisoq-QAR<Interrogativ<du
oqaasilerisoqassagaluarpugullu	oqaasilerisoq-QAR-SSA+GALUAR<Indikativ<vi+LU
oqaasilerisoqassavunga	oqaasilerisoq-QAR-SSA<Indikativ<jeg
oqaasilerisoqassavugut	oqaasilerisoq-QAR-SSA<Indikativ<vi
oqaasilerisoqassasunga	oqaasilerisoq-QAR-SSA<Participium<jeg
oqaasilerisoqartartunga	oqaasilerisoq-QAR+TAR<Participium<jeg
oqaasilerisoqartassagaluarpunga	oqaasilerisoq-QAR+TAR-SSA+GALUAR<Indikativ<jeg
oqaasilerisuugaluartunga	oqaasilerisoq-U+GALUAR<Participium<jeg
oqaasilerisuuvugut	oqaasilerisoq-U<Indikativ<vi
oqaasilerisuusassagaluarpit	oqaasilerisoq-U+TAR-SSA+GALUAR<Interrogativ<du
Paamiut	Paamiut<Absolut
Paamiulli	Paamiut<Absolut+LI
Paamiullu	Paamiut<Absolut+LU
Paamiunik	Paamiut<Instrumentalis
Paamiunilli	Paamiut<Instrumentalis+LI
Paamiunillu	Paamiut<Instrumentalis+LU
Paamiuni	Paamiut<Lokalis
Paamiunili	Paamiut<Lokalis+LI
Paamiunilu	Paamiut<Lokalis+LU
Paamiormiu	Paamiut+MIU<ental<Absolut
Paamiormiuli	Paamiut+MIU<ental<Absolut+LI
Paamiormiumilli	Paamiut+MIU<ental<Instrumentalis+LI
Paamiormiumili	Paamiut+MIU<ental<Lokalis+LI
Paamiormiumut	Paamiut+MIU<ental<Terminalis
Paamiormiumulli	Paamiut+MIU<ental<Terminalis+LI
Paamiormiunik	Paamiut+MIU<flertal<Instrumentalis
Paamiormiunilli	Paamiut+MIU<flertal<Instrumentalis+LI
Paamiormiunillu	Paamiut+MIU<flertal<Instrumentalis+LU
Paamiormiuni	Paamiut+MIU<flertal<Lokalis
Paamiormiulerigaluarpunga	Paamiut+MIU-LIRI+GALUAR<Indikativ<jeg
Paamiormiulerivit	Paamiut+MIU-LIRI<Interrogativ<du
Paamiormiulerisungali	Paamiut+MIU-LIRI<Participium<jeg+LI
Paamiormiulerissagaluartungali	Paamiut+MIU-LIRI-SSA+GALUAR<Participium<jeg+LI
Paamiormiulerissasunga	Paamiut+MIU-LIRI-SSA<Participium<jeg
Paamiormiulerisaraluarpungali	Paamiut+MIU-LIRI+TAR+GALUAR<Indikativ<jeg+LI
Paamiormiulerisaraluarpit	Paamiut+MIU-LIRI+TAR+GALUAR<Interrogativ<du
Paamiormiulerisaraluartungalu	Paamiut+MIU-LIRI+TAR+GALUAR<Participium<jeg+LU
Paamiormiulerisassagaluartunga	Paamiut+MIU-LIRI+TAR-SSA+GALUAR<Participium<jeg
Paamiormiulerisassavit	Paamiut+MIU-LIRI+TAR-SSA<Interrogativ<du
Paamiormiunngoraluarpunga	Paamiut+MIU-NNGUR+GALUAR<Indikativ<jeg
Paamiormiunngorpunga	Paamiut+MIU-NNGUR<Indikativ<jeg
Paamiormiunngussagaluarporli	Paamiut+MIU-NNGUR-SSA+GALUAR<Indikativ<han+LI
Paamiormiunngussagaluarpugulli	Paamiut+MIU-NNGUR-SSA+GALUAR<Indikativ<vi+LI
Paamiormiunngussagaluarpit	Paamiut+MIU-NNGUR-SSA+GALUAR<Interrogativ<du
Paamiormiunngussagaluartungalu	Paamiut+MIU-NNGUR-SSA+GALUAR<Participium<jeg+LU
Paamiormiunngussavit	Paamiut+MIU-NNGUR-SSA<Interrogativ<du
Paamiormiunngortaraluartunga	Paamiut+MIU-NNGUR+TAR+GALUAR<Participium<jeg
Paamiormiunngortarporli	Paamiut+MIU-NNGUR+TAR<Indikativ<han+LI
Paamiormiunngortarpit	Paamiut+MIU-NNGUR+TAR<Interrogativ<du
Paamiormiunngortassavungalu	Paamiut+MIU-NNGUR+TAR-SSA<Indikativ<jeg+LU
Paamiormioqarpoq	Paamiut+MIU-QAR<Indikativ<han
Paamiormioqarporli	Paamiut+MIU-QAR<Indikativ<han+LI
Paamiormioqarporlu	Paamiut+MIU-QAR<Indikativ<han+LU
Paamiormiuugaluarpugullu	Paamiut+MIU-U+GALUAR<Indikativ<vi+LU
Paamiormiuugaluarpit	Paamiut+MIU-U+GALUAR<Interrogativ<du
Paamiormiuuvoq	Paamiut+MIU-U<Indikativ<han
Paamiormiuuvunga	Paamiut+MIU-U<Indikativ<jeg
Paamiormiuuvugut	Paamiut+MIU-U<Indikativ<vi
Paamiormiuuvugulli	Paamiut+MIU-U<Indikativ<vi+LI
Paamiormiuuit	Paamiut+MIU-U<Interrogativ<du
Paamiormiuusunga	Paamiut+MIU-U<Participium<jeg
Paamiormiuusungali	Paamiut+MIU-U<Participium<jeg+LI
Paamiormiuussavit	Paamiut+MIU-U-SSA<Interrogativ<du
Paamiormiuusaraluarpunga	Paamiut+MIU-U+TAR+GALUAR<Indikativ<jeg
Paamiormiuusaraluarpungalu	Paamiut+MIU-U+TAR+GALUAR<Indikativ<jeg+LU
Paamiormiuusaraluarpugut	Paamiut+MIU-U+TAR+GALUAR<Indikativ<vi
Paamiormiuusaraluartunga	Paamiut+MIU-U+TAR+GALUAR<Participium<jeg
Paamiormiuusaraluartungali	Paamiut+MIU-U+TAR+GALUAR<Participium<jeg+LI
Paamiormiuusarpit	Paamiut+MIU-U+TAR<Interrogativ<du
Paamiormiuusartunga	Paamiut+MIU-U+TAR<Participium<jeg
Paamiormiuusassagaluarporlu	Paamiut+MIU-U+TAR-SSA+GALUAR<Indikativ<han+LU
Paamiormiuusassagaluarpit	Paamiut+MIU-U+TAR-SSA+GALUAR<Interrogativ<du
Paamiormiuusassagaluartunga	Paamiut+MIU-U+TAR-SSA+GALUAR<Participium<jeg
Paamiormiuusassavugullu	Paamiut+MIU-U+TAR-SSA<Indikativ<vi+LU
Paamiormiuusassasunga	Paamiut+MIU-U+TAR-SSA<Participium<jeg
piareeraluarporli	piareer+GALUAR<Indikativ<han+LI
piareeraluarpunga	piareer+GALUAR<Indikativ<jeg
piareeraluarpungali	piareer+GALUAR<Indikativ<jeg+LI
piareeraluarpit	piareer+GALUAR<Interrogativ<du
piareeraluartunga	piareer+GALUAR<Participium<jeg
piareeraluartungali	piareer+GALUAR<Participium<jeg+LI
piareerpoq	piareer<Indikativ<han
piareerporli	piareer<Indikativ<han+LI
piareerporlu	piareer<Indikativ<han+LU
piareerpunga	piareer<Indikativ<jeg
piareerpungali	piareer<Indikativ<jeg+LI
piareerpugut	piareer<Indikativ<vi
piareerpugulli	piareer<Indikativ<vi+LI
piareerpugullu	piareer<Indikativ<vi+LU
piareerpit	piareer<Interrogativ<du
piareertunga	piareer<Participium<jeg
piareertungali	piareer<Participium<jeg+LI
piareertungalu	piareer<Participium<jeg+LU
piariissagaluarporli	piareer-SSA+GALUAR<Indikativ<han+LI
piariissagaluarpunga	piareer-SSA+GALUAR<Indikativ<jeg
piariissagaluarpungali	piareer-SSA+GALUAR<Indikativ<jeg+LI
piariissagaluarpungalu	piareer-SSA+GALUAR<Indikativ<jeg+LU
piariissagaluarpugut	piareer-SSA+GALUAR<Indikativ<vi
piariissagaluarpugulli	piareer-SSA+GALUAR<Indikativ<vi+LI
piariissagaluarpit	piareer-SSA+GALUAR<Interrogativ<du
piariissagaluartunga	piareer-SSA+GALUAR<Participium<jeg
piariissagaluartungali	piareer-SSA+GALUAR<Participium<jeg+LI
piariissagaluartungalu	piareer-SSA+GALUAR<Participium<jeg+LU
piariissavoq	piareer-SSA<Indikativ<han
piariissavorli	piareer-SSA<Indikativ<han+LI
piariissavorlu	piareer-SSA<Indikativ<han+LU
piariissavunga	piareer-SSA<Indikativ<jeg
piariissavungali	piareer-SSA<Indikativ<jeg+LI
piariissavungalu	piareer-SSA<Indikativ<jeg+LU
piariissavugut	piareer-SSA<Indikativ<vi
piariissavugulli	piareer-SSA<Indikativ<vi+LI
piariissavugullu	piareer-SSA<Indikativ<vi+LU
piariissavit	piareer-SSA<Interrogativ<du
piariissasunga	piareer-SSA<Participium<jeg
piariissasungali	piareer-SSA<Participium<jeg+LI
piariissasungalu	piareer-SSA<Participium<jeg+LU
piareertaraluarpoq	piareer+TAR+GALUAR<Indikativ<han
piareertaraluarpunga	piareer+TAR+GALUAR<Indikativ<jeg
piareertaraluarpugut	piareer+TAR+GALUAR<Indikativ<vi
piareertaraluarpugulli	piareer+TAR+GALUAR<Indikativ<vi+LI
piareertaraluarpit	piareer+TAR+GALUAR<Interrogativ<du
piareertaraluartunga	piareer+TAR+GALUAR<Participium<jeg
piareertaraluartungali	piareer+TAR+GALUAR<Participium<jeg+LI
piareertaraluartungalu	piareer+TAR+GALUAR<Participium<jeg+LU
piareertarpungali	piareer+TAR<Indikativ<jeg+LI
piareertarpit	piareer+TAR<Interrogativ<du
piareertartunga	piareer+TAR<Participium<jeg
piareertartungali	piareer+TAR<Participium<jeg+LI
piareertassagaluarporlu	piareer+TAR-SSA+GALUAR<Indikativ<han+LU
piareertassagaluarpungalu	piareer+TAR-SSA+GALUAR<Indikativ<jeg+LU
piareertassagaluarpugut	piareer+TAR-SSA+GALUAR<Indikativ<vi
piareertassagaluarpugullu	piareer+TAR-SSA+GALUAR<Indikativ<vi+LU
piareertassagaluarpit	piareer+TAR-SSA+GALUAR<Interrogativ<du
piareertassagaluartunga	piareer+TAR-SSA+GALUAR<Participium<jeg
piareertassagaluartungali	piareer+TAR-SSA+GALUAR<Participium<jeg+LI
piareertassavoq	piareer+TAR-SSA<Indikativ<han
piareertassavungalu	piareer+TAR-SSA<Indikativ<jeg+LU
piareertassavugut	piareer+TAR-SSA<Indikativ<vi
piareertassavugulli	piareer+TAR-SSA<Indikativ<vi+LI
piareertassavit	piareer+TAR-SSA<Interrogativ<du
piareertassasungalu	piareer+TAR-SSA<Participium<jeg+LU
qallunaaq	qallunaaq<ental<Absolut
qallunaarli	qallunaaq<ental<Absolut+LI
qallunaarlu	qallunaaq<ental<Absolut+LU
qallunaamik	qallunaaq<ental<Instrumentalis
qallunaamilli	qallunaaq<ental<Instrumentalis+LI
qallunaamillu	qallunaaq<ental<Instrumentalis+LU
qallunaami	qallunaaq<ental<Lokalis
qallunaamili	qallunaaq<ental<Lokalis+LI
qallunaamilu	qallunaaq<ental<Lokalis+LU
qallunaamut	qallunaaq<ental<Terminalis
qallunaamulli	qallunaaq<ental<Terminalis+LI
qallunaamullu	qallunaaq<ental<Terminalis+LU
qallunaanik	qallunaaq<flertal<Instrumentalis
qallunaanilli	qallunaaq<flertal<Instrumentalis+LI
qallunaanillu	qallunaaq<flertal<Instrumentalis+LU
qallunaani	qallunaaq<flertal<Lokalis
qallunaanili	qallunaaq<flertal<Lokalis+LI
qallunaanilu	qallunaaq<flertal<Lokalis+LU
qallunaanngoraluarpoq	qallunaaq-NNGUR+GALUAR<Indikativ<han
qallunaanngoraluarporli	qallunaaq-NNGUR+GALUAR<Indikativ<han+LI
qallunaanngoraluarporlu	qallunaaq-NNGUR+GALUAR<Indikativ<han+LU
qallunaanngorporli	qallunaaq-NNGUR<Indikativ<han+LI
qallunaanngussagaluarporli	qallunaaq-NNGUR-SSA+GALUAR<Indikativ<han+LI
qallunaanngussavoq	qallunaaq-NNGUR-SSA<Indikativ<han
qallunaanngussavorli	qallunaaq-NNGUR-SSA<Indikativ<han+LI
qallunaanngussavorlu	qallunaaq-NNGUR-SSA<Indikativ<han+LU
qallunaanngortaraluarpoq	qallunaaq-NNGUR+TAR+GALUAR<Indikativ<han
qallunaanngortarpoq	qallunaaq-NNGUR+TAR<Indikativ<han
qallunaanngortarporli	qallunaaq-NNGUR+TAR<Indikativ<han+LI
qallunaanngortassagaluarpit	qallunaaq-NNGUR+TAR-SSA+GALUAR<Interrogativ<du
qallunaanngortassavunga	qallunaaq-NNGUR+TAR-SSA<Indikativ<jeg
qallunaanngortassasunga	qallunaaq-NNGUR+TAR-SSA<Participium<jeg
qallunaaqaraluarporli	qallunaaq-QAR+GALUAR<Indikativ<han+LI
qallunaaqaraluarporlu	qallunaaq-QAR+GALUAR<Indikativ<han+LU
qallunaaqarporli	qallunaaq-QAR<Indikativ<han+LI
qallunaaqarporlu	qallunaaq-QAR<Indikativ<han+LU
qallunaaqassagaluarpoq	qallunaaq-QAR-SSA+GALUAR<Indikativ<han
qallunaaqassagaluarporli	qallunaaq-QAR-SSA+GALUAR<Indikativ<han+LI
qallunaaqassagaluarporlu	qallunaaq-QAR-SSA+GALUAR<Indikativ<han+LU
qallunaaqassavoq	qallunaaq-QAR-SSA<Indikativ<han
qallunaaqassavorli	qallunaaq-QAR-SSA<Indikativ<han+LI
qallunaaqassavorlu	qallunaaq-QAR-SSA<Indikativ<han+LU
qallunaaqartaraluarporlu	qallunaaq-QAR+TAR+GALUAR<Indikativ<han+LU
qallunaaqartarporli	qallunaaq-QAR+TAR<Indikativ<han+LI
qallunaaqartassagaluarpit	qallunaaq-QAR+TAR-SSA+GALUAR<Interrogativ<du
qallunaaqartassavit	qallunaaq-QAR+TAR-SSA<Interrogativ<du
qallunaajugaluarporlu	qallunaaq-U+GALUAR<Indikativ<han+LU
qallunaajugaluarpunga	qallunaaq-U+GALUAR<Indikativ<jeg
qallunaajugaluartunga	qallunaaq-U+GALUAR<Participium<jeg
qallunaajuvoq	qallunaaq-U<Indikativ<han
qallunaajuvorli	qallunaaq-U<Indikativ<han+LI
qallunaajuvugulli	qallunaaq-U<Indikativ<vi+LI
qallunaajuit	qallunaaq-U<Interrogativ<du
qallunaajusunga	qallunaaq-U<Participium<jeg
qallunaajusungali	qallunaaq-U<Participium<jeg+LI
qallunaajussagaluarpungali	qallunaaq-U-SSA+GALUAR<Indikativ<jeg+LI
qallunaajussavugulli	qallunaaq-U-SSA<Indikativ<vi+LI
qallunaajussavit	qallunaaq-U-SSA<Interrogativ<du
qallunaajusaraluarpugulli	qallunaaq-U+TAR+GALUAR<Indikativ<vi+LI
qallunaajusaraluarpit	qallunaaq-U+TAR+GALUAR<Interrogativ<du
qallunaajusarpit	qallunaaq-U+TAR<Interrogativ<du
qallunaajusartunga	qallunaaq-U+TAR<Participium<jeg
qallunaajusassagaluarpunga	qallunaaq-U+TAR-SSA+GALUAR<Indikativ<jeg
qallunaajusassagaluarpungali	qallunaaq-U+TAR-SSA+GALUAR<Indikativ<jeg+LI
qallunaajusassagaluarpugut	qallunaaq-U+TAR-SSA+GALUAR<Indikativ<vi
qallunaajusassasungali	qallunaaq-U+TAR-SSA<Participium<jeg+LI
Qaqortoq	Qaqortoq<Absolut
Qaqortorli	Qaqortoq<Absolut+LI
Qaqortumik	Qaqortoq<Instrumentalis
Qaqortumilli	Qaqortoq<Instrumentalis+LI
Qaqortumi	Qaqortoq<Lokalis
Qaqortumili	Qaqortoq<Lokalis+LI
Qaqortumilu	Qaqortoq<Lokalis+LU
Qaqortormiulu	Qaqortoq+MIU<ental<Absolut+LU
Qaqortormiumulli	Qaqortoq+MIU<ental<Terminalis+LI
Qaqortormiuni	Qaqortoq+MIU<flertal<Lokalis
Qaqortormiulerisunga	Qaqortoq+MIU-LIRI<Participium<jeg
Qaqortormiulerisarpit	Qaqortoq+MIU-LIRI+TAR<Interrogativ<du
Qaqortormiulerisassagaluarpit	Qaqortoq+MIU-LIRI+TAR-SSA+GALUAR<Interrogativ<du
Qaqortormiunngussavit	Qaqortoq+MIU-NNGUR-SSA<Interrogativ<du
Qaqortormioqarpoq	Qaqortoq+MIU-QAR<Indikativ<han
Qaqortormioqarporli	Qaqortoq+MIU-QAR<Indikativ<han+LI
Qaqortormiuugaluarporlu	Qaqortoq+MIU-U+GALUAR<Indikativ<han+LU
Qaqortormiuugaluartungali	Qaqortoq+MIU-U+GALUAR<Participium<jeg+LI
Qaqortormiuuit	Qaqortoq+MIU-U<Interrogativ<du
Qaqortormiuussagaluartunga	Qaqortoq+MIU-U-SSA+GALUAR<Participium<jeg
Qaqortormiuusaraluarpit	Qaqortoq+MIU-U+TAR+GALUAR<Interrogativ<du
Qaqortormiuusassagaluarpugut	Qaqortoq+MIU-U+TAR-SSA+GALUAR<Indikativ<vi
Qaqortumut	Qaqortoq<Terminalis
Qaqortumulli	Qaqortoq<Terminalis+LI
Qaqortumullu	Qaqortoq<Terminalis+LU
Qasigiannguit	Qasigiannguit<Absolut
Qasigiannguilli	Qasigiannguit<Absolut+LI
Qasigiannguillu	Qasigiannguit<Absolut+LU
Qasigiannguanik	Qasigiannguit<Instrumentalis
Qasigiannguanilli	Qasigiannguit<Instrumentalis+LI
Qasigiannguanillu	Qasigiannguit<Instrumentalis+LU
Qasigiannguani	Qasigiannguit<Lokalis
Qasigiannguanili	Qasigiannguit<Lokalis+LI
Qasigiannguanilu	Qasigiannguit<Lokalis+LU
Qasigiannguarmiuni	Qasigiannguit+MIU<flertal<Lokalis
Qasigiannguarmiunngorpungalu	Qasigiannguit+MIU-NNGUR<Indikativ<jeg+LU
Qasigiannguarmiunngortungalu	Qasigiannguit+MIU-NNGUR<Participium<jeg+LU
Qasigiannguarmiunngussavit	Qasigiannguit+MIU-NNGUR-SSA<Interrogativ<du
Qasigiannguarmiunngortaraluartungalu	Qasigiannguit+MIU-NNGUR+TAR+GALUAR<Participium<jeg+LU
Qasigiannguarmiunngortassasunga	Qasigiannguit+MIU-NNGUR+TAR-SSA<Participium<jeg
Qasigiannguarmioqarporli	Qasigiannguit+MIU-QAR<Indikativ<han+LI
Qasigiannguarmioqarporlu	Qasigiannguit+MIU-QAR<Indikativ<han+LU
Qasigiannguarmiuusaraluarpungalu	Qasigiannguit+MIU-U+TAR+GALUAR<Indikativ<jeg+LU
Qasigiannguarmiuusarpit	Qasigiannguit+MIU-U+TAR<Interrogativ<du
Qasigiannguarmiuusartungalu	Qasigiannguit+MIU-U+TAR<Participium<jeg+LU
Qeqertarsuaq	Qeqertarsuaq<Absolut
Qeqertarsuarli	Qeqertarsuaq<Absolut+LI
Qeqertarsuarlu	Qeqertarsuaq<Absolut+LU
Qeqertarsuarmik	Qeqertarsuaq<Instrumentalis
Qeqertarsuarmilli	Qeqertarsuaq<Instrumentalis+LI
Qeqertarsuarmi	Qeqertarsuaq<Lokalis
Qeqertarsuarmili	Qeqertarsuaq<Lokalis+LI
Qeqertarsuarmilu	Qeqertarsuaq<Lokalis+LU
Qeqertarsuarmiumi	Qeqertarsuaq+MIU<ental<Lokalis
Qeqertarsuarmiumulli	Qeqertarsuaq+MIU<ental<Terminalis+LI
Qeqertarsuarmiuni	Qeqertarsuaq+MIU<flertal<Lokalis
Qeqertarsuarmiunilu	Qeqertarsuaq+MIU<flertal<Lokalis+LU
Qeqertarsuarmiulerivorli	Qeqertarsuaq+MIU-LIRI<Indikativ<han+LI
Qeqertarsuarmiulerivungali	Qeqertarsuaq+MIU-LIRI<Indikativ<jeg+LI
Qeqertarsuarmiulerissagaluarpit	Qeqertarsuaq+MIU-LIRI-SSA+GALUAR<Interrogativ<du
Qeqertarsuarmiulerisassagaluarpunga	Qeqertarsuaq+MIU-LIRI+TAR-SSA+GALUAR<Indikativ<jeg
Qeqertarsuarmiunngoraluarporli	Qeqertarsuaq+MIU-NNGUR+GALUAR<Indikativ<han+LI
Qeqertarsuarmiunngortunga	Qeqertarsuaq+MIU-NNGUR<Participium<jeg
Qeqertarsuarmiunngussagaluartungalu	Qeqertarsuaq+MIU-NNGUR-SSA+GALUAR<Participium<jeg+LU
Qeqertarsuarmiunngussavit	Qeqertarsuaq+MIU-NNGUR-SSA<Interrogativ<du
Qeqertarsuarmiunngortassavugullu	Qeqertarsuaq+MIU-NNGUR+TAR-SSA<Indikativ<vi+LU
Qeqertarsuarmioqarpoq	Qeqertarsuaq+MIU-QAR<Indikativ<han
Qeqertarsuarmioqarporli	Qeqertarsuaq+MIU-QAR<Indikativ<han+LI
Qeqertarsuarmioqarporlu	Qeqertarsuaq+MIU-QAR<Indikativ<han+LU
Qeqertarsuarmiuugaluarpit	Qeqertarsuaq+MIU-U+GALUAR<Interrogativ<du
Qeqertarsuarmiuuvoq	Qeqertarsuaq+MIU-U<Indikativ<han
Qeqertarsuarmiuuvunga	Qeqertarsuaq+MIU-U<Indikativ<jeg
Qeqertarsuarmiuuvugut	Qeqertarsuaq+MIU-U<Indikativ<vi
Qeqertarsuarmiuuit	Qeqertarsuaq+MIU-U<Interrogativ<du
Qeqertarsuarmiuusunga	Qeqertarsuaq+MIU-U<Participium<jeg
Qeqertarsuarmiuusungali	Qeqertarsuaq+MIU-U<Participium<jeg+LI
Qeqertarsuarmiuussagaluarpunga	Qeqertarsuaq+MIU-U-SSA+GALUAR<Indikativ<jeg
Qeqertarsuarmiuussagaluarpungalu	Qeqertarsuaq+MIU-U-SSA+GALUAR<Indikativ<jeg+LU
Qeqertarsuarmiuusaraluarpit	Qeqertarsuaq+MIU-U+TAR+GALUAR<Interrogativ<du
Qeqertarsuarmiuusaraluartungalu	Qeqertarsuaq+MIU-U+TAR+GALUAR<Participium<jeg+LU
Qeqertarsuarmiuusarpit	Qeqertarsuaq+MIU-U+TAR<Interrogativ<du
Qeqertarsuarmiuusassavungali	Qeqertarsuaq+MIU-U+TAR-SSA<Indikativ<jeg+LI
Qeqertarsuarmiuusassasungalu	Qeqertarsuaq+MIU-U+TAR-SSA<Participium<jeg+LU
Qeqertarsuarmut	Qeqertarsuaq<Terminalis
Qeqertarsuarmulli	Qeqertarsuaq<Terminalis+LI
Qeqertarsuarmullu	Qeqertarsuaq<Terminalis+LU
Sisimiut	Sisimiut<Absolut
Sisimiulli	Sisimiut<Absolut+LI
Sisimiullu	Sisimiut<Absolut+LU
Sisimiunik	Sisimiut<Instrumentalis
Sisimiunilli	Sisimiut<Instrumentalis+LI
Sisimiunillu	Sisimiut<Instrumentalis+LU
Sisimiuni	Sisimiut<Lokalis
Sisimiunili	Sisimiut<Lokalis+LI
Sisimiunilu	Sisimiut<Lokalis+LU
Sisimiormiu	Sisimiut+MIU<ental<Absolut
Sisimiormiumik	Sisimiut+MIU<ental<Instrumentalis
Sisimiormiumi	Sisimiut+MIU<ental<Lokalis
Sisimiormiumulli	Sisimiut+MIU<ental<Terminalis+LI
Sisimiormiunilli	Sisimiut+MIU<flertal<Instrumentalis+LI
Sisimiormiuni	Sisimiut+MIU<flertal<Lokalis
Sisimiormiunili	Sisimiut+MIU<flertal<Lokalis+LI
Sisimiormiulerigaluarporli	Sisimiut+MIU-LIRI+GALUAR<Indikativ<han+LI
Sisimiormiulerigaluartunga	Sisimiut+MIU-LIRI+GALUAR<Participium<jeg
Sisimiormiulerivit	Sisimiut+MIU-LIRI<Interrogativ<du
Sisimiormiulerisaraluartungali	Sisimiut+MIU-LIRI+TAR+GALUAR<Participium<jeg+LI
Sisimiormiunngorpunga	Sisimiut+MIU-NNGUR<Indikativ<jeg
Sisimiormiunngorpit	Sisimiut+MIU-NNGUR<Interrogativ<du
Sisimiormiunngortunga	Sisimiut+MIU-NNGUR<Participium<jeg
Sisimiormiunngussagaluartunga	Sisimiut+MIU-NNGUR-SSA+GALUAR<Participium<jeg
Sisimiormiunngussavit	Sisimiut+MIU-NNGUR-SSA<Interrogativ<du
Sisimiormiunngussasunga	Sisimiut+MIU-NNGUR-SSA<Participium<jeg
Sisimiormioqarpoq	Sisimiut+MIU-QAR<Indikativ<han
Sisimiormioqarporli	Sisimiut+MIU-QAR<Indikativ<han+LI
Sisimiormioqarporlu	Sisimiut+MIU-QAR<Indikativ<han+LU
Sisimiormiuugaluarpit	Sisimiut+MIU-U+GALUAR<Interrogativ<du
Sisimiormiuuvungali	Sisimiut+MIU-U<Indikativ<jeg+LI
Sisimiormiuuit	Sisimiut+MIU-U<Interrogativ<du
Sisimiormiuusunga	Sisimiut+MIU-U<Participium<jeg
Sisimiormiuussagaluarpunga	Sisimiut+MIU-U-SSA+GALUAR<Indikativ<jeg
Sisimiormiuussavugulli	Sisimiut+MIU-U-SSA<Indikativ<vi+LI
Sisimiormiuussavit	Sisimiut+MIU-U-SSA<Interrogativ<du
Sisimiormiuusaraluarpunga	Sisimiut+MIU-U+TAR+GALUAR<Indikativ<jeg
Sisimiormiuusaraluarpit	Sisimiut+MIU-U+TAR+GALUAR<Interrogativ<du
Sisimiormiuusarpit	Sisimiut+MIU-U+TAR<Interrogativ<du
Sisimiormiuusassagaluarpit	Sisimiut+MIU-U+TAR-SSA+GALUAR<Interrogativ<du
Sisimiormiuusassavungalu	Sisimiut+MIU-U+TAR-SSA<Indikativ<jeg+LU
suligaluarporli	suli+GALUAR<Indikativ<han+LI
suligaluarporlu	suli+GALUAR<Indikativ<han+LU
suligaluarpunga	suli+GALUAR<Indikativ<jeg
suligaluarpungali	suli+GALUAR<Indikativ<jeg+LI
suligaluarpungalu	suli+GALUAR<Indikativ<jeg+LU
suligaluarpugulli	suli+GALUAR<Indikativ<vi+LI
suligaluarpit	suli+GALUAR<Interrogativ<du
suligaluartunga	suli+GALUAR<Participium<jeg
suligaluartungali	suli+GALUAR<Participium<jeg+LI
suligaluartungalu	suli+GALUAR<Participium<jeg+LU
sulivoq	suli<Indikativ<han
sulivorli	suli<Indikativ<han+LI
sulivorlu	suli<Indikativ<han+LU
sulivunga	suli<Indikativ<jeg
sulivugut	suli<Indikativ<vi
sulivugulli	suli<Indikativ<vi+LI
sulivugullu	suli<Indikativ<vi+LU
sulivit	suli<Interrogativ<du
sulisunga	suli<Participium<jeg
sulisungali	suli<Participium<jeg+LI
sulisungalu	suli<Participium<jeg+LU
SULI	SULI<Partikel
SULIli	SULI<Partikel+LI
SULIlu	SULI<Partikel+LU
sulissagaluarpoq	suli-SSA+GALUAR<Indikativ<han
sulissagaluarpunga	suli-SSA+GALUAR<Indikativ<jeg
sulissagaluarpungali	suli-SSA+GALUAR<Indikativ<jeg+LI
sulissagaluarpugut	suli-SSA+GALUAR<Indikativ<vi
sulissagaluarpugulli	suli-SSA+GALUAR<Indikativ<vi+LI
sulissagaluarpit	suli-SSA+GALUAR<Interrogativ<du
sulissagaluartunga	suli-SSA+GALUAR<Participium<jeg
sulissagaluartungali	suli-SSA+GALUAR<Participium<jeg+LI
sulissagaluartungalu	suli-SSA+GALUAR<Participium<jeg+LU
sulissavoq	suli-SSA<Indikativ<han
sulissavorli	suli-SSA<Indikativ<han+LI
sulissavunga	suli-SSA<Indikativ<jeg
sulissavungali	suli-SSA<Indikativ<jeg+LI
sulissavungalu	suli-SSA<Indikativ<jeg+LU
sulissavugut	suli-SSA<Indikativ<vi
sulissavit	suli-SSA<Interrogativ<du
sulissasunga	suli-SSA<Participium<jeg
sulissasungali	suli-SSA<Participium<jeg+LI
sulissasungalu	suli-SSA<Participium<jeg+LU
sulisaraluarpoq	suli+TAR+GALUAR<Indikativ<han
sulisaraluarporli	suli+TAR+GALUAR<Indikativ<han+LI
sulisaraluarporlu	suli+TAR+GALUAR<Indikativ<han+LU
sulisaraluarpunga	suli+TAR+GALUAR<Indikativ<jeg
sulisaraluarpungali	suli+TAR+GALUAR<Indikativ<jeg+LI
sulisaraluarpugut	suli+TAR+GALUAR<Indikativ<vi
sulisaraluarpugullu	suli+TAR+GALUAR<Indikativ<vi+LU
sulisaraluarpit	suli+TAR+GALUAR<Interrogativ<du
sulisaraluartunga	suli+TAR+GALUAR<Participium<jeg
sulisaraluartungali	suli+TAR+GALUAR<Participium<jeg+LI
sulisaraluartungalu	suli+TAR+GALUAR<Participium<jeg+LU
sulisarpoq	suli+TAR<Indikativ<han
sulisarpungalu	suli+TAR<Indikativ<jeg+LU
sulisarpugulli	suli+TAR<Indikativ<vi+LI
sulisarpugullu	suli+TAR<Indikativ<vi+LU
sulisarpit	suli+TAR<Interrogativ<du
sulisartunga	suli+TAR<Participium<jeg
sulisassagaluarpoq	suli+TAR-SSA+GALUAR<Indikativ<han
sulisassagaluarporli	suli+TAR-SSA+GALUAR<Indikativ<han+LI
sulisassagaluarporlu	suli+TAR-SSA+GALUAR<Indikativ<han+LU
sulisassagaluarpunga	suli+TAR-SSA+GALUAR<Indikativ<jeg
sulisassagaluarpungali	suli+TAR-SSA+GALUAR<Indikativ<jeg+LI
sulisassagaluarpugulli	suli+TAR-SSA+GALUAR<Indikativ<vi+LI
sulisassagaluarpit	suli+TAR-SSA+GALUAR<Interrogativ<du
sulisassagaluartunga	suli+TAR-SSA+GALUAR<Participium<jeg
sulisassagaluartungali	suli+TAR-SSA+GALUAR<Participium<jeg+LI
sulisassagaluartungalu	suli+TAR-SSA+GALUAR<Participium<jeg+LU
sulisassavunga	suli+TAR-SSA<Indikativ<jeg
sulisassavungalu	suli+TAR-SSA<Indikativ<jeg+LU
sulisassavugulli	suli+TAR-SSA<Indikativ<vi+LI
sulisassavit	suli+TAR-SSA<Interrogativ<du
sulisassasunga	suli+TAR-SSA<Participium<jeg
sulisassasungali	suli+TAR-SSA<Participium<jeg+LI
sulisassasungalu	suli+TAR-SSA<Participium<jeg+LU
taagaluarpaat	taa+GALUAR<Indikativ<DeHam
taagaluarpaallu	taa+GALUAR<Indikativ<DeHam+LU
taagaluarpassi	taa+GALUAR<Indikativ<JegJer
taagaluarpassili	taa+GALUAR<Indikativ<JegJer+LI
taagaluarpiuk	taa+GALUAR<Interrogativ<DuHam
taavaat	taa<Indikativ<DeHam
taavaalli	taa<Indikativ<DeHam+LI
taavaanngali	taa<Indikativ<DeMig+LI
taavassi	taa<Indikativ<JegJer
taavassili	taa<Indikativ<JegJer+LI
taaviuk	taa<Interrogativ<DuHam
taannali	taanna<Pronomen+LI
taannalu	taanna<Pronomen+LU
taassagaluarpaannga	taa-SSA+GALUAR<Indikativ<DeMig
taassagaluarpassi	taa-SSA+GALUAR<Indikativ<JegJer
taassagaluarpassilu	taa-SSA+GALUAR<Indikativ<JegJer+LU
taassavaalli	taa-SSA<Indikativ<DeHam+LI
taassavaannga	taa-SSA<Indikativ<DeMig
taassavaanngali	taa-SSA<Indikativ<DeMig+LI
taassavaanngalu	taa-SSA<Indikativ<DeMig+LU
taassavassilu	taa-SSA<Indikativ<JegJer+LU
taassaviuk	taa-SSA<Interrogativ<DuHam
taasarpassili	taa+TAR<Indikativ<JegJer+LI
taasassagaluarpaalli	taa+TAR-SSA+GALUAR<Indikativ<DeHam+LI
taasassagaluarpaannga	taa+TAR-SSA+GALUAR<Indikativ<DeMig
taasassagaluarpiuk	taa+TAR-SSA+GALUAR<Interrogativ<DuHam
tamarmik	tamarmik<Adjektiv
tamarmilli	tamarmik<Adjektiv+LI
tamarmillu	tamarmik<Adjektiv+LU
Tasiilaq	Tasiilaq<Absolut
Tasiilarli	Tasiilaq<Absolut+LI
Tasiilarlu	Tasiilaq<Absolut+LU
Tasiilamik	Tasiilaq<Instrumentalis
Tasiilamilli	Tasiilaq<Instrumentalis+LI
Tasiilamillu	Tasiilaq<Instrumentalis+LU
Tasiilami	Tasiilaq<Lokalis
Tasiilamili	Tasiilaq<Lokalis+LI
Tasiilamilu	Tasiilaq<Lokalis+LU
Tasiilarmiumi	Tasiilaq+MIU<ental<Lokalis
Tasiilarmiumut	Tasiilaq+MIU<ental<Terminalis
Tasiilarmiumullu	Tasiilaq+MIU<ental<Terminalis+LU
Tasiilarmiuni	Tasiilaq+MIU<flertal<Lokalis
Tasiilarmiunilu	Tasiilaq+MIU<flertal<Lokalis+LU
Tasiilarmiulerissagaluarpit	Tasiilaq+MIU-LIRI-SSA+GALUAR<Interrogativ<du
Tasiilarmiulerisarpungali	Tasiilaq+MIU-LIRI+TAR<Indikativ<jeg+LI
Tasiilarmiulerisassasunga	Tasiilaq+MIU-LIRI+TAR-SSA<Participium<jeg
Tasiilarmiunngoraluarpit	Tasiilaq+MIU-NNGUR+GALUAR<Interrogativ<du
Tasiilarmiunngoraluartunga	Tasiilaq+MIU-NNGUR+GALUAR<Participium<jeg
Tasiilarmiunngorpit	Tasiilaq+MIU-NNGUR<Interrogativ<du
Tasiilarmiunngortunga	Tasiilaq+MIU-NNGUR<Participium<jeg
Tasiilarmiunngussagaluarpit	Tasiilaq+MIU-NNGUR-SSA+GALUAR<Interrogativ<du
Tasiilarmiunngussavugullu	Tasiilaq+MIU-NNGUR-SSA<Indikativ<vi+LU
Tasiilarmioqarpoq	Tasiilaq+MIU-QAR<Indikativ<han
Tasiilarmioqarporli	Tasiilaq+MIU-QAR<Indikativ<han+LI
Tasiilarmioqarporlu	Tasiilaq+MIU-QAR<Indikativ<han+LU
Tasiilarmiuugaluarpunga	Tasiilaq+MIU-U+GALUAR<Indikativ<jeg
Tasiilarmiuuvunga	Tasiilaq+MIU-U<Indikativ<jeg
Tasiilarmiuuvugut	Tasiilaq+MIU-U<Indikativ<vi
Tasiilarmiuuit	Tasiilaq+MIU-U<Interrogativ<du
Tasiilarmiuussagaluarporli	Tasiilaq+MIU-U-SSA+GALUAR<Indikativ<han+LI
Tasiilarmiuussagaluarpunga	Tasiilaq+MIU-U-SSA+GALUAR<Indikativ<jeg
Tasiilarmiuussagaluartunga	Tasiilaq+MIU-U-SSA+GALUAR<Participium<jeg
Tasiilarmiuussavoq	Tasiilaq+MIU-U-SSA<Indikativ<han
Tasiilarmiuussavorli	Tasiilaq+MIU-U-SSA<Indikativ<han+LI
Tasiilarmiuussavunga	Tasiilaq+MIU-U-SSA<Indikativ<jeg
Tasiilarmiuussavungali	Tasiilaq+MIU-U-SSA<Indikativ<jeg+LI
Tasiilarmiuussasunga	Tasiilaq+MIU-U-SSA<Participium<jeg
Tasiilarmiuusaraluarporlu	Tasiilaq+MIU-U+TAR+GALUAR<Indikativ<han+LU
Tasiilarmiuusaraluarpugullu	Tasiilaq+MIU-U+TAR+GALUAR<Indikativ<vi+LU
Tasiilarmiuusaraluarpit	Tasiilaq+MIU-U+TAR+GALUAR<Interrogativ<du
Tasiilarmiuusassagaluartunga	Tasiilaq+MIU-U+TAR-SSA+GALUAR<Participium<jeg
Tasiilarmiuusassavit	Tasiilaq+MIU-U+TAR-SSA<Interrogativ<du
Tasiilarmiuusassasunga	Tasiilaq+MIU-U+TAR-SSA<Participium<jeg
Tasiilarmiuusassasungali	Tasiilaq+MIU-U+TAR-SSA<Participium<jeg+LI
Tasiilamut	Tasiilaq<Terminalis
Tasiilamulli	Tasiilaq<Terminalis+LI
Tasiilamullu	Tasiilaq<Terminalis+LU
tassa	tassa<Partikel
tassali	tassa<Partikel+LI
tassalu	tassa<Partikel+LU
tutsiuteqqikkaluarpoq	tutsiuteqqip+GALUAR<Indikativ<han
tutsiuteqqikkaluarporli	tutsiuteqqip+GALUAR<Indikativ<han+LI
tutsiuteqqikkaluarpunga	tutsiuteqqip+GALUAR<Indikativ<jeg
tutsiuteqqikkaluarpungali	tutsiuteqqip+GALUAR<Indikativ<jeg+LI
tutsiuteqqikkaluarpugulli	tutsiuteqqip+GALUAR<Indikativ<vi+LI
tutsiuteqqikkaluarpit	tutsiuteqqip+GALUAR<Interrogativ<du
tutsiuteqqikkaluartunga	tutsiuteqqip+GALUAR<Participium<jeg
tutsiuteqqikkaluartungali	tutsiuteqqip+GALUAR<Participium<jeg+LI
tutsiuteqqippoq	tutsiuteqqip<Indikativ<han
tutsiuteqqipporli	tutsiuteqqip<Indikativ<han+LI
tutsiuteqqippunga	tutsiuteqqip<Indikativ<jeg
tutsiuteqqippungali	tutsiuteqqip<Indikativ<jeg+LI
tutsiuteqqippungalu	tutsiuteqqip<Indikativ<jeg+LU
tutsiuteqqippugut	tutsiuteqqip<Indikativ<vi
tutsiuteqqippugullu	tutsiuteqqip<Indikativ<vi+LU
tutsiuteqqippit	tutsiuteqqip<Interrogativ<du
tutsiuteqqittunga	tutsiuteqqip<Participium<jeg
tutsiuteqqittungali	tutsiuteqqip<Participium<jeg+LI
tutsiuteqqittungalu	tutsiuteqqip<Participium<jeg+LU
tutsiuteqqissagaluarpoq	tutsiuteqqip-SSA+GALUAR<Indikativ<han
tutsiuteqqissagaluarpunga	tutsiuteqqip-SSA+GALUAR<Indikativ<jeg
tutsiuteqqissagaluarpugulli	tutsiuteqqip-SSA+GALUAR<Indikativ<vi+LI
tutsiuteqqissagaluarpit	tutsiuteqqip-SSA+GALUAR<Interrogativ<du
tutsiuteqqissagaluartunga	tutsiuteqqip-SSA+GALUAR<Participium<jeg
tutsiuteqqissagaluartungali	tutsiuteqqip-SSA+GALUAR<Participium<jeg+LI
tutsiuteqqissavorli	tutsiuteqqip-SSA<Indikativ<han+LI
tutsiuteqqissavorlu	tutsiuteqqip-SSA<Indikativ<han+LU
tutsiuteqqissavunga	tutsiuteqqip-SSA<Indikativ<jeg
tutsiuteqqissavugulli	tutsiuteqqip-SSA<Indikativ<vi+LI
tutsiuteqqissavit	tutsiuteqqip-SSA<Interrogativ<du
tutsiuteqqissasunga	tutsiuteqqip-SSA<Participium<jeg
tutsiuteqqissasungali	tutsiuteqqip-SSA<Participium<jeg+LI
tutsiuteqqissasungalu	tutsiuteqqip-SSA<Participium<jeg+LU
tutsiuteqqittaraluarporli	tutsiuteqqip+TAR+GALUAR<Indikativ<han+LI
tutsiuteqqittaraluarpunga	tutsiuteqqip+TAR+GALUAR<Indikativ<jeg
tutsiuteqqittaraluartunga	tutsiuteqqip+TAR+GALUAR<Participium<jeg
tutsiuteqqittaraluartungalu	tutsiuteqqip+TAR+GALUAR<Participium<jeg+LU
tutsiuteqqittarporlu	tutsiuteqqip+TAR<Indikativ<han+LU
tutsiuteqqittarpunga	tutsiuteqqip+TAR<Indikativ<jeg
tutsiuteqqittarpungali	tutsiuteqqip+TAR<Indikativ<jeg+LI
tutsiuteqqittarpit	tutsiuteqqip+TAR<Interrogativ<du
tutsiuteqqittartunga	tutsiuteqqip+TAR<Participium<jeg
tutsiuteqqittartungali	tutsiuteqqip+TAR<Participium<jeg+LI
tutsiuteqqittartungalu	tutsiuteqqip+TAR<Participium<jeg+LU
tutsiuteqqittassagaluarpoq	tutsiuteqqip+TAR-SSA+GALUAR<Indikativ<han
tutsiuteqqittassagaluarpungali	tutsiuteqqip+TAR-SSA+GALUAR<Indikativ<jeg+LI
tutsiuteqqittassagaluarpugullu	tutsiuteqqip+TAR-SSA+GALUAR<Indikativ<vi+LU
tutsiuteqqittassagaluarpit	tutsiuteqqip+TAR-SSA+GALUAR<Interrogativ<du
tutsiuteqqittassavorli	tutsiuteqqip+TAR-SSA<Indikativ<han+LI
tutsiuteqqittassavunga	tutsiuteqqip+TAR-SSA<Indikativ<jeg
tutsiuteqqittassavit	tutsiuteqqip+TAR-SSA<Interrogativ<du
uanga	uanga<Pronomen
uangali	uanga<Pronomen+LI
uangalu	uanga<Pronomen+LU
ukioq	ukioq<ental<Absolut
ukiorli	ukioq<ental<Absolut+LI
ukiorlu	ukioq<ental<Absolut+LU
ukiumik	ukioq<ental<Instrumentalis
ukiumi	ukioq<ental<Lokalis
ukiumili	ukioq<ental<Lokalis+LI
ukiumilu	ukioq<ental<Lokalis+LU
ukiumut	ukioq<ental<Terminalis
ukiumulli	ukioq<ental<Terminalis+LI
ukiumullu	ukioq<ental<Terminalis+LU
ukiunik	ukioq<flertal<Instrumentalis
ukiunillu	ukioq<flertal<Instrumentalis+LU
ukiuni	ukioq<flertal<Lokalis
ukiunili	ukioq<flertal<Lokalis+LI
ukiunilu	ukioq<flertal<Lokalis+LU
ukiunngoraluarpoq	ukioq-NNGUR+GALUAR<Indikativ<han
ukiunngoraluarporli	ukioq-NNGUR+GALUAR<Indikativ<han+LI
ukiunngorporlu	ukioq-NNGUR<Indikativ<han+LU
ukiunngussagaluarpoq	ukioq-NNGUR-SSA+GALUAR<Indikativ<han
ukiunngussagaluarporli	ukioq-NNGUR-SSA+GALUAR<Indikativ<han+LI
ukiunngussagaluarporlu	ukioq-NNGUR-SSA+GALUAR<Indikativ<han+LU
ukiunngussavoq	ukioq-NNGUR-SSA<Indikativ<han
ukiunngussavorli	ukioq-NNGUR-SSA<Indikativ<han+LI
ukiunngussavorlu	ukioq-NNGUR-SSA<Indikativ<han+LU
ukiunngortassagaluarpit	ukioq-NNGUR+TAR-SSA+GALUAR<Interrogativ<du
ukiunngortassavunga	ukioq-NNGUR+TAR-SSA<Indikativ<jeg
ukiunngortassavit	ukioq-NNGUR+TAR-SSA<Interrogativ<du
ukiunngortassasungali	ukioq-NNGUR+TAR-SSA<Participium<jeg+LI
ukiunngortassasungalu	ukioq-NNGUR+TAR-SSA<Participium<jeg+LU
ukioqaraluarpoq	ukioq-QAR+GALUAR<Indikativ<han
ukioqaraluarporli	ukioq-QAR+GALUAR<Indikativ<han+LI
ukioqaraluarporlu	ukioq-QAR+GALUAR<Indikativ<han+LU
ukioqarpoq	ukioq-QAR<Indikativ<han
ukioqarporli	ukioq-QAR<Indikativ<han+LI
ukioqarporlu	ukioq-QAR<Indikativ<han+LU
ukioqassagaluarpoq	ukioq-QAR-SSA+GALUAR<Indikativ<han
ukioqassagaluarporli	ukioq-QAR-SSA+GALUAR<Indikativ<han+LI
ukioqassagaluarporlu	ukioq-QAR-SSA+GALUAR<Indikativ<han+LU
ukioqassavoq	ukioq-QAR-SSA<Indikativ<han
ukioqassavorli	ukioq-QAR-SSA<Indikativ<han+LI
ukioqassavorlu	ukioq-QAR-SSA<Indikativ<han+LU
ukioqartaraluarporli	ukioq-QAR+TAR+GALUAR<Indikativ<han+LI
ukioqartarpoq	ukioq-QAR+TAR<Indikativ<han
ukioqartarporli	ukioq-QAR+TAR<Indikativ<han+LI
ukioqartassagaluarporlu	ukioq-QAR+TAR-SSA+GALUAR<Indikativ<han+LU
ukioqartassagaluarpunga	ukioq-QAR+TAR-SSA+GALUAR<Indikativ<jeg
ukioqartassagaluarpit	ukioq-QAR+TAR-SSA+GALUAR<Interrogativ<du
ukioqartassagaluartungalu	ukioq-QAR+TAR-SSA+GALUAR<Participium<jeg+LU
ukioqartassavungali	ukioq-QAR+TAR-SSA<Indikativ<jeg+LI
ukioqartassavugulli	ukioq-QAR+TAR-SSA<Indikativ<vi+LI
ukioqartassavit	ukioq-QAR+TAR-SSA<Interrogativ<du
ukioqartassasunga	ukioq-QAR+TAR-SSA<Participium<jeg
ukiuugaluarpit	ukioq-U+GALUAR<Interrogativ<du
ukiuugaluartunga	ukioq-U+GALUAR<Participium<jeg
ukiuuvungali	ukioq-U<Indikativ<jeg+LI
ukiuuit	ukioq-U<Interrogativ<du
ukiuusunga	ukioq-U<Participium<jeg
ukiuusungalu	ukioq-U<Participium<jeg+LU
ukiuussagaluartunga	ukioq-U-SSA+GALUAR<Participium<jeg
ukiuussagaluartungali	ukioq-U-SSA+GALUAR<Participium<jeg+LI
ukiuussasunga	ukioq-U-SSA<Participium<jeg
ukiuussasungali	ukioq-U-SSA<Participium<jeg+LI
ukiuusarpugullu	ukioq-U+TAR<Indikativ<vi+LU
ukiuusarpit	ukioq-U+TAR<Interrogativ<du
ukiuusartungalu	ukioq-U+TAR<Participium<jeg+LU
ukiuusassavit	ukioq-U+TAR-SSA<Interrogativ<du
Upernavik	Upernavik<Absolut
Upernavilli	Upernavik<Absolut+LI
Upernavillu	Upernavik<Absolut+LU
Upernavimmik	Upernavik<Instrumentalis
Upernavimmilli	Upernavik<Instrumentalis+LI
Upernavimmillu	Upernavik<Instrumentalis+LU
Upernavimmi	Upernavik<Lokalis
Upernavimmili	Upernavik<Lokalis+LI
Upernavimmiunilli	Upernavik+MIU<flertal<Instrumentalis+LI
Upernavimmiuni	Upernavik+MIU<flertal<Lokalis
Upernavimmiunilu	Upernavik+MIU<flertal<Lokalis+LU
Upernavimmiulerigaluarpit	Upernavik+MIU-LIRI+GALUAR<Interrogativ<du
Upernavimmiulerisassavorli	Upernavik+MIU-LIRI+TAR-SSA<Indikativ<han+LI
Upernavimmiulerisassavunga	Upernavik+MIU-LIRI+TAR-SSA<Indikativ<jeg
Upernavimmiulerisassavit	Upernavik+MIU-LIRI+TAR-SSA<Interrogativ<du
Upernavimmiunngortassavugulli	Upernavik+MIU-NNGUR+TAR-SSA<Indikativ<vi+LI
Upernavimmioqarpoq	Upernavik+MIU-QAR<Indikativ<han
Upernavimmioqarporli	Upernavik+MIU-QAR<Indikativ<han+LI
Upernavimmioqarporlu	Upernavik+MIU-QAR<Indikativ<han+LU
Upernavimmiuugaluarpungali	Upernavik+MIU-U+GALUAR<Indikativ<jeg+LI
Upernavimmiuugaluarpit	Upernavik+MIU-U+GALUAR<Interrogativ<du
Upernavimmiuugaluartunga	Upernavik+MIU-U+GALUAR<Participium<jeg
Upernavimmiuuvunga	Upernavik+MIU-U<Indikativ<jeg
Upernavimmiuuit	Upernavik+MIU-U<Interrogativ<du
Upernavimmiuussagaluarpungali	Upernavik+MIU-U-SSA+GALUAR<Indikativ<jeg+LI
Upernavimmiuussagaluartunga	Upernavik+MIU-U-SSA+GALUAR<Participium<jeg
Upernavimmiuussavit	Upernavik+MIU-U-SSA<Interrogativ<du
Upernavimmiuussasunga	Upernavik+MIU-U-SSA<Participium<jeg
Upernavimmiuusaraluarpunga	Upernavik+MIU-U+TAR+GALUAR<Indikativ<jeg
Upernavimmiuusaraluarpit	Upernavik+MIU-U+TAR+GALUAR<Interrogativ<du
Upernavimmiuusassagaluarpit	Upernavik+MIU-U+TAR-SSA+GALUAR<Interrogativ<du
Upernavimmiuusassavunga	Upernavik+MIU-U+TAR-SSA<Indikativ<jeg
Upernavimmut	Upernavik<Terminalis
Upernavimmulli	Upernavik<Terminalis+LI
Upernavimmullu	Upernavik<Terminalis+LU
Uummannaq	Uummannaq<Absolut
Uummannarli	Uummannaq<Absolut+LI
Uummannarlu	Uummannaq<Absolut+LU
Uummannamik	Uummannaq<Instrumentalis
Uummannamilli	Uummannaq<Instrumentalis+LI
Uummannami	Uummannaq<Lokalis
Uummannamili	Uummannaq<Lokalis+LI
Uummannamilu	Uummannaq<Lokalis+LU
Uummannarmiulu	Uummannaq+MIU<ental<Absolut+LU
Uummannarmiunik	Uummannaq+MIU<flertal<Instrumentalis
Uummannarmiuni	Uummannaq+MIU<flertal<Lokalis
Uummannarmiunili	Uummannaq+MIU<flertal<Lokalis+LI
Uummannarmiunilu	Uummannaq+MIU<flertal<Lokalis+LU
Uummannarmiulerigaluarpungalu	Uummannaq+MIU-LIRI+GALUAR<Indikativ<jeg+LU
Uummannarmiulerisassagaluartunga	Uummannaq+MIU-LIRI+TAR-SSA+GALUAR<Participium<jeg
Uummannarmiulerisassagaluartungalu	Uummannaq+MIU-LIRI+TAR-SSA+GALUAR<Participium<jeg+LU
Uummannarmiulerisassavit	Uummannaq+MIU-LIRI+TAR-SSA<Interrogativ<du
Uummannarmiunngoraluartungali	Uummannaq+MIU-NNGUR+GALUAR<Participium<jeg+LI
Uummannarmiunngortaraluarpugulli	Uummannaq+MIU-NNGUR+TAR+GALUAR<Indikativ<vi+LI
Uummannarmioqarpoq	Uummannaq+MIU-QAR<Indikativ<han
Uummannarmioqarporli	Uummannaq+MIU-QAR<Indikativ<han+LI
Uummannarmioqarporlu	Uummannaq+MIU-QAR<Indikativ<han+LU
Uummannarmiuugaluarporlu	Uummannaq+MIU-U+GALUAR<Indikativ<han+LU
Uummannarmiuuvugulli	Uummannaq+MIU-U<Indikativ<vi+LI
Uummannarmiuusunga	Uummannaq+MIU-U<Participium<jeg
Uummannarmiuussagaluartunga	Uummannaq+MIU-U-SSA+GALUAR<Participium<jeg
Uummannarmiuussasunga	Uummannaq+MIU-U-SSA<Participium<jeg
Uummannarmiuusaraluartunga	Uummannaq+MIU-U+TAR+GALUAR<Participium<jeg
Uummannarmiuusaraluartungali	Uummannaq+MIU-U+TAR+GALUAR<Participium<jeg+LI
Uummannarmiuusassavit	Uummannaq+MIU-U+TAR-SSA<Interrogativ<du
Uummannamut	Uummannaq<Terminalis
Uummannamulli	Uummannaq<Terminalis+LI
Uummannamullu	Uummannaq<Terminalis+LU
