aap	aap<Partikel
angajulleq	angajulleq<ental<Absolut
angajullertut	angajulleq<ental<Aequalis
angajulliat	angajulleq<ental<deres<Absolut
angajulliit	angajulleq<flertal<Absolut
angajulliit	angajulleq<flertal<Relativ
angajullernut	angajulleq<flertal<Terminalis
angajulliinnaq	angajulleq-INNAQ<ental<Absolut
angajulliinnartut	angajulleq-INNAQ<ental<Aequalis
angajulliinnaat	angajulleq-INNAQ<ental<deres<Absolut
angajulliinnaat	angajulleq-INNAQ<flertal<Absolut
angajulliinnaat	angajulleq-INNAQ<flertal<Relativ
angajulliinnarnut	angajulleq-INNAQ<flertal<Terminalis
angajullilik	angajulleq-LIK<ental<Absolut
angajullilittut	angajulleq-LIK<ental<Aequalis
angajulliliat	angajulleq-LIK<ental<deres<Absolut
angajullillit	angajulleq-LIK<flertal<Absolut
angajullillit	angajulleq-LIK<flertal<Relativ
angajullilinnut	angajulleq-LIK<Terminalis<flertal
angajullerpassuit	angajulleq+PASSUAQ<flertal<Absolut
angajullerpassuartut	angajulleq+PASSUAQ<flertal<Aequalis
angajullerpassuarnut	angajulleq+PASSUAQ<flertal<Terminalis
arnaq	arnaq<ental<Absolut
arnatut	arnaq<ental<Aequalis
arnaat	arnaq<ental<deres<Absolut
arnaannaq	arnaq-INNAQ<ental<Absolut
arnaannartut	arnaq-INNAQ<ental<Aequalis
arnaannaat	arnaq-INNAQ<ental<deres<Absolut
arnaannaat	arnaq-INNAQ<flertal<Absolut
arnaannaat	arnaq-INNAQ<flertal<Relativ
arnaannarnut	arnaq-INNAQ<flertal<Terminalis
arnalik	arnaq-LIK<ental<Absolut
arnalittut	arnaq-LIK<ental<Aequalis
arnaliat	arnaq-LIK<ental<deres<Absolut
arnallit	arnaq-LIK<flertal<Absolut
arnallit	arnaq-LIK<flertal<Relativ
arnalinnut	arnaq-LIK<Terminalis<flertal
arnarpassuit	arnaq+PASSUAQ<flertal<Absolut
arnarpassuartut	arnaq+PASSUAQ<flertal<Aequalis
arnarpassuarnut	arnaq+PASSUAQ<flertal<Terminalis
arnanut	arnaq<Terminalis<flertal
atorpaa	ator<Indikativ<HanHam
atulaarpaa	ator-LAAR<Indikativ<HanHam
atorsimavaa	ator+SIMA<Indikativ<HanHam
ilaa	ilaa<Partikel
ila	ila<ental<Absolut
ilatut	ila<ental<Aequalis
ilaat	ila<ental<deres<Absolut
ilaannaq	ila-INNAQ<ental<Absolut
ilaannartut	ila-INNAQ<ental<Aequalis
ilaannaat	ila-INNAQ<ental<deres<Absolut
ilaannaat	ila-INNAQ<flertal<Absolut
ilaannaat	ila-INNAQ<flertal<Relativ
ilaannarnut	ila-INNAQ<flertal<Terminalis
ilalik	ila-LIK<ental<Absolut
ilalittut	ila-LIK<ental<Aequalis
ilaliat	ila-LIK<ental<deres<Absolut
ilallit	ila-LIK<flertal<Absolut
ilallit	ila-LIK<flertal<Relativ
ilalinnut	ila-LIK<Terminalis<flertal
ilarpassuit	ila+PASSUAQ<flertal<Absolut
ilarpassuartut	ila+PASSUAQ<flertal<Aequalis
ilarpassuarnut	ila+PASSUAQ<flertal<Terminalis
ilanut	ila<Terminalis<flertal
ilinniarnertuunngorniarfik	ilinniarnertuunngorniarfik<ental<Absolut
ilinniarnertuunngorniarfittut	ilinniarnertuunngorniarfik<ental<Aequalis
ilinniarnertuunngorniarfiat	ilinniarnertuunngorniarfik<ental<deres<Absolut
ilinniarnertuunngorniarfiit	ilinniarnertuunngorniarfik<flertal<Absolut
ilinniarnertuunngorniarfiit	ilinniarnertuunngorniarfik<flertal<Relativ
ilinniarnertuunngorniarfinnut	ilinniarnertuunngorniarfik<flertal<Terminalis
ilinniarnertuunngorniarfiinnaq	ilinniarnertuunngorniarfik-INNAQ<ental<Absolut
ilinniarnertuunngorniarfiinnartut	ilinniarnertuunngorniarfik-INNAQ<ental<Aequalis
ilinniarnertuunngorniarfiinnaat	ilinniarnertuunngorniarfik-INNAQ<ental<deres<Absolut
ilinniarnertuunngorniarfiinnaat	ilinniarnertuunngorniarfik-INNAQ<flertal<Absolut
ilinniarnertuunngorniarfiinnaat	ilinniarnertuunngorniarfik-INNAQ<flertal<Relativ
ilinniarnertuunngorniarfiinnarnut	ilinniarnertuunngorniarfik-INNAQ<flertal<Terminalis
ilinniarnertuunngorniarfilik	ilinniarnertuunngorniarfik-LIK<ental<Absolut
ilinniarnertuunngorniarfillit	ilinniarnertuunngorniarfik-LIK<flertal<Absolut
ilinniarnertuunngorniarfillit	ilinniarnertuunngorniarfik-LIK<flertal<Relativ
ilinniarnertuunngorniarfilinnut	ilinniarnertuunngorniarfik-LIK<Terminalis<flertal
ilinniarnertuunngorniarfippassuit	ilinniarnertuunngorniarfik+PASSUAQ<flertal<Absolut
ilinniarnertuunngorniarfippassuartut	ilinniarnertuunngorniarfik+PASSUAQ<flertal<Aequalis
ilinniarnertuunngorniarfippassuarnut	ilinniarnertuunngorniarfik+PASSUAQ<flertal<Terminalis
immikkoortoq	immikkoortoq<ental<Absolut
immikkoortutut	immikkoortoq<ental<Aequalis
immikkoortuat	immikkoortoq<ental<deres<Absolut
immikkoortuinnaq	immikkoortoq-INNAQ<ental<Absolut
immikkoortuinnartut	immikkoortoq-INNAQ<ental<Aequalis
immikkoortuinnaat	immikkoortoq-INNAQ<ental<deres<Absolut
immikkoortuinnaat	immikkoortoq-INNAQ<flertal<Absolut
immikkoortuinnaat	immikkoortoq-INNAQ<flertal<Relativ
immikkoortuinnarnut	immikkoortoq-INNAQ<flertal<Terminalis
immikkoortulik	immikkoortoq-LIK<ental<Absolut
immikkoortulittut	immikkoortoq-LIK<ental<Aequalis
immikkoortullit	immikkoortoq-LIK<flertal<Absolut
immikkoortullit	immikkoortoq-LIK<flertal<Relativ
immikkoortulinnut	immikkoortoq-LIK<Terminalis<flertal
immikkoortorpassuit	immikkoortoq+PASSUAQ<flertal<Absolut
immikkoortorpassuartut	immikkoortoq+PASSUAQ<flertal<Aequalis
immikkoortorpassuarnut	immikkoortoq+PASSUAQ<flertal<Terminalis
immikkoortunut	immikkoortoq<Terminalis<flertal
immikkut	immikkut<Partikel
kingulleq	kingulleq<ental<Absolut
kingullertut	kingulleq<ental<Aequalis
kingulliat	kingulleq<ental<deres<Absolut
kingulliit	kingulleq<flertal<Absolut
kingulliit	kingulleq<flertal<Relativ
kingullernut	kingulleq<flertal<Terminalis
kingulliinnaq	kingulleq-INNAQ<ental<Absolut
kingulliinnartut	kingulleq-INNAQ<ental<Aequalis
kingulliinnaat	kingulleq-INNAQ<ental<deres<Absolut
kingulliinnaat	kingulleq-INNAQ<flertal<Absolut
kingulliinnaat	kingulleq-INNAQ<flertal<Relativ
kingulliinnarnut	kingulleq-INNAQ<flertal<Terminalis
kingullilik	kingulleq-LIK<ental<Absolut
kingullilittut	kingulleq-LIK<ental<Aequalis
kingulliliat	kingulleq-LIK<ental<deres<Absolut
kingullillit	kingulleq-LIK<flertal<Absolut
kingullillit	kingulleq-LIK<flertal<Relativ
kingullilinnut	kingulleq-LIK<Terminalis<flertal
kingullerpassuit	kingulleq+PASSUAQ<flertal<Absolut
kingullerpassuartut	kingulleq+PASSUAQ<flertal<Aequalis
kingullerpassuarnut	kingulleq+PASSUAQ<flertal<Terminalis
meeraq	meeraq<ental<Absolut
meeqqatut	meeraq<ental<Aequalis
meeraat	meeraq<ental<deres<Absolut
meeraannaq	meeraq-INNAQ<ental<Absolut
meeraannartut	meeraq-INNAQ<ental<Aequalis
meeraannaat	meeraq-INNAQ<ental<deres<Absolut
meeraannaat	meeraq-INNAQ<flertal<Absolut
meeraannaat	meeraq-INNAQ<flertal<Relativ
meeraannarnut	meeraq-INNAQ<flertal<Terminalis
meeralik	meeraq-LIK<ental<Absolut
meeralittut	meeraq-LIK<ental<Aequalis
meeraliat	meeraq-LIK<ental<deres<Absolut
meerallit	meeraq-LIK<flertal<Absolut
meerallit	meeraq-LIK<flertal<Relativ
meeralinnut	meeraq-LIK<Terminalis<flertal
meerarpassuit	meeraq+PASSUAQ<flertal<Absolut
meerarpassuartut	meeraq+PASSUAQ<flertal<Aequalis
meerarpassuarnut	meeraq+PASSUAQ<flertal<Terminalis
meeqqanut	meeraq<Terminalis<flertal
nammineq	nammineq<Adjektiv
nukappiaraq	nukappiaraq<ental<Absolut
nukappiaqqatut	nukappiaraq<ental<Aequalis
nukappiaraannaq	nukappiaraq-INNAQ<ental<Absolut
nukappiaraannaat	nukappiaraq-INNAQ<ental<deres<Absolut
nukappiaraannaat	nukappiaraq-INNAQ<flertal<Absolut
nukappiaraannarnut	nukappiaraq-INNAQ<flertal<Terminalis
nukappiaralittut	nukappiaraq-LIK<ental<Aequalis
nukappiarallit	nukappiaraq-LIK<flertal<Absolut
nukappiarallit	nukappiaraq-LIK<flertal<Relativ
nukappiaralinnut	nukappiaraq-LIK<Terminalis<flertal
nukappiararpassuit	nukappiaraq+PASSUAQ<flertal<Absolut
nukappiararpassuartut	nukappiaraq+PASSUAQ<flertal<Aequalis
nukappiararpassuarnut	nukappiaraq+PASSUAQ<flertal<Terminalis
nukappiaqqanut	nukappiaraq<Terminalis<flertal
nukarleq	nukarleq<ental<Absolut
nukarlertut	nukarleq<ental<Aequalis
nukarliat	nukarleq<ental<deres<Absolut
nukarliit	nukarleq<flertal<Absolut
nukarliit	nukarleq<flertal<Relativ
nukarlernut	nukarleq<flertal<Terminalis
nukarliinnaq	nukarleq-INNAQ<ental<Absolut
nukarliinnartut	nukarleq-INNAQ<ental<Aequalis
nukarliinnaat	nukarleq-INNAQ<ental<deres<Absolut
nukarliinnaat	nukarleq-INNAQ<flertal<Absolut
nukarliinnaat	nukarleq-INNAQ<flertal<Relativ
nukarliinnarnut	nukarleq-INNAQ<flertal<Terminalis
nukarlilik	nukarleq-LIK<ental<Absolut
nukarliliat	nukarleq-LIK<ental<deres<Absolut
nukarlillit	nukarleq-LIK<flertal<Absolut
nukarlillit	nukarleq-LIK<flertal<Relativ
nukarlilinnut	nukarleq-LIK<Terminalis<flertal
nukarlerpassuit	nukarleq+PASSUAQ<flertal<Absolut
nukarlerpassuartut	nukarleq+PASSUAQ<flertal<Aequalis
nukarlerpassuarnut	nukarleq+PASSUAQ<flertal<Terminalis
nuna	nuna<ental<Absolut
nunatut	nuna<ental<Aequalis
nunaat	nuna<ental<deres<Absolut
nunaannaq	nuna-INNAQ<ental<Absolut
nunaannartut	nuna-INNAQ<ental<Aequalis
nunaannaat	nuna-INNAQ<ental<deres<Absolut
nunaannaat	nuna-INNAQ<flertal<Absolut
nunaannarnut	nuna-INNAQ<flertal<Terminalis
nunalik	nuna-LIK<ental<Absolut
nunalittut	nuna-LIK<ental<Aequalis
nunaliat	nuna-LIK<ental<deres<Absolut
nunallit	nuna-LIK<flertal<Absolut
nunallit	nuna-LIK<flertal<Relativ
nunarpassuit	nuna+PASSUAQ<flertal<Absolut
nunarpassuartut	nuna+PASSUAQ<flertal<Aequalis
nunarpassuarnut	nuna+PASSUAQ<flertal<Terminalis
nunanut	nuna<Terminalis<flertal
nuuppoq	nuup<Indikativ<han
nuulaarpoq	nuup-LAAR<Indikativ<han
nuulaarneq	nuup-LAAR+NIQ<ental<Absolut
nuulaarnertut	nuup-LAAR+NIQ<ental<Aequalis
nuulaarnerat	nuup-LAAR+NIQ<ental<deres<Absolut
nuulaarnerit	nuup-LAAR+NIQ<flertal<Relativ
nuulaarnerinnaq	nuup-LAAR+NIQ-INNAQ<ental<Absolut
nuulaarnilittut	nuup-LAAR+NIQ-LIK<ental<Aequalis
nuulaarnillit	nuup-LAAR+NIQ-LIK<flertal<Absolut
nuulaarnillit	nuup-LAAR+NIQ-LIK<flertal<Relativ
nuulaarnerpassuartut	nuup-LAAR+NIQ+PASSUAQ<flertal<Aequalis
nuunneq	nuup+NIQ<ental<Absolut
nuunnerat	nuup+NIQ<ental<deres<Absolut
nuunnerit	nuup+NIQ<flertal<Absolut
nuunnerit	nuup+NIQ<flertal<Relativ
nuunnernut	nuup+NIQ<flertal<Terminalis
nuunnerinnaq	nuup+NIQ-INNAQ<ental<Absolut
nuunnerinnartut	nuup+NIQ-INNAQ<ental<Aequalis
nuunnerinnaat	nuup+NIQ-INNAQ<flertal<Relativ
nuunnilik	nuup+NIQ-LIK<ental<Absolut
nuunnilittut	nuup+NIQ-LIK<ental<Aequalis
nuunniliat	nuup+NIQ-LIK<ental<deres<Absolut
nuunnillit	nuup+NIQ-LIK<flertal<Absolut
nuunnillit	nuup+NIQ-LIK<flertal<Relativ
nuunnilinnut	nuup+NIQ-LIK<Terminalis<flertal
nuunnerpassuit	nuup+NIQ+PASSUAQ<flertal<Absolut
nuunnerpassuartut	nuup+NIQ+PASSUAQ<flertal<Aequalis
nuussimavoq	nuup+SIMA<Indikativ<han
nuussimanerit	nuup+SIMA+NIQ<flertal<Absolut
nuussimanerit	nuup+SIMA+NIQ<flertal<Relativ
nuussimanernut	nuup+SIMA+NIQ<flertal<Terminalis
nuussimanerinnaat	nuup+SIMA+NIQ-INNAQ<ental<deres<Absolut
nuussimanerinnarnut	nuup+SIMA+NIQ-INNAQ<flertal<Terminalis
nuussimanillit	nuup+SIMA+NIQ-LIK<flertal<Absolut
nuussimanillit	nuup+SIMA+NIQ-LIK<flertal<Relativ
nuussimanilinnut	nuup+SIMA+NIQ-LIK<Terminalis<flertal
oqaasilerineq	oqaasilerineq<ental<Absolut
oqaasilerinertut	oqaasilerineq<ental<Aequalis
oqaasilerinerat	oqaasilerineq<ental<deres<Absolut
oqaasilerinerit	oqaasilerineq<flertal<Absolut
oqaasilerinerit	oqaasilerineq<flertal<Relativ
oqaasilerinernut	oqaasilerineq<flertal<Terminalis
oqaasilerinerinnaq	oqaasilerineq-INNAQ<ental<Absolut
oqaasilerinerinnartut	oqaasilerineq-INNAQ<ental<Aequalis
oqaasilerinerinnaat	oqaasilerineq-INNAQ<ental<deres<Absolut
oqaasilerinerinnaat	oqaasilerineq-INNAQ<flertal<Relativ
oqaasilerinerinnarnut	oqaasilerineq-INNAQ<flertal<Terminalis
oqaasilerinilik	oqaasilerineq-LIK<ental<Absolut
oqaasilerinilittut	oqaasilerineq-LIK<ental<Aequalis
oqaasileriniliat	oqaasilerineq-LIK<ental<deres<Absolut
oqaasilerinillit	oqaasilerineq-LIK<flertal<Absolut
oqaasilerinillit	oqaasilerineq-LIK<flertal<Relativ
oqaasilerinilinnut	oqaasilerineq-LIK<Terminalis<flertal
oqaasilerinerpassuit	oqaasilerineq+PASSUAQ<flertal<Absolut
oqaasilerinerpassuartut	oqaasilerineq+PASSUAQ<flertal<Aequalis
oqaasilerinerpassuarnut	oqaasilerineq+PASSUAQ<flertal<Terminalis
oqaluttuarpoq	oqaluttuar<Indikativ<han
oqaluttualaarpoq	oqaluttuar-LAAR<Indikativ<han
oqaluttualaarneq	oqaluttuar-LAAR+NIQ<ental<Absolut
oqaluttualaarnertut	oqaluttuar-LAAR+NIQ<ental<Aequalis
oqaluttualaarnerat	oqaluttuar-LAAR+NIQ<ental<deres<Absolut
oqaluttualaarnerit	oqaluttuar-LAAR+NIQ<flertal<Absolut
oqaluttualaarnernut	oqaluttuar-LAAR+NIQ<flertal<Terminalis
oqaluttualaarnerinnaq	oqaluttuar-LAAR+NIQ-INNAQ<ental<Absolut
oqaluttualaarnerinnartut	oqaluttuar-LAAR+NIQ-INNAQ<ental<Aequalis
oqaluttualaarnerinnaat	oqaluttuar-LAAR+NIQ-INNAQ<ental<deres<Absolut
oqaluttualaarnilik	oqaluttuar-LAAR+NIQ-LIK<ental<Absolut
oqaluttualaarnilittut	oqaluttuar-LAAR+NIQ-LIK<ental<Aequalis
oqaluttualaarniliat	oqaluttuar-LAAR+NIQ-LIK<ental<deres<Absolut
oqaluttualaarnillit	oqaluttuar-LAAR+NIQ-LIK<flertal<Absolut
oqaluttualaarnillit	oqaluttuar-LAAR+NIQ-LIK<flertal<Relativ
oqaluttualaarnilinnut	oqaluttuar-LAAR+NIQ-LIK<Terminalis<flertal
oqaluttualaarnerpassuit	oqaluttuar-LAAR+NIQ+PASSUAQ<flertal<Absolut
oqaluttuarneq	oqaluttuar+NIQ<ental<Absolut
oqaluttuarnerit	oqaluttuar+NIQ<flertal<Absolut
oqaluttuarnerit	oqaluttuar+NIQ<flertal<Relativ
oqaluttuarnerinnaat	oqaluttuar+NIQ-INNAQ<flertal<Absolut
oqaluttuarnilittut	oqaluttuar+NIQ-LIK<ental<Aequalis
oqaluttuarnillit	oqaluttuar+NIQ-LIK<flertal<Absolut
oqaluttuarnillit	oqaluttuar+NIQ-LIK<flertal<Relativ
oqaluttuarnerpassuit	oqaluttuar+NIQ+PASSUAQ<flertal<Absolut
oqaluttuarnerpassuarnut	oqaluttuar+NIQ+PASSUAQ<flertal<Terminalis
oqaluttuarsimavoq	oqaluttuar+SIMA<Indikativ<han
oqaluttuarsimaneq	oqaluttuar+SIMA+NIQ<ental<Absolut
oqaluttuarsimanerat	oqaluttuar+SIMA+NIQ<ental<deres<Absolut
oqaluttuarsimanerit	oqaluttuar+SIMA+NIQ<flertal<Absolut
oqaluttuarsimanerinnaq	oqaluttuar+SIMA+NIQ-INNAQ<ental<Absolut
oqaluttuarsimanerinnaat	oqaluttuar+SIMA+NIQ-INNAQ<ental<deres<Absolut
oqaluttuarsimanillit	oqaluttuar+SIMA+NIQ-LIK<flertal<Absolut
oqaluttuarsimanillit	oqaluttuar+SIMA+NIQ-LIK<flertal<Relativ
oqaluttuarsimanilinnut	oqaluttuar+SIMA+NIQ-LIK<Terminalis<flertal
oqarpoq	oqar<Indikativ<han
oqalaarpoq	oqar-LAAR<Indikativ<han
oqalaarneq	oqar-LAAR+NIQ<ental<Absolut
oqalaarnertut	oqar-LAAR+NIQ<ental<Aequalis
oqalaarnerat	oqar-LAAR+NIQ<ental<deres<Absolut
oqalaarnerit	oqar-LAAR+NIQ<flertal<Relativ
oqalaarnernut	oqar-LAAR+NIQ<flertal<Terminalis
oqalaarnerinnaq	oqar-LAAR+NIQ-INNAQ<ental<Absolut
oqalaarnerinnartut	oqar-LAAR+NIQ-INNAQ<ental<Aequalis
oqalaarnerinnaat	oqar-LAAR+NIQ-INNAQ<ental<deres<Absolut
oqalaarnerinnaat	oqar-LAAR+NIQ-INNAQ<flertal<Absolut
oqalaarnilik	oqar-LAAR+NIQ-LIK<ental<Absolut
oqalaarnilittut	oqar-LAAR+NIQ-LIK<ental<Aequalis
oqalaarniliat	oqar-LAAR+NIQ-LIK<ental<deres<Absolut
oqalaarnillit	oqar-LAAR+NIQ-LIK<flertal<Absolut
oqalaarnillit	oqar-LAAR+NIQ-LIK<flertal<Relativ
oqalaarnilinnut	oqar-LAAR+NIQ-LIK<Terminalis<flertal
oqalaarnerpassuit	oqar-LAAR+NIQ+PASSUAQ<flertal<Absolut
oqalaarnerpassuartut	oqar-LAAR+NIQ+PASSUAQ<flertal<Aequalis
oqalaarnerpassuarnut	oqar-LAAR+NIQ+PASSUAQ<flertal<Terminalis
oqarneq	oqar+NIQ<ental<Absolut
oqarnertut	oqar+NIQ<ental<Aequalis
oqarnerat	oqar+NIQ<ental<deres<Absolut
oqarnerit	oqar+NIQ<flertal<Absolut
oqarnerit	oqar+NIQ<flertal<Relativ
oqarnernut	oqar+NIQ<flertal<Terminalis
oqarnerinnaat	oqar+NIQ-INNAQ<ental<deres<Absolut
oqarnerinnarnut	oqar+NIQ-INNAQ<flertal<Terminalis
oqarnilik	oqar+NIQ-LIK<ental<Absolut
oqarnilittut	oqar+NIQ-LIK<ental<Aequalis
oqarniliat	oqar+NIQ-LIK<ental<deres<Absolut
oqarnillit	oqar+NIQ-LIK<flertal<Absolut
oqarnillit	oqar+NIQ-LIK<flertal<Relativ
oqarnilinnut	oqar+NIQ-LIK<Terminalis<flertal
oqarnerpassuit	oqar+NIQ+PASSUAQ<flertal<Absolut
oqarnerpassuartut	oqar+NIQ+PASSUAQ<flertal<Aequalis
oqarnerpassuarnut	oqar+NIQ+PASSUAQ<flertal<Terminalis
oqarsimavoq	oqar+SIMA<Indikativ<han
oqarsimaneq	oqar+SIMA+NIQ<ental<Absolut
oqarsimanerit	oqar+SIMA+NIQ<flertal<Absolut
oqarsimanerit	oqar+SIMA+NIQ<flertal<Relativ
oqarsimanerinnaq	oqar+SIMA+NIQ-INNAQ<ental<Absolut
oqarsimanerinnaat	oqar+SIMA+NIQ-INNAQ<ental<deres<Absolut
oqarsimanilik	oqar+SIMA+NIQ-LIK<ental<Absolut
oqarsimanillit	oqar+SIMA+NIQ-LIK<flertal<Absolut
oqarsimanillit	oqar+SIMA+NIQ-LIK<flertal<Relativ
oqarsimanilinnut	oqar+SIMA+NIQ-LIK<Terminalis<flertal
oqarsimanerpassuit	oqar+SIMA+NIQ+PASSUAQ<flertal<Absolut
oqarsimanerpassuartut	oqar+SIMA+NIQ+PASSUAQ<flertal<Aequalis
pivaa	pi<Indikativ<HanHam
pilaarpaa	pi-LAAR<Indikativ<HanHam
pisimavaa	pi+SIMA<Indikativ<HanHam
qarasaasiaq	qarasaasiaq<ental<Absolut
qarasaasiatut	qarasaasiaq<ental<Aequalis
qarasaasiaat	qarasaasiaq<ental<deres<Absolut
qarasaasiaannaq	qarasaasiaq-INNAQ<ental<Absolut
qarasaasiaannartut	qarasaasiaq-INNAQ<ental<Aequalis
qarasaasiaannaat	qarasaasiaq-INNAQ<ental<deres<Absolut
qarasaasiaannaat	qarasaasiaq-INNAQ<flertal<Absolut
qarasaasiaannaat	qarasaasiaq-INNAQ<flertal<Relativ
qarasaasiaannarnut	qarasaasiaq-INNAQ<flertal<Terminalis
qarasaasialik	qarasaasiaq-LIK<ental<Absolut
qarasaasialittut	qarasaasiaq-LIK<ental<Aequalis
qarasaasialiat	qarasaasiaq-LIK<ental<deres<Absolut
qarasaasiallit	qarasaasiaq-LIK<flertal<Absolut
qarasaasiallit	qarasaasiaq-LIK<flertal<Relativ
qarasaasialinnut	qarasaasiaq-LIK<Terminalis<flertal
qarasaasiarpassuit	qarasaasiaq+PASSUAQ<flertal<Absolut
qarasaasiarpassuartut	qarasaasiaq+PASSUAQ<flertal<Aequalis
qarasaasiarpassuarnut	qarasaasiaq+PASSUAQ<flertal<Terminalis
qarasaasianut	qarasaasiaq<Terminalis<flertal
sammisarivaa	sammisari<Indikativ<HanHam
sammisarilaarpaa	sammisari-LAAR<Indikativ<HanHam
sammisarisimavaa	sammisari+SIMA<Indikativ<HanHam
taamani	taamani<Partikel
tallimat	tallimat<Absolut
tallimatut	tallimat<Aequalis
tallimaat	tallimat<ental<deres<Absolut
tallimanut	tallimat<flertal<Terminalis
tallimaannaat	tallimat-INNAQ<flertal<Absolut
tallimaannartut	tallimat-INNAQ<flertal<Aequalis
tallimaannaat	tallimat-INNAQ<flertal<Relativ
tallimaannarnut	tallimat-INNAQ<flertal<Terminalis
tallimalik	tallimat-LIK<ental<Absolut
tallimalittut	tallimat-LIK<ental<Aequalis
tallimaliat	tallimat-LIK<ental<deres<Absolut
tallimaliit	tallimat-LIK<flertal<Absolut
tallimaliit	tallimat-LIK<flertal<Relativ
tallimalinnut	tallimat-LIK<flertal<Terminalis
ulloq	ulloq<ental<Absolut
ullutut	ulloq<ental<Aequalis
ulluat	ulloq<ental<deres<Absolut
ulluinnaq	ulloq-INNAQ<ental<Absolut
ulluinnartut	ulloq-INNAQ<ental<Aequalis
ulluinnaat	ulloq-INNAQ<ental<deres<Absolut
ulluinnaat	ulloq-INNAQ<flertal<Absolut
ulluinnaat	ulloq-INNAQ<flertal<Relativ
ulluinnarnut	ulloq-INNAQ<flertal<Terminalis
ullulik	ulloq-LIK<ental<Absolut
ullulittut	ulloq-LIK<ental<Aequalis
ulluliat	ulloq-LIK<ental<deres<Absolut
ullullit	ulloq-LIK<flertal<Absolut
ullullit	ulloq-LIK<flertal<Relativ
ullulinnut	ulloq-LIK<Terminalis<flertal
ullorpassuit	ulloq+PASSUAQ<flertal<Absolut
ullorpassuartut	ulloq+PASSUAQ<flertal<Aequalis
ullorpassuarnut	ulloq+PASSUAQ<flertal<Terminalis
ullunut	ulloq<Terminalis<flertal
ullumi	ullumi<Partikel
