aamma	aamma<Partikel
aammali	aamma<Partikel+LI
aammalu	aamma<Partikel+LU
aappaagu	aappaagu<Partikel
aappaaguli	aappaagu<Partikel+LI
aappaagulu	aappaagu<Partikel+LU
aap	aap<Partikel
aalli	aap<Partikel+LI
aallu	aap<Partikel+LU
Aasiaat	Aasiaat<Absolut
Aasiaalli	Aasiaat<Absolut+LI
Aasiaallu	Aasiaat<Absolut+LU
Aasiannik	Aasiaat<Instrumentalis
Aasiannilli	Aasiaat<Instrumentalis+LI
Aasiannillu	Aasiaat<Instrumentalis+LU
Aasianni	Aasiaat<Lokalis
Aasiannili	Aasiaat<Lokalis+LI
Aasiannilu	Aasiaat<Lokalis+LU
Aasiammiu	Aasiaat+MIU<ental<Absolut
Aasiammiumilli	Aasiaat+MIU<ental<Instrumentalis+LI
Aasiammiunut	Aasiaat+MIU<flertal<Terminalis
Aasiammiunullu	Aasiaat+MIU<flertal<Terminalis+LU
Aasiammiulerilaartartungali	Aasiaat+MIU-LIRI-LAAR=TAR<Participium<jeg+LI
Aasiammiulerisungali	Aasiaat+MIU-LIRI<Participium<jeg+LI
Aasiammiulerissavit	Aasiaat+MIU-LIRI-SSA<Interrogativ<du
Aasiammiulerissanernilli	Aasiaat+MIU-LIRI-SSA+NIQ<flertal<Instrumentalis+LI
Aasiammiulerisarpunga	Aasiaat+MIU-LIRI+TAR<Indikativ<jeg
Aasiammiunngorpungali	Aasiaat+MIU-NNGUR<Indikativ<jeg+LI
Aasiammiunngorpugullu	Aasiaat+MIU-NNGUR<Indikativ<vi+LU
Aasiammiunngornerit	Aasiaat+MIU-NNGUR+NIQ<flertal<Absolut
Aasiammiunngortunga	Aasiaat+MIU-NNGUR<Participium<jeg
Aasiammiunngortassagaluarnerni	Aasiaat+MIU-NNGUR+TAR=SSA=GALUAR+NIQ<flertal<Lokalis
Aasiammioqarporli	Aasiaat+MIU-QAR<Indikativ<han+LI
Aasiammioqarporlu	Aasiaat+MIU-QAR<Indikativ<han+LU
Aasiammioqarneq	Aasiaat+MIU-QAR+NIQ
Aasiammioqarnerli	Aasiaat+MIU-QAR+NIQ+LI
Aasiammiuulaartartunga	Aasiaat+MIU-U-LAAR=TAR<Participium<jeg
Aasiammiuunerilli	Aasiaat+MIU-U+NIQ<flertal<Relativ+LI
Aasiammiuusunga	Aasiaat+MIU-U<Participium<jeg
Aasiammiuusimanermullu	Aasiaat+MIU-U+SIMA+NIQ<ental<Terminalis+LU
Aasiammiuussasunga	Aasiaat+MIU-U-SSA<Participium<jeg
Aasiammiuusaraluartunga	Aasiaat+MIU-U+TAR=GALUAR<Participium<jeg
Aasiammiuusassavungali	Aasiaat+MIU-U+TAR=SSA<Indikativ<jeg+LI
akisooq	akisooq<ental>Absolut
akisoorli	akisooq<ental>Absolut+LI
akisuumi	akisooq<ental<Lokalis
akisuumili	akisooq<ental<Lokalis+LI
akisuunili	akisooq<flertal<Lokalis+LI
akisuuinnaq	akisooq-INNAQ<ental>Absolut
akisuuinnaat	akisooq-INNAQ<flertal<Absolut
akisuuinnanngorpunga	akisooq-INNAQ-NNGUR<Indikativ<jeg
akisuuinnanngortungalu	akisooq-INNAQ-NNGUR<Participium<jeg+LU
akisuulinnulli	akisooq-LIK<flertal<Terminalis+LI
akisuunngulaarnerli	akisooq-NNGUR-LAAR+NIQ+LI
akisuunngorsimasarnerli	akisooq-NNGUR+SIMA=TAR+NIQ+LI
akisuunngussanerli	akisooq-NNGUR-SSA+NIQ+LI
akisoorpassuit	akisooq+PASSUAQ<flertal<Absolut
akisoorpassuillu	akisooq+PASSUAQ<flertal<Absolut+LU
akisoorpassuarni	akisooq+PASSUAQ<flertal<Lokalis
akisooqalaarporli	akisooq-QAR-LAAR<Indikativ<han+LI
akisooqalaarnerli	akisooq-QAR-LAAR+NIQ+LI
akisooqarneq	akisooq-QAR+NIQ
akisooqarsimavorli	akisooq-QAR+SIMA<Indikativ<han+LI
akisooqassaneq	akisooq-QAR-SSA+NIQ
akisooqartassavorli	akisooq-QAR+TAR=SSA<Indikativ<han+LI
akisuujulaartartunga	akisooq-U-LAAR=TAR<Participium<jeg
akisuujuneralli	akisooq-U+NIQ<ental<deres<Absolut+LI
akisuujusaraluartungali	akisooq-U+TAR=GALUAR<Participium<jeg+LI
anaana	anaana<ental>Absolut
anaanamik	anaana<ental<Instrumentalis
anaanamilli	anaana<ental<Instrumentalis+LI
anaananilli	anaana<flertal<Instrumentalis+LI
anaanalittut	anaana-LIK<ental<Aequalis
anaanalilerilaartarnerit	anaana-LIK-LIRI-LAAR=TAR+NIQ<flertal<Relativ
anaanalerivugut	anaana-LIRI<Indikativ<vi
anaanalerisimavugullu	anaana-LIRI+SIMA<Indikativ<vi+LU
anaanalerisarpugut	anaana-LIRI+TAR<Indikativ<vi
anaanamiulerissasunga	anaana+MIU-LIRI-SSA<Participium<jeg
anaanamiunngoraluartungalu	anaana+MIU-NNGUR+GALUAR<Participium<jeg+LU
anaanamiunngussagaluartunga	anaana+MIU-NNGUR-SSA=GALUAR<Participium<jeg
anaanamioqarporli	anaana+MIU-QAR<Indikativ<han+LI
anaanamiuusassavit	anaana+MIU-U+TAR=SSA<Interrogativ<du
anaananngoraluartunga	anaana-NNGUR+GALUAR<Participium<jeg
anaananngortunga	anaana-NNGUR<Participium<jeg
anaanarpassuartulli	anaana+PASSUAQ<flertal<Aequalis+LI
anaanarpassuarnilli	anaana+PASSUAQ<flertal<Instrumentalis+LI
anaanaqassagaluarpunga	anaana-QAR-SSA=GALUAR<Indikativ<jeg
anaanaqassagaluartungali	anaana-QAR-SSA=GALUAR<Participium<jeg+LI
anaanaqassavit	anaana-QAR-SSA<Interrogativ<du
anaanaalaartarnerallu	anaana-U-LAAR=TAR+NIQ<ental<deres<Absolut+LU
anaanaanerit	anaana-U+NIQ<flertal<Absolut
anaanaassagaluarpunga	anaana-U-SSA=GALUAR<Indikativ<jeg
anaanaasartungalu	anaana-U+TAR<Participium<jeg+LU
angajullertulli	angajulleq<ental<Aequalis+LI
angajullialli	angajulleq<ental<deres>Absolut+LI
angajullermullu	angajulleq<ental<Terminalis+LU
angajullerni	angajulleq<flertal<Lokalis
angajulliinnarlu	angajulleq-INNAQ<ental>Absolut+LU
angajulliinnaallu	angajulleq-INNAQ<flertal<Relativ+LU
angajulliinnaasimavorlu	angajulleq-INNAQ-U+SIMA<Indikativ<han+LU
angajullillilli	angajulleq-LIK<flertal<Absolut+LI
angajullilinnut	angajulleq-LIK<flertal<Terminalis
angajullilerigaluartunga	angajulleq-LIRI+GALUAR<Participium<jeg
angajullilerilaarpoq	angajulleq-LIRI-LAAR<Indikativ<han
angajullilerilaartartungali	angajulleq-LIRI-LAAR=TAR<Participium<jeg+LI
angajullilerissaneq	angajulleq-LIRI-SSA+NIQ<ental<Absolut
angajullilerisassagaluarporlu	angajulleq-LIRI+TAR=SSA=GALUAR<Indikativ<han+LU
angajullermioqarporli	angajulleq+MIU-QAR<Indikativ<han+LI
angajullermioqarnerli	angajulleq+MIU-QAR+NIQ+LI
angajullermiuusimasarnerit	angajulleq+MIU-U+SIMA=TAR+NIQ<flertal<Relativ
angajullinngorpugullu	angajulleq-NNGUR<Indikativ<vi+LU
angajullinngussasunga	angajulleq-NNGUR-SSA<Participium<jeg
angajullerpassuarnut	angajulleq+PASSUAQ<flertal<Terminalis
angajulleqassagaluarpungalu	angajulleq-QAR-SSA=GALUAR<Indikativ<jeg+LU
angajulliussagaluarporli	angajulleq-U-SSA=GALUAR<Indikativ<han+LI
angajulliusassagaluartunga	angajulleq-U+TAR=SSA=GALUAR<Participium<jeg
arnaq	arnaq<ental>Absolut
arnarli	arnaq<ental>Absolut+LI
arnarlu	arnaq<ental>Absolut+LU
arnamik	arnaq<ental<Instrumentalis
arnami	arnaq<ental<Lokalis
arnanullu	arnaq<flertal<Terminalis+LU
arnaannarnik	arnaq-INNAQ<flertal<Instrumentalis
arnaannalerigaluartunga	arnaq-INNAQ-LIRI+GALUAR<Participium<jeg
arnaannalerisimanermut	arnaq-INNAQ-LIRI+SIMA+NIQ<ental<Terminalis
arnaannaqassagaluarpit	arnaq-INNAQ-QAR-SSA=GALUAR<Interrogativ<du
arnaannaasunga	arnaq-INNAQ-U<Participium<jeg
arnalik	arnaq-LIK<ental<Absolut
arnalittut	arnaq-LIK<ental<Aequalis
arnallillu	arnaq-LIK<flertal<Relativ+LU
arnanngussagaluarpoq	arnaq-NNGUR-SSA=GALUAR<Indikativ<han
arnanngussagaluarneq	arnaq-NNGUR-SSA=GALUAR+NIQ
arnanngussanerlu	arnaq-NNGUR-SSA+NIQ+LU
arnarpassuit	arnaq+PASSUAQ<flertal<Absolut
arnarpassuilli	arnaq+PASSUAQ<flertal<Absolut+LI
arnarpassuartut	arnaq+PASSUAQ<flertal<Aequalis
arnarpassuartulli	arnaq+PASSUAQ<flertal<Aequalis+LI
arnarpassuarnik	arnaq+PASSUAQ<flertal<Instrumentalis
arnarpassuarnut	arnaq+PASSUAQ<flertal<Terminalis
arnarpassuarnulli	arnaq+PASSUAQ<flertal<Terminalis+LI
arnarpassuarnullu	arnaq+PASSUAQ<flertal<Terminalis+LU
arnaqarsimaneq	arnaq-QAR+SIMA+NIQ
arnaqartarporli	arnaq-QAR+TAR<Indikativ<han+LI
arnaagaluarnernilli	arnaq-U+GALUAR+NIQ<flertal<Instrumentalis+LI
arnaanertulli	arnaq-U+NIQ<ental<Aequalis+LI
arnaasimavit	arnaq-U+SIMA<Interrogativ<du
arnaasimasartunga	arnaq-U+SIMA=TAR<Participium<jeg
ataatami	ataata<ental<Lokalis
ataatallit	ataata-LIK<flertal<Absolut
ataatallillu	ataata-LIK<flertal<Absolut+LU
ataatallit	ataata-LIK<flertal<Relativ
ataatamiulerisungali	ataata+MIU-LIRI<Participium<jeg+LI
ataatamioqarporli	ataata+MIU-QAR<Indikativ<han+LI
ataatanngorpunga	ataata-NNGUR<Indikativ<jeg
ataatanngulaartungali	ataata-NNGUR-LAAR<Participium<jeg+LI
ataatarpassuit	ataata+PASSUAQ<flertal<Absolut
ataatarpassuartulli	ataata+PASSUAQ<flertal<Aequalis+LI
ataatarpassuarnik	ataata+PASSUAQ<flertal<Instrumentalis
ataataqalaarpungali	ataata-QAR-LAAR<Indikativ<jeg+LI
ataataqassasungali	ataata-QAR-SSA<Participium<jeg+LI
ateqaraluartungali	ateqar+GALUAR<Participium<jeg+LI
atialli	ateq<ental<deres>Absolut+LI
atiallu	ateq<ental<deres>Absolut+LU
atiinnalerisimavunga	ateq-INNAQ-LIRI+SIMA<Indikativ<jeg
atillit	ateq-LIK<flertal<Absolut
atillit	ateq-LIK<flertal<Relativ
atillilli	ateq-LIK<flertal<Relativ+LI
atillillu	ateq-LIK<flertal<Relativ+LU
atilinngoraluarpit	ateq-LIK-NNGUR+GALUAR<Interrogativ<du
atilerissagaluartunga	ateq-LIRI-SSA=GALUAR<Participium<jeg
atinngortungali	ateq-NNGUR<Participium<jeg+LI
ateqarsimasartunga	ateq-QAR+SIMA=TAR<Participium<jeg
ateqassagaluarpugullu	ateq-QAR-SSA=GALUAR<Indikativ<vi+LU
ateqassagaluarpit	ateq-QAR-SSA=GALUAR<Interrogativ<du
atiugaluartunga	ateq-U+GALUAR<Participium<jeg
atiuit	ateq-U<Interrogativ<du
atiusunga	ateq-U<Participium<jeg
atiusungali	ateq-U<Participium<jeg+LI
atorpaanngali	ator<Indikativ<DeMig+LI
atorpaa	ator<Indikativ<HanHam
atulaarpaannga	ator-LAAR<Indikativ<DeMig
atulaarpassi	ator-LAAR<Indikativ<JegJer
atulaarpiuk	ator-LAAR<Interrogativ<DuHam
atulaartarpaali	ator-LAAR=TAR<Indikativ<HanHam+LI
atorsimavassilu	ator+SIMA<Indikativ<JegJer+LU
atorsimasarpiuk	ator+SIMA=TAR<Interrogativ<DuHam
atussagaluarpaannga	ator-SSA=GALUAR<Indikativ<DeMig
atussagaluarpiuk	ator-SSA=GALUAR<Interrogativ<DuHam
atussavaat	ator-SSA<Indikativ<DeHam
atussaviuk	ator-SSA<Interrogativ<DuHam
atortassagaluarpaa	ator+TAR=SSA=GALUAR<Indikativ<HanHam
Avanersuaq	Avanersuaq<Absolut
Avanersuarli	Avanersuaq<Absolut+LI
Avanersuarlu	Avanersuaq<Absolut+LU
Avanersuarmik	Avanersuaq<Instrumentalis
Avanersuarmilli	Avanersuaq<Instrumentalis+LI
Avanersuarmillu	Avanersuaq<Instrumentalis+LU
Avanersuarmi	Avanersuaq<Lokalis
Avanersuarmili	Avanersuaq<Lokalis+LI
Avanersuarmilu	Avanersuaq<Lokalis+LU
Avanersuarmiumi	Avanersuaq+MIU<ental<Lokalis
Avanersuarmiumilu	Avanersuaq+MIU<ental<Lokalis+LU
Avanersuarmiunilu	Avanersuaq+MIU<flertal<Lokalis+LU
Avanersuarmiunut	Avanersuaq+MIU<flertal<Terminalis
Avanersuarmiulerigaluartungali	Avanersuaq+MIU-LIRI+GALUAR<Participium<jeg+LI
Avanersuarmiulerisaraluarnernilli	Avanersuaq+MIU-LIRI+TAR=GALUAR+NIQ<flertal<Instrumentalis+LI
Avanersuarmiulerisassagaluartungali	Avanersuaq+MIU-LIRI+TAR=SSA=GALUAR<Participium<jeg+LI
Avanersuarmiunngornerit	Avanersuaq+MIU-NNGUR+NIQ<flertal<Relativ
Avanersuarmiunngorsimasarpit	Avanersuaq+MIU-NNGUR+SIMA=TAR<Interrogativ<du
Avanersuarmiunngussagaluartungalu	Avanersuaq+MIU-NNGUR-SSA=GALUAR<Participium<jeg+LU
Avanersuarmiunngortartunga	Avanersuaq+MIU-NNGUR+TAR<Participium<jeg
Avanersuarmiunngortassasunga	Avanersuaq+MIU-NNGUR+TAR=SSA<Participium<jeg
Avanersuarmioqarpoq	Avanersuaq+MIU-QAR<Indikativ<han
Avanersuarmioqarporli	Avanersuaq+MIU-QAR<Indikativ<han+LI
Avanersuarmioqarporlu	Avanersuaq+MIU-QAR<Indikativ<han+LU
Avanersuarmioqarneq	Avanersuaq+MIU-QAR+NIQ
Avanersuarmioqarnerli	Avanersuaq+MIU-QAR+NIQ+LI
Avanersuarmioqarnerlu	Avanersuaq+MIU-QAR+NIQ+LU
Avanersuarmiuugaluarporlu	Avanersuaq+MIU-U+GALUAR<Indikativ<han+LU
Avanersuarmiuugaluarpugut	Avanersuaq+MIU-U+GALUAR<Indikativ<vi
Avanersuarmiuugaluarneralli	Avanersuaq+MIU-U+GALUAR+NIQ<ental<deres<Absolut+LI
Avanersuarmiuugaluartunga	Avanersuaq+MIU-U+GALUAR<Participium<jeg
Avanersuarmiuuvugut	Avanersuaq+MIU-U<Indikativ<vi
Avanersuarmiuuit	Avanersuaq+MIU-U<Interrogativ<du
Avanersuarmiuulaarpit	Avanersuaq+MIU-U-LAAR<Interrogativ<du
Avanersuarmiuulaarneq	Avanersuaq+MIU-U-LAAR+NIQ<ental<Absolut
Avanersuarmiuulaartarpunga	Avanersuaq+MIU-U-LAAR=TAR<Indikativ<jeg
Avanersuarmiuunerat	Avanersuaq+MIU-U+NIQ<ental<deres<Absolut
Avanersuarmiuusungali	Avanersuaq+MIU-U<Participium<jeg+LI
Avanersuarmiuusungalu	Avanersuaq+MIU-U<Participium<jeg+LU
Avanersuarmiuusimasarpit	Avanersuaq+MIU-U+SIMA=TAR<Interrogativ<du
Avanersuarmiuussagaluarpungali	Avanersuaq+MIU-U-SSA=GALUAR<Indikativ<jeg+LI
Avanersuarmiuussavit	Avanersuaq+MIU-U-SSA<Interrogativ<du
Avanersuarmiuussanerallu	Avanersuaq+MIU-U-SSA+NIQ<ental<deres<Absolut+LU
Avanersuarmiuusarporli	Avanersuaq+MIU-U+TAR<Indikativ<han+LI
Avanersuarmiuusarpit	Avanersuaq+MIU-U+TAR<Interrogativ<du
Avanersuarmiuusartungalu	Avanersuaq+MIU-U+TAR<Participium<jeg+LU
Avanersuarmiuusassagaluarpunga	Avanersuaq+MIU-U+TAR=SSA=GALUAR<Indikativ<jeg
Avanersuarmiuusassagaluartungalu	Avanersuaq+MIU-U+TAR=SSA=GALUAR<Participium<jeg+LU
Avanersuarmut	Avanersuaq<Terminalis
Avanersuarmullu	Avanersuaq<Terminalis+LU
eqqaamagaluarpaannga	eqqaama+GALUAR<Indikativ<DeMig
eqqaamagaluarpaanngalu	eqqaama+GALUAR<Indikativ<DeMig+LU
eqqaamagaluarpaa	eqqaama+GALUAR<Indikativ<HanHam
eqqaamagaluarpassi	eqqaama+GALUAR<Indikativ<JegJer
eqqaamagaluarpassilu	eqqaama+GALUAR<Indikativ<JegJer+LU
eqqaamagaluarpiuk	eqqaama+GALUAR<Interrogativ<DuHam
eqqaamavaat	eqqaama<Indikativ<DeHam
eqqaamavaanngalu	eqqaama<Indikativ<DeMig+LU
eqqaamavaa	eqqaama<Indikativ<HanHam
eqqaamavassi	eqqaama<Indikativ<JegJer
eqqaamavassili	eqqaama<Indikativ<JegJer+LI
eqqaamaviuk	eqqaama<Interrogativ<DuHam
eqqaamalaarpassi	eqqaama-LAAR<Indikativ<JegJer
eqqaamalaarpiuk	eqqaama-LAAR<Interrogativ<DuHam
eqqaamalaartarpaallu	eqqaama-LAAR=TAR<Indikativ<DeHam+LU
eqqaamalaartarpiuk	eqqaama-LAAR=TAR<Interrogativ<DuHam
eqqaamasimavaat	eqqaama+SIMA<Indikativ<DeHam
eqqaamasimavaalli	eqqaama+SIMA<Indikativ<DeHam+LI
eqqaamasimavaali	eqqaama+SIMA<Indikativ<HanHam+LI
eqqaamasimavassi	eqqaama+SIMA<Indikativ<JegJer
eqqaamasimaviuk	eqqaama+SIMA<Interrogativ<DuHam
eqqaamasimasarpaallu	eqqaama+SIMA=TAR<Indikativ<DeHam+LU
eqqaamasimasarpaanngalu	eqqaama+SIMA=TAR<Indikativ<DeMig+LU
eqqaamasimasarpaa	eqqaama+SIMA=TAR<Indikativ<HanHam
eqqaamasimasarpaali	eqqaama+SIMA=TAR<Indikativ<HanHam+LI
eqqaamasimasarpiuk	eqqaama+SIMA=TAR<Interrogativ<DuHam
eqqaamassagaluarpaat	eqqaama-SSA=GALUAR<Indikativ<DeHam
eqqaamassagaluarpiuk	eqqaama-SSA=GALUAR<Interrogativ<DuHam
eqqaamassavaannga	eqqaama-SSA<Indikativ<DeMig
eqqaamassavaa	eqqaama-SSA<Indikativ<HanHam
eqqaamassavassi	eqqaama-SSA<Indikativ<JegJer
eqqaamasaraluarpaanngali	eqqaama+TAR=GALUAR<Indikativ<DeMig+LI
eqqaamasaraluarpaalu	eqqaama+TAR=GALUAR<Indikativ<HanHam+LU
eqqaamasaraluarpiuk	eqqaama+TAR=GALUAR<Interrogativ<DuHam
eqqaamasarpaa	eqqaama+TAR<Indikativ<HanHam
eqqaamasarpaali	eqqaama+TAR<Indikativ<HanHam+LI
eqqaamasarpiuk	eqqaama+TAR<Interrogativ<DuHam
eqqaamasassagaluarpaat	eqqaama+TAR=SSA=GALUAR<Indikativ<DeHam
eqqaamasassagaluarpaannga	eqqaama+TAR=SSA=GALUAR<Indikativ<DeMig
eqqaamasassagaluarpaalu	eqqaama+TAR=SSA=GALUAR<Indikativ<HanHam+LU
eqqaamasassagaluarpiuk	eqqaama+TAR=SSA=GALUAR<Interrogativ<DuHam
eqqaamasassavaalli	eqqaama+TAR=SSA<Indikativ<DeHam+LI
eqqaamasassavaallu	eqqaama+TAR=SSA<Indikativ<DeHam+LU
eqqaamasassavaannga	eqqaama+TAR=SSA<Indikativ<DeMig
eqqaamasassavaali	eqqaama+TAR=SSA<Indikativ<HanHam+LI
eqqaamasassavassi	eqqaama+TAR=SSA<Indikativ<JegJer
eqqaamasassaviuk	eqqaama+TAR=SSA<Interrogativ<DuHam
eqqumiitsuliortoq	eqqumiitsuliortoq<ental>Absolut
eqqumiitsuliortorli	eqqumiitsuliortoq<ental>Absolut+LI
eqqumiitsuliortutut	eqqumiitsuliortoq<ental<Aequalis
eqqumiitsuliortutullu	eqqumiitsuliortoq<ental<Aequalis+LU
eqqumiitsuliortumi	eqqumiitsuliortoq<ental<Lokalis
eqqumiitsuliortora	eqqumiitsuliortoq<ental<min>Absolut
eqqumiitsuliortorali	eqqumiitsuliortoq<ental<min>Absolut+LI
eqqumiitsuliortunilli	eqqumiitsuliortoq<flertal<Instrumentalis+LI
eqqumiitsuliortuni	eqqumiitsuliortoq<flertal<Lokalis
eqqumiitsuliortunili	eqqumiitsuliortoq<flertal<Lokalis+LI
eqqumiitsuliortunilu	eqqumiitsuliortoq<flertal<Lokalis+LU
eqqumiitsuliortuinnaat	eqqumiitsuliortoq-INNAQ<ental<deres>Absolut
eqqumiitsuliortuinnarmi	eqqumiitsuliortoq-INNAQ<ental<Lokalis
eqqumiitsuliortuinnalerisaraluarneralli	eqqumiitsuliortoq-INNAQ-LIRI+TAR=GALUAR+NIQ<ental<deres<Absolut+LI
eqqumiitsuliortuinnalerisarnernili	eqqumiitsuliortoq-INNAQ-LIRI+TAR+NIQ<flertal<Lokalis+LI
eqqumiitsuliortuinnanngorpugulli	eqqumiitsuliortoq-INNAQ-NNGUR<Indikativ<vi+LI
eqqumiitsuliortuinnanngulaartunga	eqqumiitsuliortoq-INNAQ-NNGUR-LAAR<Participium<jeg
eqqumiitsuliortuinnanngorsimasarpunga	eqqumiitsuliortoq-INNAQ-NNGUR+SIMA=TAR<Indikativ<jeg
eqqumiitsuliortuinnaqalaarneq	eqqumiitsuliortoq-INNAQ-QAR-LAAR+NIQ<ental<Absolut
eqqumiitsuliortuinnaqartarpit	eqqumiitsuliortoq-INNAQ-QAR+TAR<Interrogativ<du
eqqumiitsuliortuinnaalaartarnerilli	eqqumiitsuliortoq-INNAQ-U-LAAR=TAR+NIQ<flertal<Absolut+LI
eqqumiitsuliortulillu	eqqumiitsuliortoq-LIK<ental<Absolut+LU
eqqumiitsuliortulimmullu	eqqumiitsuliortoq-LIK<ental<Terminalis+LU
eqqumiitsuliortullit	eqqumiitsuliortoq-LIK<flertal<Absolut
eqqumiitsuliortullit	eqqumiitsuliortoq-LIK<flertal<Relativ
eqqumiitsuliortulilerisartunga	eqqumiitsuliortoq-LIK-LIRI+TAR<Participium<jeg
eqqumiitsuliortulerivugut	eqqumiitsuliortoq-LIRI<Indikativ<vi
eqqumiitsuliortulerilaarpit	eqqumiitsuliortoq-LIRI-LAAR<Interrogativ<du
eqqumiitsuliortulerilaarnernullu	eqqumiitsuliortoq-LIRI-LAAR+NIQ<flertal<Terminalis+LU
eqqumiitsuliortulerilaartungali	eqqumiitsuliortoq-LIRI-LAAR<Participium<jeg+LI
eqqumiitsuliortulerilaartarpunga	eqqumiitsuliortoq-LIRI-LAAR=TAR<Indikativ<jeg
eqqumiitsuliortulerisungali	eqqumiitsuliortoq-LIRI<Participium<jeg+LI
eqqumiitsuliortulerisimasarnertulli	eqqumiitsuliortoq-LIRI+SIMA=TAR+NIQ<ental<Aequalis+LI
eqqumiitsuliortulerissagaluarpugut	eqqumiitsuliortoq-LIRI-SSA=GALUAR<Indikativ<vi
eqqumiitsuliortulerissavit	eqqumiitsuliortoq-LIRI-SSA<Interrogativ<du
eqqumiitsuliortulerisassagaluarneq	eqqumiitsuliortoq-LIRI+TAR=SSA=GALUAR+NIQ<ental<Absolut
eqqumiitsuliortulerisassanertut	eqqumiitsuliortoq-LIRI+TAR=SSA+NIQ<ental<Aequalis
eqqumiitsuliortormiumulli	eqqumiitsuliortoq+MIU<ental<Terminalis+LI
eqqumiitsuliortormiunik	eqqumiitsuliortoq+MIU<flertal<Instrumentalis
eqqumiitsuliortormiunili	eqqumiitsuliortoq+MIU<flertal<Lokalis+LI
eqqumiitsuliortormiunngortungali	eqqumiitsuliortoq+MIU-NNGUR<Participium<jeg+LI
eqqumiitsuliortormiunngussagaluarpugut	eqqumiitsuliortoq+MIU-NNGUR-SSA=GALUAR<Indikativ<vi
eqqumiitsuliortormioqarporli	eqqumiitsuliortoq+MIU-QAR<Indikativ<han+LI
eqqumiitsuliortormioqarneq	eqqumiitsuliortoq+MIU-QAR+NIQ
eqqumiitsuliortormioqarnerlu	eqqumiitsuliortoq+MIU-QAR+NIQ+LU
eqqumiitsuliortormiuuit	eqqumiitsuliortoq+MIU-U<Interrogativ<du
eqqumiitsuliortormiuusimasunga	eqqumiitsuliortoq+MIU-U+SIMA<Participium<jeg
eqqumiitsuliortormiuusaraluarnerallu	eqqumiitsuliortoq+MIU-U+TAR=GALUAR+NIQ<ental<deres<Absolut+LU
eqqumiitsuliortormiuusartungalu	eqqumiitsuliortoq+MIU-U+TAR<Participium<jeg+LU
eqqumiitsuliortunngortunga	eqqumiitsuliortoq-NNGUR<Participium<jeg
eqqumiitsuliortunngorsimasunga	eqqumiitsuliortoq-NNGUR+SIMA<Participium<jeg
eqqumiitsuliortunngussagaluarpungali	eqqumiitsuliortoq-NNGUR-SSA=GALUAR<Indikativ<jeg+LI
eqqumiitsuliortunngussagaluarpit	eqqumiitsuliortoq-NNGUR-SSA=GALUAR<Interrogativ<du
eqqumiitsuliortunngussagaluartunga	eqqumiitsuliortoq-NNGUR-SSA=GALUAR<Participium<jeg
eqqumiitsuliortunngussanernik	eqqumiitsuliortoq-NNGUR-SSA+NIQ<flertal<Instrumentalis
eqqumiitsuliortunngortaraluarpit	eqqumiitsuliortoq-NNGUR+TAR=GALUAR<Interrogativ<du
eqqumiitsuliortunngortassagaluarporli	eqqumiitsuliortoq-NNGUR+TAR=SSA=GALUAR<Indikativ<han+LI
eqqumiitsuliortunngortassavunga	eqqumiitsuliortoq-NNGUR+TAR=SSA<Indikativ<jeg
eqqumiitsuliortorpassuit	eqqumiitsuliortoq+PASSUAQ<flertal<Absolut
eqqumiitsuliortorpassuilli	eqqumiitsuliortoq+PASSUAQ<flertal<Absolut+LI
eqqumiitsuliortorpassuarnik	eqqumiitsuliortoq+PASSUAQ<flertal<Instrumentalis
eqqumiitsuliortorpassuarnillu	eqqumiitsuliortoq+PASSUAQ<flertal<Instrumentalis+LU
eqqumiitsuliortorpassuarni	eqqumiitsuliortoq+PASSUAQ<flertal<Lokalis
eqqumiitsuliortorpassuarnilu	eqqumiitsuliortoq+PASSUAQ<flertal<Lokalis+LU
eqqumiitsuliortoqalaarpit	eqqumiitsuliortoq-QAR-LAAR<Interrogativ<du
eqqumiitsuliortoqalaartunga	eqqumiitsuliortoq-QAR-LAAR<Participium<jeg
eqqumiitsuliortoqalaartartunga	eqqumiitsuliortoq-QAR-LAAR=TAR<Participium<jeg
eqqumiitsuliortoqalaartartungalu	eqqumiitsuliortoq-QAR-LAAR=TAR<Participium<jeg+LU
eqqumiitsuliortoqarnerit	eqqumiitsuliortoq-QAR+NIQ<flertal<Relativ
eqqumiitsuliortoqartunga	eqqumiitsuliortoq-QAR<Participium<jeg
eqqumiitsuliortoqassagaluarpit	eqqumiitsuliortoq-QAR-SSA=GALUAR<Interrogativ<du
eqqumiitsuliortoqassagaluarnerillu	eqqumiitsuliortoq-QAR-SSA=GALUAR+NIQ<flertal<Relativ+LU
eqqumiitsuliortoqassagaluartunga	eqqumiitsuliortoq-QAR-SSA=GALUAR<Participium<jeg
eqqumiitsuliortoqassagaluartungali	eqqumiitsuliortoq-QAR-SSA=GALUAR<Participium<jeg+LI
eqqumiitsuliortoqassavugulli	eqqumiitsuliortoq-QAR-SSA<Indikativ<vi+LI
eqqumiitsuliortoqassaneq	eqqumiitsuliortoq-QAR-SSA+NIQ<ental<Absolut
eqqumiitsuliortoqassanerat	eqqumiitsuliortoq-QAR-SSA+NIQ<ental<deres<Absolut
eqqumiitsuliortoqassasunga	eqqumiitsuliortoq-QAR-SSA<Participium<jeg
eqqumiitsuliortoqassasungali	eqqumiitsuliortoq-QAR-SSA<Participium<jeg+LI
eqqumiitsuliortoqartarneralli	eqqumiitsuliortoq-QAR+TAR+NIQ<ental<deres<Absolut+LI
eqqumiitsuliortuuvugut	eqqumiitsuliortoq-U<Indikativ<vi
eqqumiitsuliortuusassagaluarpit	eqqumiitsuliortoq-U+TAR=SSA=GALUAR<Interrogativ<du
eqqumiitsuliortuusassasunga	eqqumiitsuliortoq-U+TAR=SSA<Participium<jeg
Esbjerg	Esbjerg<Absolut
Esbjergili	Esbjerg<Absolut+LI
Esbjergilu	Esbjerg<Absolut+LU
Esbjergimik	Esbjerg<Instrumentalis
Esbjergimilli	Esbjerg<Instrumentalis+LI
Esbjergimillu	Esbjerg<Instrumentalis+LU
Esbjergimi	Esbjerg<Lokalis
Esbjergimili	Esbjerg<Lokalis+LI
Esbjergimilu	Esbjerg<Lokalis+LU
Esbjergimiuli	Esbjerg+MIU<ental<Absolut+LI
Esbjergimiulu	Esbjerg+MIU<ental<Absolut+LU
Esbjergimiumi	Esbjerg+MIU<ental<Lokalis
Esbjergimiunik	Esbjerg+MIU<flertal<Instrumentalis
Esbjergimiunilli	Esbjerg+MIU<flertal<Instrumentalis+LI
Esbjergimiunillu	Esbjerg+MIU<flertal<Instrumentalis+LU
Esbjergimiuni	Esbjerg+MIU<flertal<Lokalis
Esbjergimiunilu	Esbjerg+MIU<flertal<Lokalis+LU
Esbjergimiunut	Esbjerg+MIU<flertal<Terminalis
Esbjergimiunulli	Esbjerg+MIU<flertal<Terminalis+LI
Esbjergimiunullu	Esbjerg+MIU<flertal<Terminalis+LU
Esbjergimiulerigaluarpunga	Esbjerg+MIU-LIRI+GALUAR<Indikativ<jeg
Esbjergimiulerivunga	Esbjerg+MIU-LIRI<Indikativ<jeg
Esbjergimiulerivit	Esbjerg+MIU-LIRI<Interrogativ<du
Esbjergimiulerilaarpit	Esbjerg+MIU-LIRI-LAAR<Interrogativ<du
Esbjergimiulerilaartunga	Esbjerg+MIU-LIRI-LAAR<Participium<jeg
Esbjergimiulerilaartarnermut	Esbjerg+MIU-LIRI-LAAR=TAR+NIQ<ental<Terminalis
Esbjergimiulerisunga	Esbjerg+MIU-LIRI<Participium<jeg
Esbjergimiulerissagaluartunga	Esbjerg+MIU-LIRI-SSA=GALUAR<Participium<jeg
Esbjergimiulerissanerat	Esbjerg+MIU-LIRI-SSA+NIQ<ental<deres<Absolut
Esbjergimiulerisarnerni	Esbjerg+MIU-LIRI+TAR+NIQ<flertal<Lokalis
Esbjergimiulerisartunga	Esbjerg+MIU-LIRI+TAR<Participium<jeg
Esbjergimiulerisassagaluarpunga	Esbjerg+MIU-LIRI+TAR=SSA=GALUAR<Indikativ<jeg
Esbjergimiulerisassasungalu	Esbjerg+MIU-LIRI+TAR=SSA<Participium<jeg+LU
Esbjergimiunngornerilli	Esbjerg+MIU-NNGUR+NIQ<flertal<Absolut+LI
Esbjergimiunngornerillu	Esbjerg+MIU-NNGUR+NIQ<flertal<Relativ+LU
Esbjergimiunngortunga	Esbjerg+MIU-NNGUR<Participium<jeg
Esbjergimiunngortungali	Esbjerg+MIU-NNGUR<Participium<jeg+LI
Esbjergimiunngortassagaluarporlu	Esbjerg+MIU-NNGUR+TAR=SSA=GALUAR<Indikativ<han+LU
Esbjergimioqarpoq	Esbjerg+MIU-QAR<Indikativ<han
Esbjergimioqarporli	Esbjerg+MIU-QAR<Indikativ<han+LI
Esbjergimioqarporlu	Esbjerg+MIU-QAR<Indikativ<han+LU
Esbjergimioqarneq	Esbjerg+MIU-QAR+NIQ
Esbjergimioqarnerli	Esbjerg+MIU-QAR+NIQ+LI
Esbjergimioqarnerlu	Esbjerg+MIU-QAR+NIQ+LU
Esbjergimiuugaluarpunga	Esbjerg+MIU-U+GALUAR<Indikativ<jeg
Esbjergimiuugaluartunga	Esbjerg+MIU-U+GALUAR<Participium<jeg
Esbjergimiuuvorli	Esbjerg+MIU-U<Indikativ<han+LI
Esbjergimiuuvunga	Esbjerg+MIU-U<Indikativ<jeg
Esbjergimiuuit	Esbjerg+MIU-U<Interrogativ<du
Esbjergimiuulaarpugut	Esbjerg+MIU-U-LAAR<Indikativ<vi
Esbjergimiuulaarnerat	Esbjerg+MIU-U-LAAR+NIQ<ental<deres<Absolut
Esbjergimiuulaartarpunga	Esbjerg+MIU-U-LAAR=TAR<Indikativ<jeg
Esbjergimiuulaartarpit	Esbjerg+MIU-U-LAAR=TAR<Interrogativ<du
Esbjergimiuulaartartunga	Esbjerg+MIU-U-LAAR=TAR<Participium<jeg
Esbjergimiuulaartartungali	Esbjerg+MIU-U-LAAR=TAR<Participium<jeg+LI
Esbjergimiuunerallu	Esbjerg+MIU-U+NIQ<ental<deres<Absolut+LU
Esbjergimiuunernut	Esbjerg+MIU-U+NIQ<flertal<Terminalis
Esbjergimiuusunga	Esbjerg+MIU-U<Participium<jeg
Esbjergimiuusungali	Esbjerg+MIU-U<Participium<jeg+LI
Esbjergimiuusungalu	Esbjerg+MIU-U<Participium<jeg+LU
Esbjergimiuusimavoq	Esbjerg+MIU-U+SIMA<Indikativ<han
Esbjergimiuusimavunga	Esbjerg+MIU-U+SIMA<Indikativ<jeg
Esbjergimiuusimavungalu	Esbjerg+MIU-U+SIMA<Indikativ<jeg+LU
Esbjergimiuusimanermut	Esbjerg+MIU-U+SIMA+NIQ<ental<Terminalis
Esbjergimiuusimasarporli	Esbjerg+MIU-U+SIMA=TAR<Indikativ<han+LI
Esbjergimiuusimasarpit	Esbjerg+MIU-U+SIMA=TAR<Interrogativ<du
Esbjergimiuusimasarnerlu	Esbjerg+MIU-U+SIMA=TAR+NIQ<ental<Absolut+LU
Esbjergimiuusimasartunga	Esbjerg+MIU-U+SIMA=TAR<Participium<jeg
Esbjergimiuussagaluarpoq	Esbjerg+MIU-U-SSA=GALUAR<Indikativ<han
Esbjergimiuussagaluarpungalu	Esbjerg+MIU-U-SSA=GALUAR<Indikativ<jeg+LU
Esbjergimiuussavit	Esbjerg+MIU-U-SSA<Interrogativ<du
Esbjergimiuussanermut	Esbjerg+MIU-U-SSA+NIQ<ental<Terminalis
Esbjergimiuussasunga	Esbjerg+MIU-U-SSA<Participium<jeg
Esbjergimiuusaraluarpit	Esbjerg+MIU-U+TAR=GALUAR<Interrogativ<du
Esbjergimiuusaraluarnernilu	Esbjerg+MIU-U+TAR=GALUAR+NIQ<flertal<Lokalis+LU
Esbjergimiuusaraluartunga	Esbjerg+MIU-U+TAR=GALUAR<Participium<jeg
Esbjergimiuusarpit	Esbjerg+MIU-U+TAR<Interrogativ<du
Esbjergimiuusarneq	Esbjerg+MIU-U+TAR+NIQ<ental<Absolut
Esbjergimiuusartungalu	Esbjerg+MIU-U+TAR<Participium<jeg+LU
Esbjergimiuusassagaluarpugulli	Esbjerg+MIU-U+TAR=SSA=GALUAR<Indikativ<vi+LI
Esbjergimiuusassagaluarnerat	Esbjerg+MIU-U+TAR=SSA=GALUAR+NIQ<ental<deres<Absolut
Esbjergimiuusassagaluarnernik	Esbjerg+MIU-U+TAR=SSA=GALUAR+NIQ<flertal<Instrumentalis
Esbjergimiuusassagaluarnerni	Esbjerg+MIU-U+TAR=SSA=GALUAR+NIQ<flertal<Lokalis
Esbjergimiuusassagaluarnerit	Esbjerg+MIU-U+TAR=SSA=GALUAR+NIQ<flertal<Relativ
Esbjergimiuusassagaluarnerillu	Esbjerg+MIU-U+TAR=SSA=GALUAR+NIQ<flertal<Relativ+LU
Esbjergimut	Esbjerg<Terminalis
Esbjergimulli	Esbjerg<Terminalis+LI
Esbjergimullu	Esbjerg<Terminalis+LU
Finland	Finland<Absolut
Finlandili	Finland<Absolut+LI
Finlandilu	Finland<Absolut+LU
Finlandimik	Finland<Instrumentalis
Finlandimilli	Finland<Instrumentalis+LI
Finlandimillu	Finland<Instrumentalis+LU
Finlandimi	Finland<Lokalis
Finlandimili	Finland<Lokalis+LI
Finlandimilu	Finland<Lokalis+LU
Finlandimiu	Finland+MIU<ental<Absolut
Finlandimiuli	Finland+MIU<ental<Absolut+LI
Finlandimiulu	Finland+MIU<ental<Absolut+LU
Finlandimiumik	Finland+MIU<ental<Instrumentalis
Finlandimiumilli	Finland+MIU<ental<Instrumentalis+LI
Finlandimiumillu	Finland+MIU<ental<Instrumentalis+LU
Finlandimiumili	Finland+MIU<ental<Lokalis+LI
Finlandimiumilu	Finland+MIU<ental<Lokalis+LU
Finlandimiumut	Finland+MIU<ental<Terminalis
Finlandimiunik	Finland+MIU<flertal<Instrumentalis
Finlandimiunillu	Finland+MIU<flertal<Instrumentalis+LU
Finlandimiuni	Finland+MIU<flertal<Lokalis
Finlandimiunili	Finland+MIU<flertal<Lokalis+LI
Finlandimiunulli	Finland+MIU<flertal<Terminalis+LI
Finlandimiulerilaarpunga	Finland+MIU-LIRI-LAAR<Indikativ<jeg
Finlandimiulerinerit	Finland+MIU-LIRI+NIQ<flertal<Relativ
Finlandimiulerissagaluarnerat	Finland+MIU-LIRI-SSA=GALUAR+NIQ<ental<deres<Absolut
Finlandimiulerissagaluartunga	Finland+MIU-LIRI-SSA=GALUAR<Participium<jeg
Finlandimiulerisaraluartunga	Finland+MIU-LIRI+TAR=GALUAR<Participium<jeg
Finlandimiulerisarnermulli	Finland+MIU-LIRI+TAR+NIQ<ental<Terminalis+LI
Finlandimiulerisassagaluarpungali	Finland+MIU-LIRI+TAR=SSA=GALUAR<Indikativ<jeg+LI
Finlandimiunngorpugut	Finland+MIU-NNGUR<Indikativ<vi
Finlandimiunngorpit	Finland+MIU-NNGUR<Interrogativ<du
Finlandimiunngulaarpugullu	Finland+MIU-NNGUR-LAAR<Indikativ<vi+LU
Finlandimiunngulaartarpunga	Finland+MIU-NNGUR-LAAR=TAR<Indikativ<jeg
Finlandimiunngortunga	Finland+MIU-NNGUR<Participium<jeg
Finlandimiunngorsimasartunga	Finland+MIU-NNGUR+SIMA=TAR<Participium<jeg
Finlandimiunngussagaluarpoq	Finland+MIU-NNGUR-SSA=GALUAR<Indikativ<han
Finlandimiunngussagaluartungali	Finland+MIU-NNGUR-SSA=GALUAR<Participium<jeg+LI
Finlandimiunngussasungalu	Finland+MIU-NNGUR-SSA<Participium<jeg+LU
Finlandimioqarpoq	Finland+MIU-QAR<Indikativ<han
Finlandimioqarporli	Finland+MIU-QAR<Indikativ<han+LI
Finlandimioqarporlu	Finland+MIU-QAR<Indikativ<han+LU
Finlandimioqarneq	Finland+MIU-QAR+NIQ
Finlandimioqarnerli	Finland+MIU-QAR+NIQ+LI
Finlandimioqarnerlu	Finland+MIU-QAR+NIQ+LU
Finlandimiuugaluarporli	Finland+MIU-U+GALUAR<Indikativ<han+LI
Finlandimiuugaluarpit	Finland+MIU-U+GALUAR<Interrogativ<du
Finlandimiuugaluartunga	Finland+MIU-U+GALUAR<Participium<jeg
Finlandimiuugaluartungalu	Finland+MIU-U+GALUAR<Participium<jeg+LU
Finlandimiuulaarpungali	Finland+MIU-U-LAAR<Indikativ<jeg+LI
Finlandimiuulaartarpungali	Finland+MIU-U-LAAR=TAR<Indikativ<jeg+LI
Finlandimiuulaartarpungalu	Finland+MIU-U-LAAR=TAR<Indikativ<jeg+LU
Finlandimiuulaartarpugut	Finland+MIU-U-LAAR=TAR<Indikativ<vi
Finlandimiuulaartarnerit	Finland+MIU-U-LAAR=TAR+NIQ<flertal<Relativ
Finlandimiuunerilli	Finland+MIU-U+NIQ<flertal<Relativ+LI
Finlandimiuusunga	Finland+MIU-U<Participium<jeg
Finlandimiuusungali	Finland+MIU-U<Participium<jeg+LI
Finlandimiuusimavorli	Finland+MIU-U+SIMA<Indikativ<han+LI
Finlandimiuusimavugulli	Finland+MIU-U+SIMA<Indikativ<vi+LI
Finlandimiuusimanerilli	Finland+MIU-U+SIMA+NIQ<flertal<Absolut+LI
Finlandimiuusimasunga	Finland+MIU-U+SIMA<Participium<jeg
Finlandimiuusimasarpunga	Finland+MIU-U+SIMA=TAR<Indikativ<jeg
Finlandimiuusimasarpit	Finland+MIU-U+SIMA=TAR<Interrogativ<du
Finlandimiuussavit	Finland+MIU-U-SSA<Interrogativ<du
Finlandimiuussasungali	Finland+MIU-U-SSA<Participium<jeg+LI
Finlandimiuusaraluarnerli	Finland+MIU-U+TAR=GALUAR+NIQ<ental<Absolut+LI
Finlandimiuusarpungalu	Finland+MIU-U+TAR<Indikativ<jeg+LU
Finlandimiuusarpugut	Finland+MIU-U+TAR<Indikativ<vi
Finlandimiuusarnerlu	Finland+MIU-U+TAR+NIQ<ental<Absolut+LU
Finlandimiuusartunga	Finland+MIU-U+TAR<Participium<jeg
Finlandimiuusassagaluarpunga	Finland+MIU-U+TAR=SSA=GALUAR<Indikativ<jeg
Finlandimiuusassagaluarpit	Finland+MIU-U+TAR=SSA=GALUAR<Interrogativ<du
Finlandimiuusassagaluartungali	Finland+MIU-U+TAR=SSA=GALUAR<Participium<jeg+LI
Finlandimiuusassavoq	Finland+MIU-U+TAR=SSA<Indikativ<han
Finlandimiuusassasungali	Finland+MIU-U+TAR=SSA<Participium<jeg+LI
Finlandimut	Finland<Terminalis
Finlandimulli	Finland<Terminalis+LI
Finlandimullu	Finland<Terminalis+LU
Gentofte	Gentofte<Absolut
Gentofteli	Gentofte<Absolut+LI
Gentoftelu	Gentofte<Absolut+LU
Gentoftemik	Gentofte<Instrumentalis
Gentoftemilli	Gentofte<Instrumentalis+LI
Gentoftemillu	Gentofte<Instrumentalis+LU
Gentoftemi	Gentofte<Lokalis
Gentoftemili	Gentofte<Lokalis+LI
Gentoftemilu	Gentofte<Lokalis+LU
Gentoftemiu	Gentofte+MIU<ental>Absolut
Gentoftemiuli	Gentofte+MIU<ental>Absolut+LI
Gentoftemiuat	Gentofte+MIU<ental<deres>Absolut
Gentoftemiualli	Gentofte+MIU<ental<deres>Absolut+LI
Gentoftemiumilli	Gentofte+MIU<ental<Instrumentalis+LI
Gentoftemiumi	Gentofte+MIU<ental<Lokalis
Gentoftemiumut	Gentofte+MIU<ental<Terminalis
Gentoftemiuni	Gentofte+MIU<flertal<Lokalis
Gentoftemiunili	Gentofte+MIU<flertal<Lokalis+LI
Gentoftemiunut	Gentofte+MIU<flertal<Terminalis
Gentoftemiunulli	Gentofte+MIU<flertal<Terminalis+LI
Gentoftemiunngulaartarpoq	Gentofte+MIU-NNGUR-LAAR=TAR<Indikativ<han
Gentoftemiunngulaartarnerli	Gentofte+MIU-NNGUR-LAAR=TAR+NIQ+LI
Gentoftemiunngulaartarnerlu	Gentofte+MIU-NNGUR-LAAR=TAR+NIQ+LU
Gentoftemiunngorsimavoq	Gentofte+MIU-NNGUR+SIMA<Indikativ<han
Gentoftemiunngorsimanerlu	Gentofte+MIU-NNGUR+SIMA+NIQ+LU
Gentoftemiunngorsimasarpoq	Gentofte+MIU-NNGUR+SIMA=TAR<Indikativ<han
Gentoftemiunngortaraluarpoq	Gentofte+MIU-NNGUR+TAR=GALUAR<Indikativ<han
Gentoftemut	Gentofte<Terminalis
Gentoftemulli	Gentofte<Terminalis+LI
Gentoftemullu	Gentofte<Terminalis+LU
ilaa	ilaa<Partikel
ilaalu	ilaa<Partikel+LU
ilanik	ila<flertal<Instrumentalis
ilani	ila<flertal<Lokalis
ilaannaasimasartunga	ila-INNAQ-U+SIMA=TAR<Participium<jeg
ilalinnillu	ila-LIK<flertal<Instrumentalis+LU
ilalilerisassavunga	ila-LIK-LIRI+TAR=SSA<Indikativ<jeg
ilalerineq	ila-LIRI+NIQ<ental<Absolut
ilalerissavit	ila-LIRI-SSA<Interrogativ<du
ilamiumili	ila+MIU<ental<Lokalis+LI
ilamiunngussagaluarpungalu	ila+MIU-NNGUR-SSA=GALUAR<Indikativ<jeg+LU
ilamiunngussanermulli	ila+MIU-NNGUR-SSA+NIQ<ental<Terminalis+LI
ilamioqarnerli	ila+MIU-QAR+NIQ+LI
ilamiuusassasunga	ila+MIU-U+TAR=SSA<Participium<jeg
ilanngulaartunga	ila-NNGUR-LAAR<Participium<jeg
ilanngorsimasarnernili	ila-NNGUR+SIMA=TAR+NIQ<flertal<Lokalis+LI
ilanngussanernik	ila-NNGUR-SSA+NIQ<flertal<Instrumentalis
ilanngortartunga	ila-NNGUR+TAR<Participium<jeg
ilarpassuit	ila+PASSUAQ<flertal<Absolut
ilarpassuillu	ila+PASSUAQ<flertal<Absolut+LU
ilarpassuartulli	ila+PASSUAQ<flertal<Aequalis+LI
ilaagaluartunga	ila-U+GALUAR<Participium<jeg
ilaavit	ila-U<Interrogativ<du
ilaalaartunga	ila-U-LAAR<Participium<jeg
ilaassagaluartunga	ila-U-SSA=GALUAR<Participium<jeg
ilaassasungali	ila-U-SSA<Participium<jeg+LI
ilaasarneq	ila-U+TAR+NIQ<ental<Absolut
ilinniaraluarneq	ilinniar+GALUAR+NIQ<ental<Absolut
ilinniaraluarnerit	ilinniar+GALUAR+NIQ<flertal<Absolut
ilinnialaarporlu	ilinniar-LAAR<Indikativ<han+LU
ilinnialaarpugut	ilinniar-LAAR<Indikativ<vi
ilinnialaarnerilli	ilinniar-LAAR+NIQ<flertal<Relativ+LI
ilinnialaartunga	ilinniar-LAAR<Participium<jeg
ilinnialaartarporlu	ilinniar-LAAR=TAR<Indikativ<han+LU
ilinnialaartarpunga	ilinniar-LAAR=TAR<Indikativ<jeg
ilinnialaartarpugut	ilinniar-LAAR=TAR<Indikativ<vi
ilinnialaartarpugulli	ilinniar-LAAR=TAR<Indikativ<vi+LI
ilinnialaartarpit	ilinniar-LAAR=TAR<Interrogativ<du
ilinnialaartarneralli	ilinniar-LAAR=TAR+NIQ<ental<deres<Absolut+LI
ilinnialaartarnerit	ilinniar-LAAR=TAR+NIQ<flertal<Relativ
ilinnialaartartunga	ilinniar-LAAR=TAR<Participium<jeg
ilinnialaartartungali	ilinniar-LAAR=TAR<Participium<jeg+LI
ilinniarnertuunngorniarfippassuarnik	ilinniarnertuunngorniarfik+PASSUAQ<flertal<Instrumentalis
ilinniarnerit	ilinniar+NIQ<flertal<Relativ
ilinniarnerilli	ilinniar+NIQ<flertal<Relativ+LI
ilinniartunga	ilinniar<Participium<jeg
ilinniarsimasarpunga	ilinniar+SIMA=TAR<Indikativ<jeg
ilinniarsimasarpungali	ilinniar+SIMA=TAR<Indikativ<jeg+LI
ilinniassagaluarporlu	ilinniar-SSA=GALUAR<Indikativ<han+LU
ilinniassagaluarpungali	ilinniar-SSA=GALUAR<Indikativ<jeg+LI
ilinniassagaluarpit	ilinniar-SSA=GALUAR<Interrogativ<du
ilinniassagaluarnernulli	ilinniar-SSA=GALUAR+NIQ<flertal<Terminalis+LI
ilinniassagaluartunga	ilinniar-SSA=GALUAR<Participium<jeg
ilinniassavorli	ilinniar-SSA<Indikativ<han+LI
ilinniassavugut	ilinniar-SSA<Indikativ<vi
ilinniassanernili	ilinniar-SSA+NIQ<flertal<Lokalis+LI
ilinniartaraluarneq	ilinniar+TAR=GALUAR+NIQ<ental<Absolut
ilinniartarnerit	ilinniar+TAR+NIQ<flertal<Absolut
ilinniartarnernili	ilinniar+TAR+NIQ<flertal<Lokalis+LI
ilinniartassagaluarpunga	ilinniar+TAR=SSA=GALUAR<Indikativ<jeg
ilinniartassagaluarpit	ilinniar+TAR=SSA=GALUAR<Interrogativ<du
ilinniartassagaluarnernik	ilinniar+TAR=SSA=GALUAR+NIQ<flertal<Instrumentalis
ilinniartassagaluartunga	ilinniar+TAR=SSA=GALUAR<Participium<jeg
ilinniartassavunga	ilinniar+TAR=SSA<Indikativ<jeg
ilinniartassasunga	ilinniar+TAR=SSA<Participium<jeg
Ilisimatusarfik	Ilisimatusarfik<ental>Absolut
Ilisimatusarfilli	Ilisimatusarfik<ental>Absolut+LI
Ilisimatusarfimmi	Ilisimatusarfik<ental<Lokalis
Ilisimatusarfinnilli	Ilisimatusarfik<flertal<Instrumentalis+LI
Ilisimatusarfinni	Ilisimatusarfik<flertal<Lokalis
Ilisimatusarfinnilu	Ilisimatusarfik<flertal<Lokalis+LU
Ilisimatusarfilerilaartartunga	Ilisimatusarfik-LIRI-LAAR=TAR<Participium<jeg
Ilisimatusarfimmiuni	Ilisimatusarfik+MIU<flertal<Lokalis
Ilisimatusarfimmiunulli	Ilisimatusarfik+MIU<flertal<Terminalis+LI
Ilisimatusarfimmiulerisassavungali	Ilisimatusarfik+MIU-LIRI+TAR=SSA<Indikativ<jeg+LI
Ilisimatusarfimmiunngulaartarpit	Ilisimatusarfik+MIU-NNGUR-LAAR=TAR<Interrogativ<du
Ilisimatusarfippassuarnik	Ilisimatusarfik+PASSUAQ<flertal<Instrumentalis
Ilisimatusarfippassuarni	Ilisimatusarfik+PASSUAQ<flertal<Lokalis
Ilisimatusarfippassuarnullu	Ilisimatusarfik+PASSUAQ<flertal<Terminalis+LU
Ilisimatusarfeqarpoq	Ilisimatusarfik-QAR<Indikativ<han
Ilisimatusarfeqalaarporli	Ilisimatusarfik-QAR-LAAR<Indikativ<han+LI
Ilisimatusarfeqalaarporlu	Ilisimatusarfik-QAR-LAAR<Indikativ<han+LU
Ilisimatusarfeqalaarneq	Ilisimatusarfik-QAR-LAAR+NIQ
Ilisimatusarfeqalaarnerlu	Ilisimatusarfik-QAR-LAAR+NIQ+LU
Ilisimatusarfeqalaartarnerli	Ilisimatusarfik-QAR-LAAR=TAR+NIQ+LI
Ilisimatusarfeqarsimavoq	Ilisimatusarfik-QAR+SIMA<Indikativ<han
Ilisimatusarfeqarsimasarnerlu	Ilisimatusarfik-QAR+SIMA=TAR+NIQ+LU
Ilisimatusarfeqassagaluarneq	Ilisimatusarfik-QAR-SSA=GALUAR+NIQ
Ilisimatusarfeqassavorlu	Ilisimatusarfik-QAR-SSA<Indikativ<han+LU
Ilisimatusarfeqassanerli	Ilisimatusarfik-QAR-SSA+NIQ+LI
Ilisimatusarfeqartaraluarnerli	Ilisimatusarfik-QAR+TAR=GALUAR+NIQ+LI
Ilisimatusarfeqartarpoq	Ilisimatusarfik-QAR+TAR<Indikativ<han
Ilisimatusarfeqartassagaluarnerli	Ilisimatusarfik-QAR+TAR=SSA=GALUAR+NIQ+LI
Illoqqortoormiut	Illoqqortoormiut<Absolut
Illoqqortoormiulli	Illoqqortoormiut<Absolut+LI
Illoqqortoormiunik	Illoqqortoormiut<Instrumentalis
Illoqqortoormiunilli	Illoqqortoormiut<Instrumentalis+LI
Illoqqortoormiuni	Illoqqortoormiut<Lokalis
Illoqqortoormiunili	Illoqqortoormiut<Lokalis+LI
Illoqqortoormiunilu	Illoqqortoormiut<Lokalis+LU
Illoqqortoormiormiunillu	Illoqqortoormiut+MIU<flertal<Instrumentalis+LU
Illoqqortoormiormiuni	Illoqqortoormiut+MIU<flertal<Lokalis
Illoqqortoormiormiulerigaluarpugut	Illoqqortoormiut+MIU-LIRI+GALUAR<Indikativ<vi
Illoqqortoormiormiulerilaartarpugullu	Illoqqortoormiut+MIU-LIRI-LAAR=TAR<Indikativ<vi+LU
Illoqqortoormiormiunngulaartarneq	Illoqqortoormiut+MIU-NNGUR-LAAR=TAR+NIQ<ental<Absolut
Illoqqortoormiormiunngortarpit	Illoqqortoormiut+MIU-NNGUR+TAR<Interrogativ<du
Illoqqortoormiormioqarpoq	Illoqqortoormiut+MIU-QAR<Indikativ<han
Illoqqortoormiormioqarnerlu	Illoqqortoormiut+MIU-QAR+NIQ+LU
Illoqqortoormiormiuulaarpoq	Illoqqortoormiut+MIU-U-LAAR<Indikativ<han
Illoqqortoormiormiuusimasarpit	Illoqqortoormiut+MIU-U+SIMA=TAR<Interrogativ<du
Illoqqortoormiormiuusimasarnerit	Illoqqortoormiut+MIU-U+SIMA=TAR+NIQ<flertal<Relativ
Illoqqortoormiormiuussanerilli	Illoqqortoormiut+MIU-U-SSA+NIQ<flertal<Relativ+LI
Illoqqortoormiormiuusaraluarnertullu	Illoqqortoormiut+MIU-U+TAR=GALUAR+NIQ<ental<Aequalis+LU
Illoqqortoormiormiuusaraluarnernut	Illoqqortoormiut+MIU-U+TAR=GALUAR+NIQ<flertal<Terminalis
illutut	illu<ental<Aequalis
illuinnaassasunga	illu-INNAQ-U-SSA<Participium<jeg
illulik	illu-LIK<ental<Absolut
illullit	illu-LIK<flertal<Absolut
illullilli	illu-LIK<flertal<Absolut+LI
illullilli	illu-LIK<flertal<Relativ+LI
illulerigaluarpit	illu-LIRI+GALUAR<Interrogativ<du
illulerisartunga	illu-LIRI+TAR<Participium<jeg
illumiumut	illu+MIU<ental<Terminalis
illumiuni	illu+MIU<flertal<Lokalis
illumiunngortassasunga	illu+MIU-NNGUR+TAR=SSA<Participium<jeg
illumiuusimavunga	illu+MIU-U+SIMA<Indikativ<jeg
illumiuussasunga	illu+MIU-U-SSA<Participium<jeg
illumiuusaraluartungali	illu+MIU-U+TAR=GALUAR<Participium<jeg+LI
illunngussanermulli	illu-NNGUR-SSA+NIQ<ental<Terminalis+LI
illorpassuit	illu+PASSUAQ<flertal<Absolut
illorpassuilli	illu+PASSUAQ<flertal<Absolut+LI
illorpassuarnik	illu+PASSUAQ<flertal<Instrumentalis
illorpassuarnut	illu+PASSUAQ<flertal<Terminalis
illoqalaarnerlu	illu-QAR-LAAR+NIQ<ental<Absolut+LU
illoqalaartunga	illu-QAR-LAAR<Participium<jeg
illoqarnertulli	illu-QAR+NIQ<ental<Aequalis+LI
illoqartunga	illu-QAR<Participium<jeg
illoqartungalu	illu-QAR<Participium<jeg+LU
illoqassagaluartunga	illu-QAR-SSA=GALUAR<Participium<jeg
illoqassagaluartungali	illu-QAR-SSA=GALUAR<Participium<jeg+LI
illoqartartungalu	illu-QAR+TAR<Participium<jeg+LU
Ilulissat	Ilulissat<Absolut
Ilulissallu	Ilulissat<Absolut+LU
Ilulissanik	Ilulissat<Instrumentalis
Ilulissanilli	Ilulissat<Instrumentalis+LI
Ilulissanillu	Ilulissat<Instrumentalis+LU
Ilulissani	Ilulissat<Lokalis
Ilulissanili	Ilulissat<Lokalis+LI
Iluliarmiuli	Ilulissat+MIU<ental<Absolut+LI
Iluliarmiumi	Ilulissat+MIU<ental<Lokalis
Iluliarmiunik	Ilulissat+MIU<flertal<Instrumentalis
Iluliarmiuni	Ilulissat+MIU<flertal<Lokalis
Iluliarmiunili	Ilulissat+MIU<flertal<Lokalis+LI
Iluliarmiulerisimasarpugulli	Ilulissat+MIU-LIRI+SIMA=TAR<Indikativ<vi+LI
Iluliarmiulerisimasarpit	Ilulissat+MIU-LIRI+SIMA=TAR<Interrogativ<du
Iluliarmiunngulaartarnerillu	Ilulissat+MIU-NNGUR-LAAR=TAR+NIQ<flertal<Relativ+LU
Iluliarmiunngornerli	Ilulissat+MIU-NNGUR+NIQ<ental<Absolut+LI
Iluliarmiunngussagaluarneralli	Ilulissat+MIU-NNGUR-SSA=GALUAR+NIQ<ental<deres<Absolut+LI
Iluliarmiunngortassagaluarnerit	Ilulissat+MIU-NNGUR+TAR=SSA=GALUAR+NIQ<flertal<Absolut
Iluliarmioqarnerli	Ilulissat+MIU-QAR+NIQ+LI
Iluliarmioqarnerlu	Ilulissat+MIU-QAR+NIQ+LU
Iluliarmiuugaluartunga	Ilulissat+MIU-U+GALUAR<Participium<jeg
Iluliarmiuuit	Ilulissat+MIU-U<Interrogativ<du
Iluliarmiuuneq	Ilulissat+MIU-U+NIQ<ental<Absolut
Iluliarmiuusimasunga	Ilulissat+MIU-U+SIMA<Participium<jeg
Iluliarmiuusimasartunga	Ilulissat+MIU-U+SIMA=TAR<Participium<jeg
Iluliarmiuussagaluarporlu	Ilulissat+MIU-U-SSA=GALUAR<Indikativ<han+LU
immikkoortoq	immikkoortoq<ental>Absolut
immikkoortorlu	immikkoortoq<ental>Absolut+LU
immikkoortutut	immikkoortoq<ental<Aequalis
immikkoortumilli	immikkoortoq<ental<Instrumentalis+LI
immikkoortora	immikkoortoq<ental<min>Absolut
immikkoortorali	immikkoortoq<ental<min>Absolut+LI
immikkoortunik	immikkoortoq<flertal<Instrumentalis
immikkoortuni	immikkoortoq<flertal<Lokalis
immikkoortuinnaat	immikkoortoq-INNAQ<flertal<Relativ
immikkoortuinnalerisimasunga	immikkoortoq-INNAQ-LIRI+SIMA<Participium<jeg
immikkoortuinnaasarpit	immikkoortoq-INNAQ-U+TAR<Interrogativ<du
immikkoortullilli	immikkoortoq-LIK<flertal<Absolut+LI
immikkoortulinni	immikkoortoq-LIK<flertal<Lokalis
immikkoortullillu	immikkoortoq-LIK<flertal<Relativ+LU
immikkoortulerivit	immikkoortoq-LIRI<Interrogativ<du
immikkoortulerinerni	immikkoortoq-LIRI+NIQ<flertal<Lokalis
immikkoortulerisunga	immikkoortoq-LIRI<Participium<jeg
immikkoortormiuni	immikkoortoq+MIU<flertal<Lokalis
immikkoortormioqarpoq	immikkoortoq+MIU-QAR<Indikativ<han
immikkoortormioqarporlu	immikkoortoq+MIU-QAR<Indikativ<han+LU
immikkoortormioqarneq	immikkoortoq+MIU-QAR+NIQ
immikkoortormiuulaartarpungalu	immikkoortoq+MIU-U-LAAR=TAR<Indikativ<jeg+LU
immikkoortormiuusungali	immikkoortoq+MIU-U<Participium<jeg+LI
immikkoortormiuusimasarpit	immikkoortoq+MIU-U+SIMA=TAR<Interrogativ<du
immikkoortormiuussavoq	immikkoortoq+MIU-U-SSA<Indikativ<han
immikkoortunngorpit	immikkoortoq-NNGUR<Interrogativ<du
immikkoortunngulaartarpit	immikkoortoq-NNGUR-LAAR=TAR<Interrogativ<du
immikkoortunngulaartarnernulli	immikkoortoq-NNGUR-LAAR=TAR+NIQ<flertal<Terminalis+LI
immikkoortunngornerli	immikkoortoq-NNGUR+NIQ<ental<Absolut+LI
immikkoortorpassuillu	immikkoortoq+PASSUAQ<flertal<Absolut+LU
immikkoortorpassuartut	immikkoortoq+PASSUAQ<flertal<Aequalis
immikkoortoqalaartarpungali	immikkoortoq-QAR-LAAR=TAR<Indikativ<jeg+LI
immikkoortoqalaartarnernut	immikkoortoq-QAR-LAAR=TAR+NIQ<flertal<Terminalis
immikkoortoqartunga	immikkoortoq-QAR<Participium<jeg
immikkoortoqassagaluarpunga	immikkoortoq-QAR-SSA=GALUAR<Indikativ<jeg
immikkoortoqassagaluartungalu	immikkoortoq-QAR-SSA=GALUAR<Participium<jeg+LU
immikkoortoqassavit	immikkoortoq-QAR-SSA<Interrogativ<du
immikkoortoqassasunga	immikkoortoq-QAR-SSA<Participium<jeg
immikkoortuuit	immikkoortoq-U<Interrogativ<du
immikkoortuulaarnerilli	immikkoortoq-U-LAAR+NIQ<flertal<Absolut+LI
immikkoortuussanerit	immikkoortoq-U-SSA+NIQ<flertal<Relativ
immikkut	immikkut<Partikel
immikkulli	immikkut<Partikel+LI
immikkullu	immikkut<Partikel+LU
Ivittuut	Ivittuut<Absolut
Ivittuulli	Ivittuut<Absolut+LI
Ivittuullu	Ivittuut<Absolut+LU
Ivittuunik	Ivittuut<Instrumentalis
Ivittuunilli	Ivittuut<Instrumentalis+LI
Ivittuunillu	Ivittuut<Instrumentalis+LU
Ivittuuni	Ivittuut<Lokalis
Ivittuunili	Ivittuut<Lokalis+LI
Ivittuunilu	Ivittuut<Lokalis+LU
Ivittoormiumik	Ivittuut+MIU<ental<Instrumentalis
Ivittoormiumilli	Ivittuut+MIU<ental<Instrumentalis+LI
Ivittoormiumi	Ivittuut+MIU<ental<Lokalis
Ivittoormiumut	Ivittuut+MIU<ental<Terminalis
Ivittoormiunik	Ivittuut+MIU<flertal<Instrumentalis
Ivittoormiunut	Ivittuut+MIU<flertal<Terminalis
Ivittoormiulerivungali	Ivittuut+MIU-LIRI<Indikativ<jeg+LI
Ivittoormiulerilaarporli	Ivittuut+MIU-LIRI-LAAR<Indikativ<han+LI
Ivittoormiulerilaarnernili	Ivittuut+MIU-LIRI-LAAR+NIQ<flertal<Lokalis+LI
Ivittoormiulerilaartarnerilli	Ivittuut+MIU-LIRI-LAAR=TAR+NIQ<flertal<Relativ+LI
Ivittoormiulerisassagaluarpit	Ivittuut+MIU-LIRI+TAR=SSA=GALUAR<Interrogativ<du
Ivittoormiunngulaartarneralli	Ivittuut+MIU-NNGUR-LAAR=TAR+NIQ<ental<deres<Absolut+LI
Ivittoormiunngorneq	Ivittuut+MIU-NNGUR+NIQ<ental<Absolut
Ivittoormiunngussagaluarpungalu	Ivittuut+MIU-NNGUR-SSA=GALUAR<Indikativ<jeg+LU
Ivittoormiunngussavoq	Ivittuut+MIU-NNGUR-SSA<Indikativ<han
Ivittoormiunngussasungali	Ivittuut+MIU-NNGUR-SSA<Participium<jeg+LI
Ivittoormiunngortassavit	Ivittuut+MIU-NNGUR+TAR=SSA<Interrogativ<du
Ivittoormiunngortassanerit	Ivittuut+MIU-NNGUR+TAR=SSA+NIQ<flertal<Relativ
Ivittoormioqarpoq	Ivittuut+MIU-QAR<Indikativ<han
Ivittoormioqarporli	Ivittuut+MIU-QAR<Indikativ<han+LI
Ivittoormioqarporlu	Ivittuut+MIU-QAR<Indikativ<han+LU
Ivittoormioqarneq	Ivittuut+MIU-QAR+NIQ
Ivittoormioqarnerli	Ivittuut+MIU-QAR+NIQ+LI
Ivittoormiuuvungali	Ivittuut+MIU-U<Indikativ<jeg+LI
Ivittoormiuuit	Ivittuut+MIU-U<Interrogativ<du
Ivittoormiuunernut	Ivittuut+MIU-U+NIQ<flertal<Terminalis
Ivittoormiuusungalu	Ivittuut+MIU-U<Participium<jeg+LU
Ivittoormiuusimavugut	Ivittuut+MIU-U+SIMA<Indikativ<vi
Ivittoormiuusimanerli	Ivittuut+MIU-U+SIMA+NIQ<ental<Absolut+LI
Ivittoormiuusimanerit	Ivittuut+MIU-U+SIMA+NIQ<flertal<Relativ
Ivittoormiuusimasarpit	Ivittuut+MIU-U+SIMA=TAR<Interrogativ<du
Ivittoormiuusimasarnerat	Ivittuut+MIU-U+SIMA=TAR+NIQ<ental<deres<Absolut
Ivittoormiuusimasartunga	Ivittuut+MIU-U+SIMA=TAR<Participium<jeg
Ivittoormiuussagaluarpunga	Ivittuut+MIU-U-SSA=GALUAR<Indikativ<jeg
Ivittoormiuussagaluarneralli	Ivittuut+MIU-U-SSA=GALUAR+NIQ<ental<deres<Absolut+LI
Ivittoormiuusaraluarnermut	Ivittuut+MIU-U+TAR=GALUAR+NIQ<ental<Terminalis
Ivittoormiuusassagaluarneq	Ivittuut+MIU-U+TAR=SSA=GALUAR+NIQ<ental<Absolut
Ivittoormiuusassavunga	Ivittuut+MIU-U+TAR=SSA<Indikativ<jeg
Ivittoormiuusassavugulli	Ivittuut+MIU-U+TAR=SSA<Indikativ<vi+LI
Ivittoormiuusassasungali	Ivittuut+MIU-U+TAR=SSA<Participium<jeg+LI
kalaalerli	kalaaleq<ental>Absolut+LI
kalaalerlu	kalaaleq<ental>Absolut+LU
kalaallimik	kalaaleq<ental<Instrumentalis
kalaallimilli	kalaaleq<ental<Instrumentalis+LI
kalaallimi	kalaaleq<ental<Lokalis
kalaallimut	kalaaleq<ental<Terminalis
kalaallimulli	kalaaleq<ental<Terminalis+LI
kalaallinik	kalaaleq<flertal<Instrumentalis
kalaallinillu	kalaaleq<flertal<Instrumentalis+LU
kalaallini	kalaaleq<flertal<Lokalis
kalaaliinnaq	kalaaleq-INNAQ<ental>Absolut
kalaaliinnaat	kalaaleq-INNAQ<flertal<Absolut
kalaaliinnaat	kalaaleq-INNAQ<flertal<Relativ
kalaaliinnaassagaluarpit	kalaaleq-INNAQ-U-SSA=GALUAR<Interrogativ<du
kalaalilik	kalaaleq-LIK<ental<Absolut
kalaalilittullu	kalaaleq-LIK<ental<Aequalis+LU
kalaalilinni	kalaaleq-LIK<flertal<Lokalis
kalaalilinnilu	kalaaleq-LIK<flertal<Lokalis+LU
kalaalilinngussagaluarnermut	kalaaleq-LIK-NNGUR-SSA=GALUAR+NIQ<ental<Terminalis
kalaalinngoraluarnerat	kalaaleq-NNGUR+GALUAR+NIQ<ental<deres<Absolut
kalaalinngorpit	kalaaleq-NNGUR<Interrogativ<du
kalaalinngulaartarnerilli	kalaaleq-NNGUR-LAAR=TAR+NIQ<flertal<Absolut+LI
kalaalinngussagaluartunga	kalaaleq-NNGUR-SSA=GALUAR<Participium<jeg
kalaalinngussavugullu	kalaaleq-NNGUR-SSA<Indikativ<vi+LU
kalaalinngortaraluarporli	kalaaleq-NNGUR+TAR=GALUAR<Indikativ<han+LI
kalaalinngortassavit	kalaaleq-NNGUR+TAR=SSA<Interrogativ<du
kalaalerpassuit	kalaaleq+PASSUAQ<flertal<Absolut
kalaalerpassuilli	kalaaleq+PASSUAQ<flertal<Absolut+LI
kalaalerpassuillu	kalaaleq+PASSUAQ<flertal<Absolut+LU
kalaalerpassuarnut	kalaaleq+PASSUAQ<flertal<Terminalis
kalaaleqaraluarnerli	kalaaleq-QAR+GALUAR+NIQ+LI
kalaaleqalaarnerli	kalaaleq-QAR-LAAR+NIQ+LI
kalaaleqalaartarporli	kalaaleq-QAR-LAAR=TAR<Indikativ<han+LI
kalaaleqalaartarneq	kalaaleq-QAR-LAAR=TAR+NIQ
kalaaleqalaartarnerlu	kalaaleq-QAR-LAAR=TAR+NIQ+LU
kalaaleqassagaluarnerlu	kalaaleq-QAR-SSA=GALUAR+NIQ+LU
kalaaleqassavorli	kalaaleq-QAR-SSA<Indikativ<han+LI
kalaaleqartarnerli	kalaaleq-QAR+TAR+NIQ+LI
kalaaliugaluarporli	kalaaleq-U+GALUAR<Indikativ<han+LI
kalaaliugaluarnerni	kalaaleq-U+GALUAR+NIQ<flertal<Lokalis
kalaaliulaartartunga	kalaaleq-U-LAAR=TAR<Participium<jeg
kalaaliunernili	kalaaleq-U+NIQ<flertal<Lokalis+LI
kalaaliussagaluarporli	kalaaleq-U-SSA=GALUAR<Indikativ<han+LI
kalaaliusarneralli	kalaaleq-U+TAR+NIQ<ental<deres<Absolut+LI
kalaallisut	kalaallisut<Partikel
kalaallisulli	kalaallisut<Partikel+LI
kalaallisullu	kalaallisut<Partikel+LU
Kangaatsiaq	Kangaatsiaq<Absolut
Kangaatsiamik	Kangaatsiaq<Instrumentalis
Kangaatsiamilli	Kangaatsiaq<Instrumentalis+LI
Kangaatsiamillu	Kangaatsiaq<Instrumentalis+LU
Kangaatsiami	Kangaatsiaq<Lokalis
Kangaatsiamili	Kangaatsiaq<Lokalis+LI
Kangaatsiarmiuli	Kangaatsiaq+MIU<ental<Absolut+LI
Kangaatsiarmiumi	Kangaatsiaq+MIU<ental<Lokalis
Kangaatsiarmiuni	Kangaatsiaq+MIU<flertal<Lokalis
Kangaatsiarmiunilu	Kangaatsiaq+MIU<flertal<Lokalis+LU
Kangaatsiarmiunut	Kangaatsiaq+MIU<flertal<Terminalis
Kangaatsiarmiulerisunga	Kangaatsiaq+MIU-LIRI<Participium<jeg
Kangaatsiarmiulerisartunga	Kangaatsiaq+MIU-LIRI+TAR<Participium<jeg
Kangaatsiarmiunngornernili	Kangaatsiaq+MIU-NNGUR+NIQ<flertal<Lokalis+LI
Kangaatsiarmiunngortaraluarpoq	Kangaatsiaq+MIU-NNGUR+TAR=GALUAR<Indikativ<han
Kangaatsiarmioqarpoq	Kangaatsiaq+MIU-QAR<Indikativ<han
Kangaatsiarmioqarporli	Kangaatsiaq+MIU-QAR<Indikativ<han+LI
Kangaatsiarmioqarneq	Kangaatsiaq+MIU-QAR+NIQ
Kangaatsiarmioqarnerli	Kangaatsiaq+MIU-QAR+NIQ+LI
Kangaatsiarmioqarnerlu	Kangaatsiaq+MIU-QAR+NIQ+LU
Kangaatsiarmiuugaluartunga	Kangaatsiaq+MIU-U+GALUAR<Participium<jeg
Kangaatsiarmiuulaartarnertut	Kangaatsiaq+MIU-U-LAAR=TAR+NIQ<ental<Aequalis
Kangaatsiarmiuusunga	Kangaatsiaq+MIU-U<Participium<jeg
Kangaatsiarmiuussagaluartunga	Kangaatsiaq+MIU-U-SSA=GALUAR<Participium<jeg
Kangaatsiamut	Kangaatsiaq<Terminalis
Kangaatsiamulli	Kangaatsiaq<Terminalis+LI
Kangaatsiamullu	Kangaatsiaq<Terminalis+LU
Kangerlussuaq	Kangerlussuaq<Absolut
Kangerlussuarli	Kangerlussuaq<Absolut+LI
Kangerlussuarmik	Kangerlussuaq<Instrumentalis
Kangerlussuarmilli	Kangerlussuaq<Instrumentalis+LI
Kangerlussuarmi	Kangerlussuaq<Lokalis
Kangerlussuarmili	Kangerlussuaq<Lokalis+LI
Kangerlussuarmilu	Kangerlussuaq<Lokalis+LU
Kangerlussuarmiuli	Kangerlussuaq+MIU<ental<Absolut+LI
Kangerlussuarmiulu	Kangerlussuaq+MIU<ental<Absolut+LU
Kangerlussuarmiumili	Kangerlussuaq+MIU<ental<Lokalis+LI
Kangerlussuarmiuni	Kangerlussuaq+MIU<flertal<Lokalis
Kangerlussuarmiunili	Kangerlussuaq+MIU<flertal<Lokalis+LI
Kangerlussuarmiulerisimanerlu	Kangerlussuaq+MIU-LIRI+SIMA+NIQ<ental<Absolut+LU
Kangerlussuarmiulerisassagaluarnerit	Kangerlussuaq+MIU-LIRI+TAR=SSA=GALUAR+NIQ<flertal<Relativ
Kangerlussuarmiunngulaarpugut	Kangerlussuaq+MIU-NNGUR-LAAR<Indikativ<vi
Kangerlussuarmiunngortunga	Kangerlussuaq+MIU-NNGUR<Participium<jeg
Kangerlussuarmiunngorsimavit	Kangerlussuaq+MIU-NNGUR+SIMA<Interrogativ<du
Kangerlussuarmioqarpoq	Kangerlussuaq+MIU-QAR<Indikativ<han
Kangerlussuarmioqarporli	Kangerlussuaq+MIU-QAR<Indikativ<han+LI
Kangerlussuarmioqarporlu	Kangerlussuaq+MIU-QAR<Indikativ<han+LU
Kangerlussuarmioqarneq	Kangerlussuaq+MIU-QAR+NIQ
Kangerlussuarmioqarnerlu	Kangerlussuaq+MIU-QAR+NIQ+LU
Kangerlussuarmiuugaluarnerni	Kangerlussuaq+MIU-U+GALUAR+NIQ<flertal<Lokalis
Kangerlussuarmiuulaarpungalu	Kangerlussuaq+MIU-U-LAAR<Indikativ<jeg+LU
Kangerlussuarmiuulaartarpoq	Kangerlussuaq+MIU-U-LAAR=TAR<Indikativ<han
Kangerlussuarmiuulaartarnerilli	Kangerlussuaq+MIU-U-LAAR=TAR+NIQ<flertal<Absolut+LI
Kangerlussuarmiuusungali	Kangerlussuaq+MIU-U<Participium<jeg+LI
Kangerlussuarmiuusimasartungalu	Kangerlussuaq+MIU-U+SIMA=TAR<Participium<jeg+LU
Kangerlussuarmiuussavungali	Kangerlussuaq+MIU-U-SSA<Indikativ<jeg+LI
Kangerlussuarmiuussavugullu	Kangerlussuaq+MIU-U-SSA<Indikativ<vi+LU
Kangerlussuarmiuusassagaluarpit	Kangerlussuaq+MIU-U+TAR=SSA=GALUAR<Interrogativ<du
Kangerlussuarmiuusassanerit	Kangerlussuaq+MIU-U+TAR=SSA+NIQ<flertal<Absolut
Kangerlussuarmut	Kangerlussuaq<Terminalis
Kangerlussuarmulli	Kangerlussuaq<Terminalis+LI
kingulleq	kingulleq<ental>Absolut
kingulliat	kingulleq<ental<deres>Absolut
kingullialli	kingulleq<ental<deres>Absolut+LI
kingulliit	kingulleq<flertal<Absolut
kingullernik	kingulleq<flertal<Instrumentalis
kingullernilli	kingulleq<flertal<Instrumentalis+LI
kingulliit	kingulleq<flertal<Relativ
kingulliinnarnilli	kingulleq-INNAQ<flertal<Instrumentalis+LI
kingulliinnalerisarpunga	kingulleq-INNAQ-LIRI+TAR<Indikativ<jeg
kingulliinnaalaartunga	kingulleq-INNAQ-U-LAAR<Participium<jeg
kingulliinnaanertulli	kingulleq-INNAQ-U+NIQ<ental<Aequalis+LI
kingullilik	kingulleq-LIK<ental<Absolut
kingulliliat	kingulleq-LIK<ental<deres<Absolut
kingullilimmullu	kingulleq-LIK<ental<Terminalis+LU
kingullillilli	kingulleq-LIK<flertal<Absolut+LI
kingullilinnullu	kingulleq-LIK<flertal<Terminalis+LU
kingullililerivorli	kingulleq-LIK-LIRI<Indikativ<han+LI
kingullilerilaartarpugut	kingulleq-LIRI-LAAR=TAR<Indikativ<vi
kingullilerinerat	kingulleq-LIRI+NIQ<ental<deres<Absolut
kingullermiumi	kingulleq+MIU<ental<Lokalis
kingullermiunut	kingulleq+MIU<flertal<Terminalis
kingullermiunullu	kingulleq+MIU<flertal<Terminalis+LU
kingullermioqarporlu	kingulleq+MIU-QAR<Indikativ<han+LU
kingullermioqarneq	kingulleq+MIU-QAR+NIQ
kingullermioqarnerli	kingulleq+MIU-QAR+NIQ+LI
kingullermioqarnerlu	kingulleq+MIU-QAR+NIQ+LU
kingullermiuulaartarnernilli	kingulleq+MIU-U-LAAR=TAR+NIQ<flertal<Instrumentalis+LI
kingullermiuusimasartungalu	kingulleq+MIU-U+SIMA=TAR<Participium<jeg+LU
kingullermiuusassasungali	kingulleq+MIU-U+TAR=SSA<Participium<jeg+LI
kingullinngulaartarnernik	kingulleq-NNGUR-LAAR=TAR+NIQ<flertal<Instrumentalis
kingullinngorsimasunga	kingulleq-NNGUR+SIMA<Participium<jeg
kingullinngorsimasungalu	kingulleq-NNGUR+SIMA<Participium<jeg+LU
kingullinngussagaluartunga	kingulleq-NNGUR-SSA=GALUAR<Participium<jeg
kingullerpassuit	kingulleq+PASSUAQ<flertal<Absolut
kingullerpassuillu	kingulleq+PASSUAQ<flertal<Absolut+LU
kingullerpassuarnulli	kingulleq+PASSUAQ<flertal<Terminalis+LI
kingulleqalaarpit	kingulleq-QAR-LAAR<Interrogativ<du
kingulleqalaarnermut	kingulleq-QAR-LAAR+NIQ<ental<Terminalis
kingulleqalaartunga	kingulleq-QAR-LAAR<Participium<jeg
kingulleqalaartungali	kingulleq-QAR-LAAR<Participium<jeg+LI
kingulleqalaartarpit	kingulleq-QAR-LAAR=TAR<Interrogativ<du
kingulleqalaartarnertulli	kingulleq-QAR-LAAR=TAR+NIQ<ental<Aequalis+LI
kingulleqalaartartunga	kingulleq-QAR-LAAR=TAR<Participium<jeg
kingulleqalaartartungalu	kingulleq-QAR-LAAR=TAR<Participium<jeg+LU
kingulleqassagaluarnernik	kingulleq-QAR-SSA=GALUAR+NIQ<flertal<Instrumentalis
kingulleqassavit	kingulleq-QAR-SSA<Interrogativ<du
kingulleqassasunga	kingulleq-QAR-SSA<Participium<jeg
kingulleqartaraluarnernilu	kingulleq-QAR+TAR=GALUAR+NIQ<flertal<Lokalis+LU
kingulliuvungalu	kingulleq-U<Indikativ<jeg+LU
kingulliusimasunga	kingulleq-U+SIMA<Participium<jeg
kingulliusimasarnernullu	kingulleq-U+SIMA=TAR+NIQ<flertal<Terminalis+LU
kingulliussasunga	kingulleq-U-SSA<Participium<jeg
kingulliusaraluarnerni	kingulleq-U+TAR=GALUAR+NIQ<flertal<Lokalis
kunngitullu	kunngi<ental<Aequalis+LU
kunngimili	kunngi<ental<Lokalis+LI
kunngiga	kunngi<ental<min>Absolut
kunngini	kunngi<flertal<Lokalis
kunngiinnaq	kunngi-INNAQ<ental>Absolut
kunngiinnarmi	kunngi-INNAQ<ental<Lokalis
kunngiinnara	kunngi-INNAQ<ental<min>Absolut
kunngiinnarnut	kunngi-INNAQ<flertal<Terminalis
kunngiinnanngulaartunga	kunngi-INNAQ-NNGUR-LAAR<Participium<jeg
kunngiinnaqalaartarpoq	kunngi-INNAQ-QAR-LAAR=TAR<Indikativ<han
kunngiinnaqarsimasarpoq	kunngi-INNAQ-QAR+SIMA=TAR<Indikativ<han
kunngilittullu	kunngi-LIK<ental<Aequalis+LU
kunngilimmut	kunngi-LIK<ental<Terminalis
kunngilimmullu	kunngi-LIK<ental<Terminalis+LU
kunngillillu	kunngi-LIK<flertal<Absolut+LU
kunngilerilaartarporli	kunngi-LIRI-LAAR=TAR<Indikativ<han+LI
kunngimiu	kunngi+MIU<ental<Absolut
kunngimiumik	kunngi+MIU<ental<Instrumentalis
kunngimiunngussagaluarnerat	kunngi+MIU-NNGUR-SSA=GALUAR+NIQ<ental<deres<Absolut
kunngimioqarporli	kunngi+MIU-QAR<Indikativ<han+LI
kunngimioqarporlu	kunngi+MIU-QAR<Indikativ<han+LU
kunngimioqarnerli	kunngi+MIU-QAR+NIQ+LI
kunngimioqarnerlu	kunngi+MIU-QAR+NIQ+LU
kunngimiuulaartartungalu	kunngi+MIU-U-LAAR=TAR<Participium<jeg+LU
kunngimiuusimasungalu	kunngi+MIU-U+SIMA<Participium<jeg+LU
kunngimiuusassagaluartunga	kunngi+MIU-U+TAR=SSA=GALUAR<Participium<jeg
kunnginngulaartunga	kunngi-NNGUR-LAAR<Participium<jeg
kunnginngussagaluarpunga	kunngi-NNGUR-SSA=GALUAR<Indikativ<jeg
kunnginngussagaluartungali	kunngi-NNGUR-SSA=GALUAR<Participium<jeg+LI
kunngerpassuit	kunngi+PASSUAQ<flertal<Absolut
kunngerpassuilli	kunngi+PASSUAQ<flertal<Absolut+LI
kunngerpassuillu	kunngi+PASSUAQ<flertal<Absolut+LU
kunngerpassuartut	kunngi+PASSUAQ<flertal<Aequalis
kunngerpassuarnik	kunngi+PASSUAQ<flertal<Instrumentalis
kunngerpassuarni	kunngi+PASSUAQ<flertal<Lokalis
kunngerpassuarnut	kunngi+PASSUAQ<flertal<Terminalis
kunngerpassuarnulli	kunngi+PASSUAQ<flertal<Terminalis+LI
kunngeqalaarpit	kunngi-QAR-LAAR<Interrogativ<du
kunngeqalaarneq	kunngi-QAR-LAAR+NIQ<ental<Absolut
kunngeqalaartungalu	kunngi-QAR-LAAR<Participium<jeg+LU
kunngeqalaartarpunga	kunngi-QAR-LAAR=TAR<Indikativ<jeg
kunngeqalaartarneralli	kunngi-QAR-LAAR=TAR+NIQ<ental<deres<Absolut+LI
kunngeqartunga	kunngi-QAR<Participium<jeg
kunngeqarsimasarpunga	kunngi-QAR+SIMA=TAR<Indikativ<jeg
kunngeqassagaluarpunga	kunngi-QAR-SSA=GALUAR<Indikativ<jeg
kunngeqassagaluarnerat	kunngi-QAR-SSA=GALUAR+NIQ<ental<deres<Absolut
kunngeqassagaluartunga	kunngi-QAR-SSA=GALUAR<Participium<jeg
kunngeqassagaluartungalu	kunngi-QAR-SSA=GALUAR<Participium<jeg+LU
kunngeqassavungalu	kunngi-QAR-SSA<Indikativ<jeg+LU
kunngeqassaneq	kunngi-QAR-SSA+NIQ<ental<Absolut
kunngeqassanerni	kunngi-QAR-SSA+NIQ<flertal<Lokalis
kunngeqassasunga	kunngi-QAR-SSA<Participium<jeg
kunngiusimasartunga	kunngi-U+SIMA=TAR<Participium<jeg
Maniitsoq	Maniitsoq<Absolut
Maniitsorli	Maniitsoq<Absolut+LI
Maniitsorlu	Maniitsoq<Absolut+LU
Maniitsumik	Maniitsoq<Instrumentalis
Maniitsumilli	Maniitsoq<Instrumentalis+LI
Maniitsumillu	Maniitsoq<Instrumentalis+LU
Maniitsumi	Maniitsoq<Lokalis
Maniitsumili	Maniitsoq<Lokalis+LI
Maniitsumilu	Maniitsoq<Lokalis+LU
Maniitsormiuli	Maniitsoq+MIU<ental<Absolut+LI
Maniitsormiulu	Maniitsoq+MIU<ental<Absolut+LU
Maniitsormiumilli	Maniitsoq+MIU<ental<Instrumentalis+LI
Maniitsormiumi	Maniitsoq+MIU<ental<Lokalis
Maniitsormiumili	Maniitsoq+MIU<ental<Lokalis+LI
Maniitsormiumilu	Maniitsoq+MIU<ental<Lokalis+LU
Maniitsormiumulli	Maniitsoq+MIU<ental<Terminalis+LI
Maniitsormiunik	Maniitsoq+MIU<flertal<Instrumentalis
Maniitsormiunilli	Maniitsoq+MIU<flertal<Instrumentalis+LI
Maniitsormiunillu	Maniitsoq+MIU<flertal<Instrumentalis+LU
Maniitsormiuni	Maniitsoq+MIU<flertal<Lokalis
Maniitsormiunili	Maniitsoq+MIU<flertal<Lokalis+LI
Maniitsormiunut	Maniitsoq+MIU<flertal<Terminalis
Maniitsormiunulli	Maniitsoq+MIU<flertal<Terminalis+LI
Maniitsormiulerigaluartunga	Maniitsoq+MIU-LIRI+GALUAR<Participium<jeg
Maniitsormiulerilaartarnernut	Maniitsoq+MIU-LIRI-LAAR=TAR+NIQ<flertal<Terminalis
Maniitsormiulerisunga	Maniitsoq+MIU-LIRI<Participium<jeg
Maniitsormiulerisimasartunga	Maniitsoq+MIU-LIRI+SIMA=TAR<Participium<jeg
Maniitsormiulerissavugut	Maniitsoq+MIU-LIRI-SSA<Indikativ<vi
Maniitsormiulerisassanerli	Maniitsoq+MIU-LIRI+TAR=SSA+NIQ<ental<Absolut+LI
Maniitsormiunngulaartunga	Maniitsoq+MIU-NNGUR-LAAR<Participium<jeg
Maniitsormiunngulaartartungalu	Maniitsoq+MIU-NNGUR-LAAR=TAR<Participium<jeg+LU
Maniitsormiunngorsimanernilu	Maniitsoq+MIU-NNGUR+SIMA+NIQ<flertal<Lokalis+LU
Maniitsormioqarpoq	Maniitsoq+MIU-QAR<Indikativ<han
Maniitsormioqarporli	Maniitsoq+MIU-QAR<Indikativ<han+LI
Maniitsormioqarporlu	Maniitsoq+MIU-QAR<Indikativ<han+LU
Maniitsormioqarneq	Maniitsoq+MIU-QAR+NIQ
Maniitsormioqarnerli	Maniitsoq+MIU-QAR+NIQ+LI
Maniitsormioqarnerlu	Maniitsoq+MIU-QAR+NIQ+LU
Maniitsormiuulaarneralli	Maniitsoq+MIU-U-LAAR+NIQ<ental<deres<Absolut+LI
Maniitsormiuulaartarpunga	Maniitsoq+MIU-U-LAAR=TAR<Indikativ<jeg
Maniitsormiuulaartartunga	Maniitsoq+MIU-U-LAAR=TAR<Participium<jeg
Maniitsormiuusunga	Maniitsoq+MIU-U<Participium<jeg
Maniitsormiuusimasarneq	Maniitsoq+MIU-U+SIMA=TAR+NIQ<ental<Absolut
Maniitsormiuusimasartunga	Maniitsoq+MIU-U+SIMA=TAR<Participium<jeg
Maniitsormiuusimasartungalu	Maniitsoq+MIU-U+SIMA=TAR<Participium<jeg+LU
Maniitsormiuussagaluarpungali	Maniitsoq+MIU-U-SSA=GALUAR<Indikativ<jeg+LI
Maniitsormiuussavunga	Maniitsoq+MIU-U-SSA<Indikativ<jeg
Maniitsormiuussasunga	Maniitsoq+MIU-U-SSA<Participium<jeg
Maniitsormiuussasungalu	Maniitsoq+MIU-U-SSA<Participium<jeg+LU
Maniitsormiuusaraluarpoq	Maniitsoq+MIU-U+TAR=GALUAR<Indikativ<han
Maniitsormiuusaraluartunga	Maniitsoq+MIU-U+TAR=GALUAR<Participium<jeg
Maniitsormiuusarpunga	Maniitsoq+MIU-U+TAR<Indikativ<jeg
Maniitsormiuusassagaluarporli	Maniitsoq+MIU-U+TAR=SSA=GALUAR<Indikativ<han+LI
Maniitsormiuusassagaluarnerat	Maniitsoq+MIU-U+TAR=SSA=GALUAR+NIQ<ental<deres<Absolut
Maniitsormiuusassavit	Maniitsoq+MIU-U+TAR=SSA<Interrogativ<du
Maniitsormiuusassanerit	Maniitsoq+MIU-U+TAR=SSA+NIQ<flertal<Relativ
Maniitsormiuusassasunga	Maniitsoq+MIU-U+TAR=SSA<Participium<jeg
Maniitsumut	Maniitsoq<Terminalis
Maniitsumulli	Maniitsoq<Terminalis+LI
Maniitsumullu	Maniitsoq<Terminalis+LU
meeraq	meeraq<ental<Absolut
meerarli	meeraq<ental<Absolut+LI
meerarlu	meeraq<ental<Absolut+LU
meeqqatut	meeraq<ental<Aequalis
meeqqatulli	meeraq<ental<Aequalis+LI
meeqqatullu	meeraq<ental<Aequalis+LU
meeraat	meeraq<ental<deres<Absolut
meeraallu	meeraq<ental<deres<Absolut+LU
meeqqani	meeraq<ental<Lokalis
meeqqanili	meeraq<ental<Lokalis+LI
meeqqanilu	meeraq<ental<Lokalis+LU
meeqqamut	meeraq<ental<Terminalis
meeqqamulli	meeraq<ental<Terminalis+LI
meeqqamullu	meeraq<ental<Terminalis+LU
meeqqanik	meeraq<flertal<Instrumentalis
meeqqanilli	meeraq<flertal<Instrumentalis+LI
meeqqanillu	meeraq<flertal<Instrumentalis+LU
meeqqanut	meeraq<flertal<Terminalis
meeqqanulli	meeraq<flertal<Terminalis+LI
meeqqanullu	meeraq<flertal<Terminalis+LU
meeraannaq	meeraq-INNAQ<ental>Absolut
meeraannaallu	meeraq-INNAQ<ental<deres>Absolut+LU
meeraannarmili	meeraq-INNAQ<ental<Lokalis+LI
meeraannaat	meeraq-INNAQ<flertal<Absolut
meeraannarnillu	meeraq-INNAQ<flertal<Instrumentalis+LU
meeraannalerissanerat	meeraq-INNAQ-LIRI-SSA+NIQ<ental<deres<Absolut
meeraannanngorsimasarpunga	meeraq-INNAQ-NNGUR+SIMA=TAR<Indikativ<jeg
meeraannanngortassanerit	meeraq-INNAQ-NNGUR+TAR=SSA+NIQ<flertal<Absolut
meeraannaqalaarnertut	meeraq-INNAQ-QAR-LAAR+NIQ<ental<Aequalis
meeraannaqassagaluarnernili	meeraq-INNAQ-QAR-SSA=GALUAR+NIQ<flertal<Lokalis+LI
meeraannaqartassasunga	meeraq-INNAQ-QAR+TAR=SSA<Participium<jeg
meeraannaalaartarnernillu	meeraq-INNAQ-U-LAAR=TAR+NIQ<flertal<Instrumentalis+LU
meeraannaasaraluartunga	meeraq-INNAQ-U+TAR=GALUAR<Participium<jeg
meeralilli	meeraq-LIK<ental<Absolut+LI
meeraliat	meeraq-LIK<ental<deres<Absolut
meerallilli	meeraq-LIK<flertal<Absolut+LI
meeralinni	meeraq-LIK<flertal<Lokalis
meerallit	meeraq-LIK<flertal<Relativ
meerallilli	meeraq-LIK<flertal<Relativ+LI
meeralinnullu	meeraq-LIK<flertal<Terminalis+LU
meeralerivit	meeraq-LIRI<Interrogativ<du
meeralerinerilli	meeraq-LIRI+NIQ<flertal<Absolut+LI
meeralerisunga	meeraq-LIRI<Participium<jeg
meeralerisungalu	meeraq-LIRI<Participium<jeg+LU
meeralerisimavunga	meeraq-LIRI+SIMA<Indikativ<jeg
meeralerisimasarpungalu	meeraq-LIRI+SIMA=TAR<Indikativ<jeg+LU
meeralerisimasarnerat	meeraq-LIRI+SIMA=TAR+NIQ<ental<deres<Absolut
meeralerissaneq	meeraq-LIRI-SSA+NIQ<ental<Absolut
meeralerisaraluarpunga	meeraq-LIRI+TAR=GALUAR<Indikativ<jeg
meeralerisassasunga	meeraq-LIRI+TAR=SSA<Participium<jeg
meeranngorporli	meeraq-NNGUR<Indikativ<han+LI
meeranngulaarpungalu	meeraq-NNGUR-LAAR<Indikativ<jeg+LU
meeranngulaartarneq	meeraq-NNGUR-LAAR=TAR+NIQ<ental<Absolut
meeranngorsimasartungali	meeraq-NNGUR+SIMA=TAR<Participium<jeg+LI
meeranngussagaluarpungalu	meeraq-NNGUR-SSA=GALUAR<Indikativ<jeg+LU
meeranngussagaluartunga	meeraq-NNGUR-SSA=GALUAR<Participium<jeg
meeranngussagaluartungalu	meeraq-NNGUR-SSA=GALUAR<Participium<jeg+LU
meeranngortarpugut	meeraq-NNGUR+TAR<Indikativ<vi
meeranngortartunga	meeraq-NNGUR+TAR<Participium<jeg
meerarpassuit	meeraq+PASSUAQ<flertal<Absolut
meerarpassuilli	meeraq+PASSUAQ<flertal<Absolut+LI
meerarpassuillu	meeraq+PASSUAQ<flertal<Absolut+LU
meerarpassuartut	meeraq+PASSUAQ<flertal<Aequalis
meerarpassuartulli	meeraq+PASSUAQ<flertal<Aequalis+LI
meerarpassuarnik	meeraq+PASSUAQ<flertal<Instrumentalis
meerarpassuarnilli	meeraq+PASSUAQ<flertal<Instrumentalis+LI
meerarpassuarni	meeraq+PASSUAQ<flertal<Lokalis
meerarpassuarnut	meeraq+PASSUAQ<flertal<Terminalis
meerarpassuarnulli	meeraq+PASSUAQ<flertal<Terminalis+LI
meerarpassuarnullu	meeraq+PASSUAQ<flertal<Terminalis+LU
najugaqaraluarnernut	najugaqar+GALUAR+NIQ<flertal<Terminalis
najugaqalaarpunga	najugaqar-LAAR<Indikativ<jeg
najugaqalaarnerit	najugaqar-LAAR+NIQ<flertal<Relativ
najugaqalaartartunga	najugaqar-LAAR=TAR<Participium<jeg
najugaqalaartartungali	najugaqar-LAAR=TAR<Participium<jeg+LI
najugaqartunga	najugaqar<Participium<jeg
najugaqassagaluarnerit	najugaqar-SSA=GALUAR+NIQ<flertal<Absolut
najugaqassavit	najugaqar-SSA<Interrogativ<du
najugaqartassagaluarnerat	najugaqar+TAR=SSA=GALUAR+NIQ<ental<deres<Absolut
najugaqartassavugut	najugaqar+TAR=SSA<Indikativ<vi
najugaq	najugaq<ental>Absolut
najukkatut	najugaq<ental<Aequalis
najukkatulli	najugaq<ental<Aequalis+LI
najukkatullu	najugaq<ental<Aequalis+LU
najukkamik	najugaq<ental<Instrumentalis
najukkamilli	najugaq<ental<Instrumentalis+LI
najukkami	najugaq<ental<Lokalis
najugaralu	najugaq<ental<min>Absolut+LU
najukkamut	najugaq<ental<Terminalis
najukkamulli	najugaq<ental<Terminalis+LI
najukkanik	najugaq<flertal<Instrumentalis
najukkanillu	najugaq<flertal<Instrumentalis+LU
najukkani	najugaq<flertal<Lokalis
najukkanili	najugaq<flertal<Lokalis+LI
najukkanilu	najugaq<flertal<Lokalis+LU
najukkanulli	najugaq<flertal<Terminalis+LI
najukkanullu	najugaq<flertal<Terminalis+LU
najugaannalerisimasartungalu	najugaq-INNAQ-LIRI+SIMA=TAR<Participium<jeg+LU
najugaannanngulaartartunga	najugaq-INNAQ-NNGUR-LAAR=TAR<Participium<jeg
najugaannaqalaartarnermulli	najugaq-INNAQ-QAR-LAAR=TAR+NIQ<ental<Terminalis+LI
najugalilli	najugaq-LIK<ental<Absolut+LI
najugalimmut	najugaq-LIK<ental<Terminalis
najugallillu	najugaq-LIK<flertal<Relativ+LU
najugalerilaartunga	najugaq-LIRI-LAAR<Participium<jeg
najugalerisassagaluarpit	najugaq-LIRI+TAR=SSA=GALUAR<Interrogativ<du
najugarmiunili	najugaq+MIU<flertal<Lokalis+LI
najugarmioqarporli	najugaq+MIU-QAR<Indikativ<han+LI
najugarmioqarporlu	najugaq+MIU-QAR<Indikativ<han+LU
najugarmioqarneq	najugaq+MIU-QAR+NIQ
najugarmiuusunga	najugaq+MIU-U<Participium<jeg
najugarmiuusaraluarnerli	najugaq+MIU-U+TAR=GALUAR+NIQ<ental<Absolut+LI
najuganngoraluarpit	najugaq-NNGUR+GALUAR<Interrogativ<du
najuganngulaartartungalu	najugaq-NNGUR-LAAR=TAR<Participium<jeg+LU
najuganngorsimasartunga	najugaq-NNGUR+SIMA=TAR<Participium<jeg
najuganngortassagaluarporli	najugaq-NNGUR+TAR=SSA=GALUAR<Indikativ<han+LI
najuganngortassagaluartunga	najugaq-NNGUR+TAR=SSA=GALUAR<Participium<jeg
najuganngortassavit	najugaq-NNGUR+TAR=SSA<Interrogativ<du
najugarpassuit	najugaq+PASSUAQ<flertal<Absolut
najugarpassuarnut	najugaq+PASSUAQ<flertal<Terminalis
najugaqalaarporlu	najugaq-QAR-LAAR<Indikativ<han+LU
najugaqalaartartungali	najugaq-QAR-LAAR=TAR<Participium<jeg+LI
najugaagaluarneq	najugaq-U+GALUAR+NIQ<ental<Absolut
najugaalaartarporlu	najugaq-U-LAAR=TAR<Indikativ<han+LU
najugaasimanerit	najugaq-U+SIMA+NIQ<flertal<Absolut
nammineq	nammineq<Adjektiv
namminerli	nammineq<Adjektiv+LI
namminerlu	nammineq<Adjektiv+LU
Nanortalik	Nanortalik<Absolut
Nanortalilli	Nanortalik<Absolut+LI
Nanortalillu	Nanortalik<Absolut+LU
Nanortalimmik	Nanortalik<Instrumentalis
Nanortalimmiumi	Nanortalik+MIU<ental<Lokalis
Nanortalimmiunillu	Nanortalik+MIU<flertal<Instrumentalis+LU
Nanortalimmiunut	Nanortalik+MIU<flertal<Terminalis
Nanortalimmiunngussagaluartungali	Nanortalik+MIU-NNGUR-SSA=GALUAR<Participium<jeg+LI
Nanortalimmiunngussavunga	Nanortalik+MIU-NNGUR-SSA<Indikativ<jeg
Nanortalimmioqarpoq	Nanortalik+MIU-QAR<Indikativ<han
Nanortalimmioqarporli	Nanortalik+MIU-QAR<Indikativ<han+LI
Nanortalimmioqarporlu	Nanortalik+MIU-QAR<Indikativ<han+LU
Nanortalimmiuulaartarnerni	Nanortalik+MIU-U-LAAR=TAR+NIQ<flertal<Lokalis
Nanortalimmiuuneq	Nanortalik+MIU-U+NIQ<ental<Absolut
Nanortalimmiuusunga	Nanortalik+MIU-U<Participium<jeg
Nanortalimmiuusimanerit	Nanortalik+MIU-U+SIMA+NIQ<flertal<Relativ
Nanortalimmulli	Nanortalik<Terminalis+LI
Nanortalimmullu	Nanortalik<Terminalis+LU
Narsaq	Narsaq<Absolut
Narsarli	Narsaq<Absolut+LI
Narsamik	Narsaq<Instrumentalis
Narsamilli	Narsaq<Instrumentalis+LI
Narsamillu	Narsaq<Instrumentalis+LU
Narsami	Narsaq<Lokalis
Narsamili	Narsaq<Lokalis+LI
Narsamilu	Narsaq<Lokalis+LU
Narsarmiu	Narsaq+MIU<ental<Absolut
Narsarmioqarporlu	Narsaq+MIU-QAR<Indikativ<han+LU
Narsarmioqarneq	Narsaq+MIU-QAR+NIQ
Narsarmioqarnerli	Narsaq+MIU-QAR+NIQ+LI
Narsarmiuugaluartungali	Narsaq+MIU-U+GALUAR<Participium<jeg+LI
Narsarmiuusimavorli	Narsaq+MIU-U+SIMA<Indikativ<han+LI
Narsarmiuusimaneq	Narsaq+MIU-U+SIMA+NIQ<ental<Absolut
Narsarmiuusimasungali	Narsaq+MIU-U+SIMA<Participium<jeg+LI
Narsarmiuusassagaluarnermullu	Narsaq+MIU-U+TAR=SSA=GALUAR+NIQ<ental<Terminalis+LU
Narsamut	Narsaq<Terminalis
Narsarsuarli	Narsarsuaq<Absolut+LI
Narsarsuarlu	Narsarsuaq<Absolut+LU
Narsarsuarmiunngussasungali	Narsarsuaq+MIU-NNGUR-SSA<Participium<jeg+LI
Narsarsuarmiunngortaraluarnerat	Narsarsuaq+MIU-NNGUR+TAR=GALUAR+NIQ<ental<deres<Absolut
Narsarsuarmioqarporlu	Narsarsuaq+MIU-QAR<Indikativ<han+LU
Narsarsuarmioqarneq	Narsarsuaq+MIU-QAR+NIQ
Narsarsuarmiuusassagaluartungali	Narsarsuaq+MIU-U+TAR=SSA=GALUAR<Participium<jeg+LI
nukappiararli	nukappiaraq<ental<Absolut+LI
nukappiaqqatut	nukappiaraq<ental<Aequalis
nukappiaqqani	nukappiaraq<ental<Lokalis
nukappiaqqanili	nukappiaraq<ental<Lokalis+LI
nukappiaqqamullu	nukappiaraq<ental<Terminalis+LU
nukappiaqqanik	nukappiaraq<flertal<Instrumentalis
nukappiaqqanillu	nukappiaraq<flertal<Instrumentalis+LU
nukappiaqqanut	nukappiaraq<flertal<Terminalis
nukappiaraannaalli	nukappiaraq-INNAQ<flertal<Absolut+LI
nukappiaralilli	nukappiaraq-LIK<ental<Absolut+LI
nukappiaranngussanerit	nukappiaraq-NNGUR-SSA+NIQ<flertal<Relativ
nukarliinnaqassavunga	nukarleq-INNAQ-QAR-SSA<Indikativ<jeg
nukarlermiunilu	nukarleq+MIU<flertal<Lokalis+LU
nukarlermiuusassavunga	nukarleq+MIU-U+TAR=SSA<Indikativ<jeg
nukarlinngussagaluarnerli	nukarleq-NNGUR-SSA=GALUAR+NIQ<ental<Absolut+LI
nukarlerpassuit	nukarleq+PASSUAQ<flertal<Absolut
nukarleqalaarpit	nukarleq-QAR-LAAR<Interrogativ<du
nukarleqalaartungalu	nukarleq-QAR-LAAR<Participium<jeg+LU
nukarleqalaartarnernut	nukarleq-QAR-LAAR=TAR+NIQ<flertal<Terminalis
nukarleqalaartartunga	nukarleq-QAR-LAAR=TAR<Participium<jeg
nukarleqassagaluarporli	nukarleq-QAR-SSA=GALUAR<Indikativ<han+LI
nukarleqassagaluartungalu	nukarleq-QAR-SSA=GALUAR<Participium<jeg+LU
nukarleqassasungali	nukarleq-QAR-SSA<Participium<jeg+LI
nukarliusimasunga	nukarleq-U+SIMA<Participium<jeg
nuliamik	nuliaq<ental<Instrumentalis
nuliarali	nuliaq<ental<min>Absolut+LI
nulianilli	nuliaq<flertal<Instrumentalis+LI
nulialilli	nuliaq-LIK<ental<Absolut+LI
nuliallit	nuliaq-LIK<flertal<Absolut
nulialerivit	nuliaq-LIRI<Interrogativ<du
nulialerisunga	nuliaq-LIRI<Participium<jeg
nulialerisimasunga	nuliaq-LIRI+SIMA<Participium<jeg
nulialerisimasarnerat	nuliaq-LIRI+SIMA=TAR+NIQ<ental<deres<Absolut
nulialerisaraluartungali	nuliaq-LIRI+TAR=GALUAR<Participium<jeg+LI
nuliarmiumilli	nuliaq+MIU<ental<Instrumentalis+LI
nuliarmiuni	nuliaq+MIU<flertal<Lokalis
nuliarmiulerinerat	nuliaq+MIU-LIRI+NIQ<ental<deres<Absolut
nuliarmiunngulaartarpugulli	nuliaq+MIU-NNGUR-LAAR=TAR<Indikativ<vi+LI
nuliarmioqarneq	nuliaq+MIU-QAR+NIQ
nuliarmioqarnerli	nuliaq+MIU-QAR+NIQ+LI
nuliarmiuusarnerlu	nuliaq+MIU-U+TAR+NIQ<ental<Absolut+LU
nuliarpassuit	nuliaq+PASSUAQ<flertal<Absolut
nuliarpassuilli	nuliaq+PASSUAQ<flertal<Absolut+LI
nuliarpassuarni	nuliaq+PASSUAQ<flertal<Lokalis
nuliarpassuarnut	nuliaq+PASSUAQ<flertal<Terminalis
nuliaqaraluarpit	nuliaq-QAR+GALUAR<Interrogativ<du
nuliaqassagaluarpugullu	nuliaq-QAR-SSA=GALUAR<Indikativ<vi+LU
nuliaqassagaluarpit	nuliaq-QAR-SSA=GALUAR<Interrogativ<du
nuliaqassanerillu	nuliaq-QAR-SSA+NIQ<flertal<Absolut+LU
nuliaalaartarpunga	nuliaq-U-LAAR=TAR<Indikativ<jeg
nunali	nuna<ental>Absolut+LI
nunatut	nuna<ental<Aequalis
nunamilli	nuna<ental<Instrumentalis+LI
nunani	nuna<flertal<Lokalis
nunaannalerissagaluarpugut	nuna-INNAQ-LIRI-SSA=GALUAR<Indikativ<vi
nunaannalerisassaneq	nuna-INNAQ-LIRI+TAR=SSA+NIQ<ental<Absolut
nunaannaqassavorli	nuna-INNAQ-QAR-SSA<Indikativ<han+LI
nunalik	nuna-LIK<ental<Absolut
nunalittut	nuna-LIK<ental<Aequalis
nunalerinernulli	nuna-LIRI+NIQ<flertal<Terminalis+LI
nunalerissagaluarnertulli	nuna-LIRI-SSA=GALUAR+NIQ<ental<Aequalis+LI
nunalerisarnerilli	nuna-LIRI+TAR+NIQ<flertal<Relativ+LI
nunamiu	nuna+MIU<ental<Absolut
nunamiulerisimasartunga	nuna+MIU-LIRI+SIMA=TAR<Participium<jeg
nunamiunngussagaluarnernut	nuna+MIU-NNGUR-SSA=GALUAR+NIQ<flertal<Terminalis
nunamioqarporli	nuna+MIU-QAR<Indikativ<han+LI
nunamiuulaartartungali	nuna+MIU-U-LAAR=TAR<Participium<jeg+LI
nunanngussagaluartungalu	nuna-NNGUR-SSA=GALUAR<Participium<jeg+LU
nunarpassuit	nuna+PASSUAQ<flertal<Absolut
nunaqartassavorli	nuna-QAR+TAR=SSA<Indikativ<han+LI
Nuuk	Nuuk<Absolut
Nuulli	Nuuk<Absolut+LI
Nuullu	Nuuk<Absolut+LU
Nuummik	Nuuk<Instrumentalis
Nuummilli	Nuuk<Instrumentalis+LI
Nuummillu	Nuuk<Instrumentalis+LU
Nuummi	Nuuk<Lokalis
Nuummili	Nuuk<Lokalis+LI
Nuummiu	Nuuk+MIU<ental<Absolut
Nuummiulu	Nuuk+MIU<ental<Absolut+LU
Nuummiumi	Nuuk+MIU<ental<Lokalis
Nuummiuni	Nuuk+MIU<flertal<Lokalis
Nuummiunili	Nuuk+MIU<flertal<Lokalis+LI
Nuummiulerissagaluarnerit	Nuuk+MIU-LIRI-SSA=GALUAR+NIQ<flertal<Relativ
Nuummiunngornermut	Nuuk+MIU-NNGUR+NIQ<ental<Terminalis
Nuummiunngortassanerit	Nuuk+MIU-NNGUR+TAR=SSA+NIQ<flertal<Absolut
Nuummioqarporli	Nuuk+MIU-QAR<Indikativ<han+LI
Nuummioqarneq	Nuuk+MIU-QAR+NIQ
Nuummioqarnerli	Nuuk+MIU-QAR+NIQ+LI
Nuummiuugaluartunga	Nuuk+MIU-U+GALUAR<Participium<jeg
Nuummiuulaarpit	Nuuk+MIU-U-LAAR<Interrogativ<du
Nuummiuulaartungalu	Nuuk+MIU-U-LAAR<Participium<jeg+LU
Nuummiuunerat	Nuuk+MIU-U+NIQ<ental<deres<Absolut
Nuummiuunernut	Nuuk+MIU-U+NIQ<flertal<Terminalis
Nuummiuusunga	Nuuk+MIU-U<Participium<jeg
Nuummiuusimanerat	Nuuk+MIU-U+SIMA+NIQ<ental<deres<Absolut
Nuummiuusimasunga	Nuuk+MIU-U+SIMA<Participium<jeg
Nuummiuussagaluartunga	Nuuk+MIU-U-SSA=GALUAR<Participium<jeg
Nuummiuussaneq	Nuuk+MIU-U-SSA+NIQ<ental<Absolut
Nuummiuussasunga	Nuuk+MIU-U-SSA<Participium<jeg
Nuummiuusarpungali	Nuuk+MIU-U+TAR<Indikativ<jeg+LI
Nuummiuusassagaluartunga	Nuuk+MIU-U+TAR=SSA=GALUAR<Participium<jeg
Nuummiuusassagaluartungalu	Nuuk+MIU-U+TAR=SSA=GALUAR<Participium<jeg+LU
Nuummiuusassanertut	Nuuk+MIU-U+TAR=SSA+NIQ<ental<Aequalis
Nuummut	Nuuk<Terminalis
Nuummulli	Nuuk<Terminalis+LI
Nuummullu	Nuuk<Terminalis+LU
nuukkaluarpugut	nuup+GALUAR<Indikativ<vi
nuukkaluarpit	nuup+GALUAR<Interrogativ<du
nuukkaluarneralli	nuup+GALUAR+NIQ<ental<deres<Absolut+LI
nuukkaluarnerilli	nuup+GALUAR+NIQ<flertal<Absolut+LI
nuukkaluarnerit	nuup+GALUAR+NIQ<flertal<Relativ
nuukkaluartunga	nuup+GALUAR<Participium<jeg
nuupporlu	nuup<Indikativ<han+LU
nuuppunga	nuup<Indikativ<jeg
nuuppungali	nuup<Indikativ<jeg+LI
nuuppit	nuup<Interrogativ<du
nuulaartarneralli	nuup-LAAR=TAR+NIQ<ental<deres<Absolut+LI
nuulaartartunga	nuup-LAAR=TAR<Participium<jeg
nuunneq	nuup+NIQ<ental<Absolut
nuunnerit	nuup+NIQ<flertal<Absolut
nuunnerillu	nuup+NIQ<flertal<Absolut+LU
nuunnerilli	nuup+NIQ<flertal<Relativ+LI
nuunnernut	nuup+NIQ<flertal<Terminalis
nuuttunga	nuup<Participium<jeg
nuussimanermulli	nuup+SIMA+NIQ<ental<Terminalis+LI
nuussimasarporlu	nuup+SIMA=TAR<Indikativ<han+LU
nuussimasarpunga	nuup+SIMA=TAR<Indikativ<jeg
nuussasungalu	nuup-SSA<Participium<jeg+LU
nuuttaraluarneq	nuup+TAR=GALUAR+NIQ<ental<Absolut
nuuttartunga	nuup+TAR<Participium<jeg
oqaaserli	oqaaseq<ental>Absolut+LI
oqaaserlu	oqaaseq<ental>Absolut+LU
oqaatsitulli	oqaaseq<ental<Aequalis+LI
oqaatsimik	oqaaseq<ental<Instrumentalis
oqaatsimi	oqaaseq<ental<Lokalis
oqaatsimut	oqaaseq<ental<Terminalis
oqaatsimulli	oqaaseq<ental<Terminalis+LI
oqaatsinik	oqaaseq<flertal<Instrumentalis
oqaatsinillu	oqaaseq<flertal<Instrumentalis+LU
oqaatsini	oqaaseq<flertal<Lokalis
oqaatsinili	oqaaseq<flertal<Lokalis+LI
oqaatsinilu	oqaaseq<flertal<Lokalis+LU
oqaatsinut	oqaaseq<flertal<Terminalis
oqaatsinullu	oqaaseq<flertal<Terminalis+LU
oqaasiinnaasunga	oqaaseq-INNAQ-U<Participium<jeg
oqaasilerilaarpunga	oqaaseq-LIRI-LAAR<Indikativ<jeg
oqaasilerilaartunga	oqaaseq-LIRI-LAAR<Participium<jeg
oqaasilerilaartarneq	oqaaseq-LIRI-LAAR=TAR+NIQ<ental<Absolut
oqaasermiuusaraluarpit	oqaaseq+MIU-U+TAR=GALUAR<Interrogativ<du
oqaasinngussavunga	oqaaseq-NNGUR-SSA<Indikativ<jeg
oqaaserpassuarnulli	oqaaseq+PASSUAQ<flertal<Terminalis+LI
oqaaseqarsimavugulli	oqaaseq-QAR+SIMA<Indikativ<vi+LI
oqaaseqarsimanernilu	oqaaseq-QAR+SIMA+NIQ<flertal<Lokalis+LU
oqaaseqassanertullu	oqaaseq-QAR-SSA+NIQ<ental<Aequalis+LU
oqaaseqassasunga	oqaaseq-QAR-SSA<Participium<jeg
oqaasiusassasunga	oqaaseq-U+TAR=SSA<Participium<jeg
oqaasilerininngussagaluarnerit	oqaasilerineq-NNGUR-SSA=GALUAR+NIQ<flertal<Relativ
oqaasilerisumut	oqaasilerisoq<ental<Terminalis
oqaasilerisuinnalerisartunga	oqaasilerisoq-INNAQ-LIRI+TAR<Participium<jeg
oqaasilerisoqalaartunga	oqaasilerisoq-QAR-LAAR<Participium<jeg
oqaluttuaraluarneq	oqaluttuar+GALUAR+NIQ<ental<Absolut
oqaluttuaraluarnernik	oqaluttuar+GALUAR+NIQ<flertal<Instrumentalis
oqaluttuarporli	oqaluttuar<Indikativ<han+LI
oqaluttuarporlu	oqaluttuar<Indikativ<han+LU
oqaluttuarpunga	oqaluttuar<Indikativ<jeg
oqaluttuarpit	oqaluttuar<Interrogativ<du
oqaluttualaarpungali	oqaluttuar-LAAR<Indikativ<jeg+LI
oqaluttualaarpit	oqaluttuar-LAAR<Interrogativ<du
oqaluttualaartunga	oqaluttuar-LAAR<Participium<jeg
oqaluttualaartungali	oqaluttuar-LAAR<Participium<jeg+LI
oqaluttualaartarpunga	oqaluttuar-LAAR=TAR<Indikativ<jeg
oqaluttualaartarpit	oqaluttuar-LAAR=TAR<Interrogativ<du
oqaluttualaartarnerlu	oqaluttuar-LAAR=TAR+NIQ<ental<Absolut+LU
oqaluttualaartarnerat	oqaluttuar-LAAR=TAR+NIQ<ental<deres<Absolut
oqaluttualaartartunga	oqaluttuar-LAAR=TAR<Participium<jeg
oqaluttuarnerit	oqaluttuar+NIQ<flertal<Relativ
oqaluttuartunga	oqaluttuar<Participium<jeg
oqaluttuartungali	oqaluttuar<Participium<jeg+LI
oqaluttuarsimavoq	oqaluttuar+SIMA<Indikativ<han
oqaluttuarsimavugullu	oqaluttuar+SIMA<Indikativ<vi+LU
oqaluttuarsimaneq	oqaluttuar+SIMA+NIQ<ental<Absolut
oqaluttuarsimasarporli	oqaluttuar+SIMA=TAR<Indikativ<han+LI
oqaluttuarsimasarnermut	oqaluttuar+SIMA=TAR+NIQ<ental<Terminalis
oqaluttuarsimasartunga	oqaluttuar+SIMA=TAR<Participium<jeg
oqaluttuassagaluarpit	oqaluttuar-SSA=GALUAR<Interrogativ<du
oqaluttuassagaluarneq	oqaluttuar-SSA=GALUAR+NIQ<ental<Absolut
oqaluttuassagaluarnerillu	oqaluttuar-SSA=GALUAR+NIQ<flertal<Absolut+LU
oqaluttuassagaluarnerit	oqaluttuar-SSA=GALUAR+NIQ<flertal<Relativ
oqaluttuassagaluarnernullu	oqaluttuar-SSA=GALUAR+NIQ<flertal<Terminalis+LU
oqaluttuassagaluartunga	oqaluttuar-SSA=GALUAR<Participium<jeg
oqaluttuassagaluartungali	oqaluttuar-SSA=GALUAR<Participium<jeg+LI
oqaluttuassavungali	oqaluttuar-SSA<Indikativ<jeg+LI
oqaluttuassaneq	oqaluttuar-SSA+NIQ<ental<Absolut
oqaluttuassanerni	oqaluttuar-SSA+NIQ<flertal<Lokalis
oqaluttuassasungali	oqaluttuar-SSA<Participium<jeg+LI
oqaluttuassasungalu	oqaluttuar-SSA<Participium<jeg+LU
oqaluttuartaraluarnermut	oqaluttuar+TAR=GALUAR+NIQ<ental<Terminalis
oqaluttuartaraluartunga	oqaluttuar+TAR=GALUAR<Participium<jeg
oqaluttuartarnernili	oqaluttuar+TAR+NIQ<flertal<Lokalis+LI
oqaluttuartartunga	oqaluttuar+TAR<Participium<jeg
oqaluttuartassaneq	oqaluttuar+TAR=SSA+NIQ<ental<Absolut
oqaluttuartassanerit	oqaluttuar+TAR=SSA+NIQ<flertal<Relativ
oqaraluarpit	oqar+GALUAR<Interrogativ<du
oqaraluarnerni	oqar+GALUAR+NIQ<flertal<Lokalis
oqaraluartungali	oqar+GALUAR<Participium<jeg+LI
oqarpoq	oqar<Indikativ<han
oqarporli	oqar<Indikativ<han+LI
oqarpunga	oqar<Indikativ<jeg
oqarpit	oqar<Interrogativ<du
oqalaarporli	oqar-LAAR<Indikativ<han+LI
oqalaarpunga	oqar-LAAR<Indikativ<jeg
oqalaarpungalu	oqar-LAAR<Indikativ<jeg+LU
oqalaarpit	oqar-LAAR<Interrogativ<du
oqalaarneq	oqar-LAAR+NIQ<ental<Absolut
oqalaarnertullu	oqar-LAAR+NIQ<ental<Aequalis+LU
oqalaarneralli	oqar-LAAR+NIQ<ental<deres<Absolut+LI
oqalaarnerit	oqar-LAAR+NIQ<flertal<Absolut
oqalaarnerilli	oqar-LAAR+NIQ<flertal<Absolut+LI
oqalaarnerillu	oqar-LAAR+NIQ<flertal<Relativ+LU
oqalaartunga	oqar-LAAR<Participium<jeg
oqalaartungalu	oqar-LAAR<Participium<jeg+LU
oqalaartarpunga	oqar-LAAR=TAR<Indikativ<jeg
oqalaartarpugut	oqar-LAAR=TAR<Indikativ<vi
oqalaartarpugullu	oqar-LAAR=TAR<Indikativ<vi+LU
oqalaartarpit	oqar-LAAR=TAR<Interrogativ<du
oqalaartarnerit	oqar-LAAR=TAR+NIQ<flertal<Relativ
oqalaartartunga	oqar-LAAR=TAR<Participium<jeg
oqalaartartungalu	oqar-LAAR=TAR<Participium<jeg+LU
oqarneralli	oqar+NIQ<ental<deres<Absolut+LI
oqarnermut	oqar+NIQ<ental<Terminalis
oqarnernili	oqar+NIQ<flertal<Lokalis+LI
oqarnerit	oqar+NIQ<flertal<Relativ
oqarnerilli	oqar+NIQ<flertal<Relativ+LI
oqartunga	oqar<Participium<jeg
oqartungali	oqar<Participium<jeg+LI
oqartungalu	oqar<Participium<jeg+LU
oqarsimavungali	oqar+SIMA<Indikativ<jeg+LI
oqarsimavungalu	oqar+SIMA<Indikativ<jeg+LU
oqarsimavit	oqar+SIMA<Interrogativ<du
oqarsimanernilu	oqar+SIMA+NIQ<flertal<Lokalis+LU
oqarsimasunga	oqar+SIMA<Participium<jeg
oqarsimasarpunga	oqar+SIMA=TAR<Indikativ<jeg
oqarsimasarpungali	oqar+SIMA=TAR<Indikativ<jeg+LI
oqarsimasartungalu	oqar+SIMA=TAR<Participium<jeg+LU
oqassagaluarpunga	oqar-SSA=GALUAR<Indikativ<jeg
oqassagaluarpugut	oqar-SSA=GALUAR<Indikativ<vi
oqassagaluarpit	oqar-SSA=GALUAR<Interrogativ<du
oqassagaluarneralli	oqar-SSA=GALUAR+NIQ<ental<deres<Absolut+LI
oqassagaluarnernut	oqar-SSA=GALUAR+NIQ<flertal<Terminalis
oqassagaluarnernulli	oqar-SSA=GALUAR+NIQ<flertal<Terminalis+LI
oqassagaluartunga	oqar-SSA=GALUAR<Participium<jeg
oqassagaluartungali	oqar-SSA=GALUAR<Participium<jeg+LI
oqassagaluartungalu	oqar-SSA=GALUAR<Participium<jeg+LU
oqassavoq	oqar-SSA<Indikativ<han
oqassavunga	oqar-SSA<Indikativ<jeg
oqassavugut	oqar-SSA<Indikativ<vi
oqassavit	oqar-SSA<Interrogativ<du
oqassanerli	oqar-SSA+NIQ<ental<Absolut+LI
oqassaneralli	oqar-SSA+NIQ<ental<deres<Absolut+LI
oqassanerit	oqar-SSA+NIQ<flertal<Relativ
oqassasunga	oqar-SSA<Participium<jeg
oqassasungali	oqar-SSA<Participium<jeg+LI
oqartaraluarpunga	oqar+TAR=GALUAR<Indikativ<jeg
oqartaraluarnerit	oqar+TAR=GALUAR+NIQ<flertal<Relativ
oqartaraluarnerilli	oqar+TAR=GALUAR+NIQ<flertal<Relativ+LI
oqartaraluartungali	oqar+TAR=GALUAR<Participium<jeg+LI
oqartarpungalu	oqar+TAR<Indikativ<jeg+LU
oqartarnerillu	oqar+TAR+NIQ<flertal<Relativ+LU
oqartassanerat	oqar+TAR=SSA+NIQ<ental<deres<Absolut
Paamiut	Paamiut<Absolut
Paamiulli	Paamiut<Absolut+LI
Paamiullu	Paamiut<Absolut+LU
Paamiunik	Paamiut<Instrumentalis
Paamiunilli	Paamiut<Instrumentalis+LI
Paamiunillu	Paamiut<Instrumentalis+LU
Paamiuni	Paamiut<Lokalis
Paamiunili	Paamiut<Lokalis+LI
Paamiunilu	Paamiut<Lokalis+LU
Paamiormiu	Paamiut+MIU<ental<Absolut
Paamiormiumik	Paamiut+MIU<ental<Instrumentalis
Paamiormiumilli	Paamiut+MIU<ental<Instrumentalis+LI
Paamiormiumi	Paamiut+MIU<ental<Lokalis
Paamiormiunik	Paamiut+MIU<flertal<Instrumentalis
Paamiormiunilli	Paamiut+MIU<flertal<Instrumentalis+LI
Paamiormiuni	Paamiut+MIU<flertal<Lokalis
Paamiormiunullu	Paamiut+MIU<flertal<Terminalis+LU
Paamiormiulerilaarpoq	Paamiut+MIU-LIRI-LAAR<Indikativ<han
Paamiormiulerineq	Paamiut+MIU-LIRI+NIQ<ental<Absolut
Paamiormiulerisunga	Paamiut+MIU-LIRI<Participium<jeg
Paamiormiulerisimavunga	Paamiut+MIU-LIRI+SIMA<Indikativ<jeg
Paamiormiulerisimavit	Paamiut+MIU-LIRI+SIMA<Interrogativ<du
Paamiormiulerisimanerni	Paamiut+MIU-LIRI+SIMA+NIQ<flertal<Lokalis
Paamiormiulerisimasarpit	Paamiut+MIU-LIRI+SIMA=TAR<Interrogativ<du
Paamiormiulerissagaluarpit	Paamiut+MIU-LIRI-SSA=GALUAR<Interrogativ<du
Paamiormiulerissagaluarneq	Paamiut+MIU-LIRI-SSA=GALUAR+NIQ<ental<Absolut
Paamiormiulerissasungali	Paamiut+MIU-LIRI-SSA<Participium<jeg+LI
Paamiormiulerisaraluarporli	Paamiut+MIU-LIRI+TAR=GALUAR<Indikativ<han+LI
Paamiormiulerisartungali	Paamiut+MIU-LIRI+TAR<Participium<jeg+LI
Paamiormiulerisassagaluarpugut	Paamiut+MIU-LIRI+TAR=SSA=GALUAR<Indikativ<vi
Paamiormiulerisassavit	Paamiut+MIU-LIRI+TAR=SSA<Interrogativ<du
Paamiormiulerisassasungali	Paamiut+MIU-LIRI+TAR=SSA<Participium<jeg+LI
Paamiormiunngorpugullu	Paamiut+MIU-NNGUR<Indikativ<vi+LU
Paamiormiunngulaarpunga	Paamiut+MIU-NNGUR-LAAR<Indikativ<jeg
Paamiormiunngortunga	Paamiut+MIU-NNGUR<Participium<jeg
Paamiormiunngorsimasartunga	Paamiut+MIU-NNGUR+SIMA=TAR<Participium<jeg
Paamiormiunngussavit	Paamiut+MIU-NNGUR-SSA<Interrogativ<du
Paamiormioqarpoq	Paamiut+MIU-QAR<Indikativ<han
Paamiormioqarporli	Paamiut+MIU-QAR<Indikativ<han+LI
Paamiormioqarporlu	Paamiut+MIU-QAR<Indikativ<han+LU
Paamiormioqarneq	Paamiut+MIU-QAR+NIQ
Paamiormioqarnerli	Paamiut+MIU-QAR+NIQ+LI
Paamiormioqarnerlu	Paamiut+MIU-QAR+NIQ+LU
Paamiormiuugaluarporli	Paamiut+MIU-U+GALUAR<Indikativ<han+LI
Paamiormiuugaluarnertut	Paamiut+MIU-U+GALUAR+NIQ<ental<Aequalis
Paamiormiuugaluarnertullu	Paamiut+MIU-U+GALUAR+NIQ<ental<Aequalis+LU
Paamiormiuugaluartunga	Paamiut+MIU-U+GALUAR<Participium<jeg
Paamiormiuuvorli	Paamiut+MIU-U<Indikativ<han+LI
Paamiormiuuvunga	Paamiut+MIU-U<Indikativ<jeg
Paamiormiuuvugullu	Paamiut+MIU-U<Indikativ<vi+LU
Paamiormiuuit	Paamiut+MIU-U<Interrogativ<du
Paamiormiuulaarpugut	Paamiut+MIU-U-LAAR<Indikativ<vi
Paamiormiuulaartarpungali	Paamiut+MIU-U-LAAR=TAR<Indikativ<jeg+LI
Paamiormiuulaartarneq	Paamiut+MIU-U-LAAR=TAR+NIQ<ental<Absolut
Paamiormiuulaartarnernik	Paamiut+MIU-U-LAAR=TAR+NIQ<flertal<Instrumentalis
Paamiormiuulaartarnernilli	Paamiut+MIU-U-LAAR=TAR+NIQ<flertal<Instrumentalis+LI
Paamiormiuulaartartungalu	Paamiut+MIU-U-LAAR=TAR<Participium<jeg+LU
Paamiormiuunerat	Paamiut+MIU-U+NIQ<ental<deres<Absolut
Paamiormiuunerallu	Paamiut+MIU-U+NIQ<ental<deres<Absolut+LU
Paamiormiuunernik	Paamiut+MIU-U+NIQ<flertal<Instrumentalis
Paamiormiuunernilu	Paamiut+MIU-U+NIQ<flertal<Lokalis+LU
Paamiormiuusunga	Paamiut+MIU-U<Participium<jeg
Paamiormiuusimavugut	Paamiut+MIU-U+SIMA<Indikativ<vi
Paamiormiuusimasunga	Paamiut+MIU-U+SIMA<Participium<jeg
Paamiormiuusimasarnerit	Paamiut+MIU-U+SIMA=TAR+NIQ<flertal<Relativ
Paamiormiuussagaluarpit	Paamiut+MIU-U-SSA=GALUAR<Interrogativ<du
Paamiormiuussavunga	Paamiut+MIU-U-SSA<Indikativ<jeg
Paamiormiuussasunga	Paamiut+MIU-U-SSA<Participium<jeg
Paamiormiuussasungalu	Paamiut+MIU-U-SSA<Participium<jeg+LU
Paamiormiuusaraluarpungali	Paamiut+MIU-U+TAR=GALUAR<Indikativ<jeg+LI
Paamiormiuusaraluarpungalu	Paamiut+MIU-U+TAR=GALUAR<Indikativ<jeg+LU
Paamiormiuusaraluarpit	Paamiut+MIU-U+TAR=GALUAR<Interrogativ<du
Paamiormiuusaraluartungali	Paamiut+MIU-U+TAR=GALUAR<Participium<jeg+LI
Paamiormiuusarpugulli	Paamiut+MIU-U+TAR<Indikativ<vi+LI
Paamiormiuusarnernilli	Paamiut+MIU-U+TAR+NIQ<flertal<Instrumentalis+LI
Paamiormiuusarnernut	Paamiut+MIU-U+TAR+NIQ<flertal<Terminalis
Paamiormiuusassagaluartungali	Paamiut+MIU-U+TAR=SSA=GALUAR<Participium<jeg+LI
Paamiormiuusassagaluartungalu	Paamiut+MIU-U+TAR=SSA=GALUAR<Participium<jeg+LU
Paamiormiuusassanerat	Paamiut+MIU-U+TAR=SSA+NIQ<ental<deres<Absolut
piareeraluarpit	piareer+GALUAR<Interrogativ<du
piariilaartunga	piareer-LAAR<Participium<jeg
piariilaartungalu	piareer-LAAR<Participium<jeg+LU
piariilaartarnerillu	piareer-LAAR=TAR+NIQ<flertal<Absolut+LU
piariilaartartunga	piareer-LAAR=TAR<Participium<jeg
piareersimasarnerat	piareer+SIMA=TAR+NIQ<ental<deres<Absolut
piareersimasarnernik	piareer+SIMA=TAR+NIQ<flertal<Instrumentalis
piareersimasartungali	piareer+SIMA=TAR<Participium<jeg+LI
piariissasunga	piareer-SSA<Participium<jeg
piareertaraluartungali	piareer+TAR=GALUAR<Participium<jeg+LI
pigaluarpaalli	pi+GALUAR<Indikativ<DeHam+LI
pigaluarpaallu	pi+GALUAR<Indikativ<DeHam+LU
pigaluarpaannga	pi+GALUAR<Indikativ<DeMig
pigaluarpaa	pi+GALUAR<Indikativ<HanHam
pigaluarpaali	pi+GALUAR<Indikativ<HanHam+LI
pigaluarpaalu	pi+GALUAR<Indikativ<HanHam+LU
pigaluarpassi	pi+GALUAR<Indikativ<JegJer
pigaluarpassilu	pi+GALUAR<Indikativ<JegJer+LU
pigaluarpiuk	pi+GALUAR<Interrogativ<DuHam
pivaat	pi<Indikativ<DeHam
pivaannga	pi<Indikativ<DeMig
pivaanngali	pi<Indikativ<DeMig+LI
pivaa	pi<Indikativ<HanHam
pivassi	pi<Indikativ<JegJer
pivassili	pi<Indikativ<JegJer+LI
piviuk	pi<Interrogativ<DuHam
pilaarpaannga	pi-LAAR<Indikativ<DeMig
pilaarpaa	pi-LAAR<Indikativ<HanHam
pilaarpaalu	pi-LAAR<Indikativ<HanHam+LU
pilaarpassili	pi-LAAR<Indikativ<JegJer+LI
pilaarpassilu	pi-LAAR<Indikativ<JegJer+LU
pilaarpiuk	pi-LAAR<Interrogativ<DuHam
pilaartarpaat	pi-LAAR=TAR<Indikativ<DeHam
pilaartarpaalli	pi-LAAR=TAR<Indikativ<DeHam+LI
pilaartarpaallu	pi-LAAR=TAR<Indikativ<DeHam+LU
pilaartarpaannga	pi-LAAR=TAR<Indikativ<DeMig
pilaartarpaa	pi-LAAR=TAR<Indikativ<HanHam
pilaartarpaalu	pi-LAAR=TAR<Indikativ<HanHam+LU
pilaartarpassi	pi-LAAR=TAR<Indikativ<JegJer
pilaartarpassili	pi-LAAR=TAR<Indikativ<JegJer+LI
pilaartarpassilu	pi-LAAR=TAR<Indikativ<JegJer+LU
pilaartarpiuk	pi-LAAR=TAR<Interrogativ<DuHam
pisimavaat	pi+SIMA<Indikativ<DeHam
pisimavaannga	pi+SIMA<Indikativ<DeMig
pisimavaanngali	pi+SIMA<Indikativ<DeMig+LI
pisimavaanngalu	pi+SIMA<Indikativ<DeMig+LU
pisimavaa	pi+SIMA<Indikativ<HanHam
pisimavassili	pi+SIMA<Indikativ<JegJer+LI
pisimavassilu	pi+SIMA<Indikativ<JegJer+LU
pisimaviuk	pi+SIMA<Interrogativ<DuHam
pisimasarpaat	pi+SIMA=TAR<Indikativ<DeHam
pisimasarpaannga	pi+SIMA=TAR<Indikativ<DeMig
pisimasarpaa	pi+SIMA=TAR<Indikativ<HanHam
pisimasarpassi	pi+SIMA=TAR<Indikativ<JegJer
pisimasarpassili	pi+SIMA=TAR<Indikativ<JegJer+LI
pisimasarpiuk	pi+SIMA=TAR<Interrogativ<DuHam
pissagaluarpaalli	pi-SSA=GALUAR<Indikativ<DeHam+LI
pissagaluarpaallu	pi-SSA=GALUAR<Indikativ<DeHam+LU
pissagaluarpaanngalu	pi-SSA=GALUAR<Indikativ<DeMig+LU
pissagaluarpaa	pi-SSA=GALUAR<Indikativ<HanHam
pissagaluarpaali	pi-SSA=GALUAR<Indikativ<HanHam+LI
pissagaluarpassi	pi-SSA=GALUAR<Indikativ<JegJer
pissagaluarpiuk	pi-SSA=GALUAR<Interrogativ<DuHam
pissavaat	pi-SSA<Indikativ<DeHam
pissavaanngalu	pi-SSA<Indikativ<DeMig+LU
pissavaa	pi-SSA<Indikativ<HanHam
pissavaali	pi-SSA<Indikativ<HanHam+LI
pissavassi	pi-SSA<Indikativ<JegJer
pissaviuk	pi-SSA<Interrogativ<DuHam
pisaraluarpaat	pi+TAR=GALUAR<Indikativ<DeHam
pisaraluarpaa	pi+TAR=GALUAR<Indikativ<HanHam
pisaraluarpassi	pi+TAR=GALUAR<Indikativ<JegJer
pisaraluarpassili	pi+TAR=GALUAR<Indikativ<JegJer+LI
pisaraluarpiuk	pi+TAR=GALUAR<Interrogativ<DuHam
pisarpaat	pi+TAR<Indikativ<DeHam
pisarpaannga	pi+TAR<Indikativ<DeMig
pisarpaanngali	pi+TAR<Indikativ<DeMig+LI
pisarpaa	pi+TAR<Indikativ<HanHam
pisarpassi	pi+TAR<Indikativ<JegJer
pisarpiuk	pi+TAR<Interrogativ<DuHam
pisassagaluarpaat	pi+TAR=SSA=GALUAR<Indikativ<DeHam
pisassagaluarpaanngali	pi+TAR=SSA=GALUAR<Indikativ<DeMig+LI
pisassagaluarpaanngalu	pi+TAR=SSA=GALUAR<Indikativ<DeMig+LU
pisassagaluarpaalu	pi+TAR=SSA=GALUAR<Indikativ<HanHam+LU
pisassagaluarpassi	pi+TAR=SSA=GALUAR<Indikativ<JegJer
pisassagaluarpassili	pi+TAR=SSA=GALUAR<Indikativ<JegJer+LI
pisassagaluarpiuk	pi+TAR=SSA=GALUAR<Interrogativ<DuHam
pisassavaannga	pi+TAR=SSA<Indikativ<DeMig
pisassavaa	pi+TAR=SSA<Indikativ<HanHam
pisassavassi	pi+TAR=SSA<Indikativ<JegJer
pisassaviuk	pi+TAR=SSA<Interrogativ<DuHam
qallunaaq	qallunaaq<ental>Absolut
qallunaarli	qallunaaq<ental>Absolut+LI
qallunaarlu	qallunaaq<ental>Absolut+LU
qallunaamilli	qallunaaq<ental<Instrumentalis+LI
qallunaamut	qallunaaq<ental<Terminalis
qallunaanik	qallunaaq<flertal<Instrumentalis
qallunaanilli	qallunaaq<flertal<Instrumentalis+LI
qallunaanilu	qallunaaq<flertal<Lokalis+LU
qallunaanulli	qallunaaq<flertal<Terminalis+LI
qallunaanullu	qallunaaq<flertal<Terminalis+LU
qallunaannaallu	qallunaaq-INNAQ<flertal<Absolut+LU
qallunaannarnilu	qallunaaq-INNAQ<flertal<Lokalis+LU
qallunaannaqalaartarnerit	qallunaaq-INNAQ-QAR-LAAR=TAR+NIQ<flertal<Absolut
qallunaannaqassanerillu	qallunaaq-INNAQ-QAR-SSA+NIQ<flertal<Absolut+LU
qallunaalilli	qallunaaq-LIK<ental<Absolut+LI
qallunaalillu	qallunaaq-LIK<ental<Absolut+LU
qallunaalittut	qallunaaq-LIK<ental<Aequalis
qallunaalittulli	qallunaaq-LIK<ental<Aequalis+LI
qallunaallit	qallunaaq-LIK<flertal<Relativ
qallunaallilli	qallunaaq-LIK<flertal<Relativ+LI
qallunaalinnulli	qallunaaq-LIK<flertal<Terminalis+LI
qallunaalilerisunga	qallunaaq-LIK-LIRI<Participium<jeg
qallunaanngulaarneq	qallunaaq-NNGUR-LAAR+NIQ
qallunaanngulaartarporli	qallunaaq-NNGUR-LAAR=TAR<Indikativ<han+LI
qallunaanngulaartarneq	qallunaaq-NNGUR-LAAR=TAR+NIQ
qallunaanngussagaluarporlu	qallunaaq-NNGUR-SSA=GALUAR<Indikativ<han+LU
qallunaanngussavorlu	qallunaaq-NNGUR-SSA<Indikativ<han+LU
qallunaanngortaraluarnerlu	qallunaaq-NNGUR+TAR=GALUAR+NIQ+LU
qallunaanngortassagaluarporlu	qallunaaq-NNGUR+TAR=SSA=GALUAR<Indikativ<han+LU
qallunaarpassuit	qallunaaq+PASSUAQ<flertal<Absolut
qallunaarpassuillu	qallunaaq+PASSUAQ<flertal<Absolut+LU
qallunaarpassuarnik	qallunaaq+PASSUAQ<flertal<Instrumentalis
qallunaarpassuarnilli	qallunaaq+PASSUAQ<flertal<Instrumentalis+LI
qallunaarpassuarnillu	qallunaaq+PASSUAQ<flertal<Instrumentalis+LU
qallunaarpassuarni	qallunaaq+PASSUAQ<flertal<Lokalis
qallunaarpassuarnili	qallunaaq+PASSUAQ<flertal<Lokalis+LI
qallunaarpassuarnulli	qallunaaq+PASSUAQ<flertal<Terminalis+LI
qallunaarpassuarnullu	qallunaaq+PASSUAQ<flertal<Terminalis+LU
qallunaaqalaarneq	qallunaaq-QAR-LAAR+NIQ
qallunaaqalaartarnerli	qallunaaq-QAR-LAAR=TAR+NIQ+LI
qallunaaqarneq	qallunaaq-QAR+NIQ
qallunaaqassagaluarpoq	qallunaaq-QAR-SSA=GALUAR<Indikativ<han
qallunaaqassanerli	qallunaaq-QAR-SSA+NIQ+LI
qallunaaqartaraluarporlu	qallunaaq-QAR+TAR=GALUAR<Indikativ<han+LU
qallunaajugaluarnermut	qallunaaq-U+GALUAR+NIQ<ental<Terminalis
qallunaajuvunga	qallunaaq-U<Indikativ<jeg
qallunaajulaartarnernut	qallunaaq-U-LAAR=TAR+NIQ<flertal<Terminalis
qallunaajusimaneq	qallunaaq-U+SIMA+NIQ<ental<Absolut
qallunaajusimasarnerat	qallunaaq-U+SIMA=TAR+NIQ<ental<deres<Absolut
qallunaajusimasartunga	qallunaaq-U+SIMA=TAR<Participium<jeg
qallunaajusarneq	qallunaaq-U+TAR+NIQ<ental<Absolut
Qaqortoq	Qaqortoq<Absolut
Qaqortorli	Qaqortoq<Absolut+LI
Qaqortorlu	Qaqortoq<Absolut+LU
Qaqortumik	Qaqortoq<Instrumentalis
Qaqortumilli	Qaqortoq<Instrumentalis+LI
Qaqortumillu	Qaqortoq<Instrumentalis+LU
Qaqortumi	Qaqortoq<Lokalis
Qaqortumili	Qaqortoq<Lokalis+LI
Qaqortumilu	Qaqortoq<Lokalis+LU
Qaqortormiumili	Qaqortoq+MIU<ental<Lokalis+LI
Qaqortormiunilli	Qaqortoq+MIU<flertal<Instrumentalis+LI
Qaqortormiunili	Qaqortoq+MIU<flertal<Lokalis+LI
Qaqortormiunngussagaluarporlu	Qaqortoq+MIU-NNGUR-SSA=GALUAR<Indikativ<han+LU
Qaqortormiunngussasungali	Qaqortoq+MIU-NNGUR-SSA<Participium<jeg+LI
Qaqortormioqarporli	Qaqortoq+MIU-QAR<Indikativ<han+LI
Qaqortormioqarporlu	Qaqortoq+MIU-QAR<Indikativ<han+LU
Qaqortormioqarnerli	Qaqortoq+MIU-QAR+NIQ+LI
Qaqortormioqarnerlu	Qaqortoq+MIU-QAR+NIQ+LU
Qaqortormiuulaarnerit	Qaqortoq+MIU-U-LAAR+NIQ<flertal<Relativ
Qaqortormiuulaartarpit	Qaqortoq+MIU-U-LAAR=TAR<Interrogativ<du
Qaqortormiuunerat	Qaqortoq+MIU-U+NIQ<ental<deres<Absolut
Qaqortormiuunerit	Qaqortoq+MIU-U+NIQ<flertal<Absolut
Qaqortormiuusimasarpunga	Qaqortoq+MIU-U+SIMA=TAR<Indikativ<jeg
Qaqortormiuusassagaluarnerni	Qaqortoq+MIU-U+TAR=SSA=GALUAR+NIQ<flertal<Lokalis
Qaqortumut	Qaqortoq<Terminalis
Qaqortumulli	Qaqortoq<Terminalis+LI
Qaqortumullu	Qaqortoq<Terminalis+LU
qarasaasiaq	qarasaasiaq<ental>Absolut
qarasaasiarli	qarasaasiaq<ental>Absolut+LI
qarasaasiarlu	qarasaasiaq<ental>Absolut+LU
qarasaasiatut	qarasaasiaq<ental<Aequalis
qarasaasiamik	qarasaasiaq<ental<Instrumentalis
qarasaasiamili	qarasaasiaq<ental<Lokalis+LI
qarasaasiara	qarasaasiaq<ental<min>Absolut
qarasaasiaralu	qarasaasiaq<ental<min>Absolut+LU
qarasaasiamulli	qarasaasiaq<ental<Terminalis+LI
qarasaasianik	qarasaasiaq<flertal<Instrumentalis
qarasaasianilli	qarasaasiaq<flertal<Instrumentalis+LI
qarasaasianillu	qarasaasiaq<flertal<Instrumentalis+LU
qarasaasiani	qarasaasiaq<flertal<Lokalis
qarasaasianili	qarasaasiaq<flertal<Lokalis+LI
qarasaasiallit	qarasaasiaq-LIK<flertal<Absolut
qarasaasiallillu	qarasaasiaq-LIK<flertal<Relativ+LU
qarasaasialilerisassaneq	qarasaasiaq-LIK-LIRI+TAR=SSA+NIQ<ental<Absolut
qarasaasialinngulaarpungali	qarasaasiaq-LIK-NNGUR-LAAR<Indikativ<jeg+LI
qarasaasialerivorlu	qarasaasiaq-LIRI<Indikativ<han+LU
qarasaasialerisimanernut	qarasaasiaq-LIRI+SIMA+NIQ<flertal<Terminalis
qarasaasialerisimasarpugut	qarasaasiaq-LIRI+SIMA=TAR<Indikativ<vi
qarasaasialerisarporlu	qarasaasiaq-LIRI+TAR<Indikativ<han+LU
qarasaasialerisarpunga	qarasaasiaq-LIRI+TAR<Indikativ<jeg
qarasaasiarmiunilli	qarasaasiaq+MIU<flertal<Instrumentalis+LI
qarasaasiarmiunullu	qarasaasiaq+MIU<flertal<Terminalis+LU
qarasaasiarmiulerivit	qarasaasiaq+MIU-LIRI<Interrogativ<du
qarasaasiarmiunngortunga	qarasaasiaq+MIU-NNGUR<Participium<jeg
qarasaasiarmiunngortartunga	qarasaasiaq+MIU-NNGUR+TAR<Participium<jeg
qarasaasiarmioqarpoq	qarasaasiaq+MIU-QAR<Indikativ<han
qarasaasiarmioqarporlu	qarasaasiaq+MIU-QAR<Indikativ<han+LU
qarasaasiarmioqarneq	qarasaasiaq+MIU-QAR+NIQ
qarasaasiarmioqarnerli	qarasaasiaq+MIU-QAR+NIQ+LI
qarasaasiarmioqarnerlu	qarasaasiaq+MIU-QAR+NIQ+LU
qarasaasiarmiuuvoq	qarasaasiaq+MIU-U<Indikativ<han
qarasaasiarmiuuit	qarasaasiaq+MIU-U<Interrogativ<du
qarasaasiarmiuusunga	qarasaasiaq+MIU-U<Participium<jeg
qarasaasiarmiuusimanerni	qarasaasiaq+MIU-U+SIMA+NIQ<flertal<Lokalis
qarasaasiarmiuusimasunga	qarasaasiaq+MIU-U+SIMA<Participium<jeg
qarasaasiarmiuusimasartunga	qarasaasiaq+MIU-U+SIMA=TAR<Participium<jeg
qarasaasiarmiuussasunga	qarasaasiaq+MIU-U-SSA<Participium<jeg
qarasaasiarmiuusaraluarpoq	qarasaasiaq+MIU-U+TAR=GALUAR<Indikativ<han
qarasaasiarmiuusaraluartunga	qarasaasiaq+MIU-U+TAR=GALUAR<Participium<jeg
qarasaasiarmiuusarnerillu	qarasaasiaq+MIU-U+TAR+NIQ<flertal<Relativ+LU
qarasaasiarmiuusassagaluarpit	qarasaasiaq+MIU-U+TAR=SSA=GALUAR<Interrogativ<du
qarasaasiarmiuusassaneq	qarasaasiaq+MIU-U+TAR=SSA+NIQ<ental<Absolut
qarasaasianngoraluartungali	qarasaasiaq-NNGUR+GALUAR<Participium<jeg+LI
qarasaasianngulaarneq	qarasaasiaq-NNGUR-LAAR+NIQ<ental<Absolut
qarasaasianngussagaluarpunga	qarasaasiaq-NNGUR-SSA=GALUAR<Indikativ<jeg
qarasaasianngussagaluarpit	qarasaasiaq-NNGUR-SSA=GALUAR<Interrogativ<du
qarasaasianngussagaluartunga	qarasaasiaq-NNGUR-SSA=GALUAR<Participium<jeg
qarasaasianngussavit	qarasaasiaq-NNGUR-SSA<Interrogativ<du
qarasaasianngussasunga	qarasaasiaq-NNGUR-SSA<Participium<jeg
qarasaasianngortaraluartunga	qarasaasiaq-NNGUR+TAR=GALUAR<Participium<jeg
qarasaasianngortassagaluarpit	qarasaasiaq-NNGUR+TAR=SSA=GALUAR<Interrogativ<du
qarasaasiarpassuit	qarasaasiaq+PASSUAQ<flertal<Absolut
qarasaasiarpassuilli	qarasaasiaq+PASSUAQ<flertal<Absolut+LI
qarasaasiarpassuillu	qarasaasiaq+PASSUAQ<flertal<Absolut+LU
qarasaasiarpassuartulli	qarasaasiaq+PASSUAQ<flertal<Aequalis+LI
qarasaasiarpassuarni	qarasaasiaq+PASSUAQ<flertal<Lokalis
qarasaasiarpassuarnut	qarasaasiaq+PASSUAQ<flertal<Terminalis
qarasaasiarpassuarnullu	qarasaasiaq+PASSUAQ<flertal<Terminalis+LU
qarasaasiaqalaartunga	qarasaasiaq-QAR-LAAR<Participium<jeg
qarasaasiaqalaartartungali	qarasaasiaq-QAR-LAAR=TAR<Participium<jeg+LI
qarasaasiaqarsimasartunga	qarasaasiaq-QAR+SIMA=TAR<Participium<jeg
qarasaasiaqassagaluarneq	qarasaasiaq-QAR-SSA=GALUAR+NIQ<ental<Absolut
qarasaasiaqassasungali	qarasaasiaq-QAR-SSA<Participium<jeg+LI
qarasaasiaqartassagaluarnertullu	qarasaasiaq-QAR+TAR=SSA=GALUAR+NIQ<ental<Aequalis+LU
qarasaasiaavunga	qarasaasiaq-U<Indikativ<jeg
qarasaasiaasungalu	qarasaasiaq-U<Participium<jeg+LU
qarasaasiaasimasartunga	qarasaasiaq-U+SIMA=TAR<Participium<jeg
Qasigiannguit	Qasigiannguit<Absolut
Qasigiannguilli	Qasigiannguit<Absolut+LI
Qasigiannguillu	Qasigiannguit<Absolut+LU
Qasigiannguanik	Qasigiannguit<Instrumentalis
Qasigiannguanilli	Qasigiannguit<Instrumentalis+LI
Qasigiannguanillu	Qasigiannguit<Instrumentalis+LU
Qasigiannguani	Qasigiannguit<Lokalis
Qasigiannguanili	Qasigiannguit<Lokalis+LI
Qasigiannguanilu	Qasigiannguit<Lokalis+LU
Qasigiannguarmiunilli	Qasigiannguit+MIU<flertal<Instrumentalis+LI
Qasigiannguarmiuni	Qasigiannguit+MIU<flertal<Lokalis
Qasigiannguarmiunut	Qasigiannguit+MIU<flertal<Terminalis
Qasigiannguarmiulerivugut	Qasigiannguit+MIU-LIRI<Indikativ<vi
Qasigiannguarmiunngussagaluarpit	Qasigiannguit+MIU-NNGUR-SSA=GALUAR<Interrogativ<du
Qasigiannguarmiunngussagaluarnerillu	Qasigiannguit+MIU-NNGUR-SSA=GALUAR+NIQ<flertal<Relativ+LU
Qasigiannguarmioqarporli	Qasigiannguit+MIU-QAR<Indikativ<han+LI
Qasigiannguarmioqarporlu	Qasigiannguit+MIU-QAR<Indikativ<han+LU
Qasigiannguarmioqarnerli	Qasigiannguit+MIU-QAR+NIQ+LI
Qasigiannguarmioqarnerlu	Qasigiannguit+MIU-QAR+NIQ+LU
Qasigiannguarmiuussavit	Qasigiannguit+MIU-U-SSA<Interrogativ<du
Qasigiannguarmiuusarpit	Qasigiannguit+MIU-U+TAR<Interrogativ<du
Qasigiannguarmiuusarnerlu	Qasigiannguit+MIU-U+TAR+NIQ<ental<Absolut+LU
Qeqertarsuaq	Qeqertarsuaq<Absolut
Qeqertarsuarli	Qeqertarsuaq<Absolut+LI
Qeqertarsuarlu	Qeqertarsuaq<Absolut+LU
Qeqertarsuarmik	Qeqertarsuaq<Instrumentalis
Qeqertarsuarmilli	Qeqertarsuaq<Instrumentalis+LI
Qeqertarsuarmillu	Qeqertarsuaq<Instrumentalis+LU
Qeqertarsuarmi	Qeqertarsuaq<Lokalis
Qeqertarsuarmili	Qeqertarsuaq<Lokalis+LI
Qeqertarsuarmilu	Qeqertarsuaq<Lokalis+LU
Qeqertarsuarmiuli	Qeqertarsuaq+MIU<ental<Absolut+LI
Qeqertarsuarmiumilli	Qeqertarsuaq+MIU<ental<Instrumentalis+LI
Qeqertarsuarmiumilu	Qeqertarsuaq+MIU<ental<Lokalis+LU
Qeqertarsuarmiumut	Qeqertarsuaq+MIU<ental<Terminalis
Qeqertarsuarmiunillu	Qeqertarsuaq+MIU<flertal<Instrumentalis+LU
Qeqertarsuarmiunili	Qeqertarsuaq+MIU<flertal<Lokalis+LI
Qeqertarsuarmiunut	Qeqertarsuaq+MIU<flertal<Terminalis
Qeqertarsuarmiulerilaartungali	Qeqertarsuaq+MIU-LIRI-LAAR<Participium<jeg+LI
Qeqertarsuarmiulerinertut	Qeqertarsuaq+MIU-LIRI+NIQ<ental<Aequalis
Qeqertarsuarmiulerisimasarpit	Qeqertarsuaq+MIU-LIRI+SIMA=TAR<Interrogativ<du
Qeqertarsuarmiulerissanerillu	Qeqertarsuaq+MIU-LIRI-SSA+NIQ<flertal<Relativ+LU
Qeqertarsuarmiunngulaarpungali	Qeqertarsuaq+MIU-NNGUR-LAAR<Indikativ<jeg+LI
Qeqertarsuarmiunngortunga	Qeqertarsuaq+MIU-NNGUR<Participium<jeg
Qeqertarsuarmiunngussagaluartungali	Qeqertarsuaq+MIU-NNGUR-SSA=GALUAR<Participium<jeg+LI
Qeqertarsuarmiunngortaraluarneralli	Qeqertarsuaq+MIU-NNGUR+TAR=GALUAR+NIQ<ental<deres<Absolut+LI
Qeqertarsuarmioqarpoq	Qeqertarsuaq+MIU-QAR<Indikativ<han
Qeqertarsuarmioqarporli	Qeqertarsuaq+MIU-QAR<Indikativ<han+LI
Qeqertarsuarmioqarporlu	Qeqertarsuaq+MIU-QAR<Indikativ<han+LU
Qeqertarsuarmioqarneq	Qeqertarsuaq+MIU-QAR+NIQ
Qeqertarsuarmioqarnerli	Qeqertarsuaq+MIU-QAR+NIQ+LI
Qeqertarsuarmioqarnerlu	Qeqertarsuaq+MIU-QAR+NIQ+LU
Qeqertarsuarmiuugaluarpit	Qeqertarsuaq+MIU-U+GALUAR<Interrogativ<du
Qeqertarsuarmiuugaluarnerilli	Qeqertarsuaq+MIU-U+GALUAR+NIQ<flertal<Relativ+LI
Qeqertarsuarmiuulaarporlu	Qeqertarsuaq+MIU-U-LAAR<Indikativ<han+LU
Qeqertarsuarmiuulaarnerit	Qeqertarsuaq+MIU-U-LAAR+NIQ<flertal<Relativ
Qeqertarsuarmiuulaartunga	Qeqertarsuaq+MIU-U-LAAR<Participium<jeg
Qeqertarsuarmiuunerlu	Qeqertarsuaq+MIU-U+NIQ<ental<Absolut+LU
Qeqertarsuarmiuusungali	Qeqertarsuaq+MIU-U<Participium<jeg+LI
Qeqertarsuarmiuusungalu	Qeqertarsuaq+MIU-U<Participium<jeg+LU
Qeqertarsuarmiuussagaluarpit	Qeqertarsuaq+MIU-U-SSA=GALUAR<Interrogativ<du
Qeqertarsuarmiuussagaluartunga	Qeqertarsuaq+MIU-U-SSA=GALUAR<Participium<jeg
Qeqertarsuarmiuussagaluartungali	Qeqertarsuaq+MIU-U-SSA=GALUAR<Participium<jeg+LI
Qeqertarsuarmiuussasunga	Qeqertarsuaq+MIU-U-SSA<Participium<jeg
Qeqertarsuarmiuusaraluarporli	Qeqertarsuaq+MIU-U+TAR=GALUAR<Indikativ<han+LI
Qeqertarsuarmiuusaraluarnerni	Qeqertarsuaq+MIU-U+TAR=GALUAR+NIQ<flertal<Lokalis
Qeqertarsuarmiuusarnerit	Qeqertarsuaq+MIU-U+TAR+NIQ<flertal<Relativ
Qeqertarsuarmiuusassasunga	Qeqertarsuaq+MIU-U+TAR=SSA<Participium<jeg
Qeqertarsuarmut	Qeqertarsuaq<Terminalis
Qeqertarsuarmulli	Qeqertarsuaq<Terminalis+LI
Qeqertarsuarmullu	Qeqertarsuaq<Terminalis+LU
sammisarigaluarpaat	sammisari+GALUAR<Indikativ<DeHam
sammisarigaluarpaa	sammisari+GALUAR<Indikativ<HanHam
sammisarigaluarpaali	sammisari+GALUAR<Indikativ<HanHam+LI
sammisarigaluarpassi	sammisari+GALUAR<Indikativ<JegJer
sammisarigaluarpiuk	sammisari+GALUAR<Interrogativ<DuHam
sammisarivaannga	sammisari<Indikativ<DeMig
sammisarivaanngali	sammisari<Indikativ<DeMig+LI
sammisarivaa	sammisari<Indikativ<HanHam
sammisarivaali	sammisari<Indikativ<HanHam+LI
sammisarivassi	sammisari<Indikativ<JegJer
sammisariviuk	sammisari<Interrogativ<DuHam
sammisarilaarpaat	sammisari-LAAR<Indikativ<DeHam
sammisarilaarpaalli	sammisari-LAAR<Indikativ<DeHam+LI
sammisarilaarpaanngali	sammisari-LAAR<Indikativ<DeMig+LI
sammisarilaarpaa	sammisari-LAAR<Indikativ<HanHam
sammisarilaarpassi	sammisari-LAAR<Indikativ<JegJer
sammisarilaarpassilu	sammisari-LAAR<Indikativ<JegJer+LU
sammisarilaarpiuk	sammisari-LAAR<Interrogativ<DuHam
sammisarilaartarpaalli	sammisari-LAAR=TAR<Indikativ<DeHam+LI
sammisarilaartarpaannga	sammisari-LAAR=TAR<Indikativ<DeMig
sammisarilaartarpaa	sammisari-LAAR=TAR<Indikativ<HanHam
sammisarilaartarpassi	sammisari-LAAR=TAR<Indikativ<JegJer
sammisarilaartarpassili	sammisari-LAAR=TAR<Indikativ<JegJer+LI
sammisarilaartarpiuk	sammisari-LAAR=TAR<Interrogativ<DuHam
sammisarisimavaat	sammisari+SIMA<Indikativ<DeHam
sammisarisimavaanngali	sammisari+SIMA<Indikativ<DeMig+LI
sammisarisimaviuk	sammisari+SIMA<Interrogativ<DuHam
sammisarisimasarpaat	sammisari+SIMA=TAR<Indikativ<DeHam
sammisarisimasarpaalli	sammisari+SIMA=TAR<Indikativ<DeHam+LI
sammisarisimasarpaannga	sammisari+SIMA=TAR<Indikativ<DeMig
sammisarisimasarpaa	sammisari+SIMA=TAR<Indikativ<HanHam
sammisarisimasarpiuk	sammisari+SIMA=TAR<Interrogativ<DuHam
sammisarissagaluarpaat	sammisari-SSA=GALUAR<Indikativ<DeHam
sammisarissagaluarpaalli	sammisari-SSA=GALUAR<Indikativ<DeHam+LI
sammisarissagaluarpiuk	sammisari-SSA=GALUAR<Interrogativ<DuHam
sammisarissavaat	sammisari-SSA<Indikativ<DeHam
sammisarissavaalli	sammisari-SSA<Indikativ<DeHam+LI
sammisarissavaannga	sammisari-SSA<Indikativ<DeMig
sammisarissavaanngali	sammisari-SSA<Indikativ<DeMig+LI
sammisarissavassi	sammisari-SSA<Indikativ<JegJer
sammisarissaviuk	sammisari-SSA<Interrogativ<DuHam
sammisarisaraluarpassi	sammisari+TAR=GALUAR<Indikativ<JegJer
sammisarisaraluarpiuk	sammisari+TAR=GALUAR<Interrogativ<DuHam
sammisarisarpaallu	sammisari+TAR<Indikativ<DeHam+LU
sammisarisarpaanngali	sammisari+TAR<Indikativ<DeMig+LI
sammisarisarpaa	sammisari+TAR<Indikativ<HanHam
sammisarisarpiuk	sammisari+TAR<Interrogativ<DuHam
sammisarisassagaluarpaannga	sammisari+TAR=SSA=GALUAR<Indikativ<DeMig
sammisarisassagaluarpaanngali	sammisari+TAR=SSA=GALUAR<Indikativ<DeMig+LI
sammisarisassagaluarpaa	sammisari+TAR=SSA=GALUAR<Indikativ<HanHam
sammisarisassagaluarpaali	sammisari+TAR=SSA=GALUAR<Indikativ<HanHam+LI
sammisarisassagaluarpiuk	sammisari+TAR=SSA=GALUAR<Interrogativ<DuHam
sammisarisassavaallu	sammisari+TAR=SSA<Indikativ<DeHam+LU
sammisarisassavaa	sammisari+TAR=SSA<Indikativ<HanHam
sammisarisassavassili	sammisari+TAR=SSA<Indikativ<JegJer+LI
Sisimiut	Sisimiut<Absolut
Sisimiulli	Sisimiut<Absolut+LI
Sisimiullu	Sisimiut<Absolut+LU
Sisimiunik	Sisimiut<Instrumentalis
Sisimiunilli	Sisimiut<Instrumentalis+LI
Sisimiunillu	Sisimiut<Instrumentalis+LU
Sisimiuni	Sisimiut<Lokalis
Sisimiunili	Sisimiut<Lokalis+LI
Sisimiunilu	Sisimiut<Lokalis+LU
Sisimiormiuli	Sisimiut+MIU<ental<Absolut+LI
Sisimiormiumillu	Sisimiut+MIU<ental<Instrumentalis+LU
Sisimiormiumi	Sisimiut+MIU<ental<Lokalis
Sisimiormiuni	Sisimiut+MIU<flertal<Lokalis
Sisimiormiunili	Sisimiut+MIU<flertal<Lokalis+LI
Sisimiormiunilu	Sisimiut+MIU<flertal<Lokalis+LU
Sisimiormiunullu	Sisimiut+MIU<flertal<Terminalis+LU
Sisimiormiulerisunga	Sisimiut+MIU-LIRI<Participium<jeg
Sisimiormiulerissagaluarpugulli	Sisimiut+MIU-LIRI-SSA=GALUAR<Indikativ<vi+LI
Sisimiormiulerissanerni	Sisimiut+MIU-LIRI-SSA+NIQ<flertal<Lokalis
Sisimiormiulerisassasungali	Sisimiut+MIU-LIRI+TAR=SSA<Participium<jeg+LI
Sisimiormiunngorpungalu	Sisimiut+MIU-NNGUR<Indikativ<jeg+LU
Sisimiormiunngulaarpit	Sisimiut+MIU-NNGUR-LAAR<Interrogativ<du
Sisimiormiunngulaarnernut	Sisimiut+MIU-NNGUR-LAAR+NIQ<flertal<Terminalis
Sisimiormiunngulaartarnerallu	Sisimiut+MIU-NNGUR-LAAR=TAR+NIQ<ental<deres<Absolut+LU
Sisimiormiunngornerlu	Sisimiut+MIU-NNGUR+NIQ<ental<Absolut+LU
Sisimiormiunngussagaluarpungali	Sisimiut+MIU-NNGUR-SSA=GALUAR<Indikativ<jeg+LI
Sisimiormioqarpoq	Sisimiut+MIU-QAR<Indikativ<han
Sisimiormioqarporli	Sisimiut+MIU-QAR<Indikativ<han+LI
Sisimiormioqarneq	Sisimiut+MIU-QAR+NIQ
Sisimiormioqarnerli	Sisimiut+MIU-QAR+NIQ+LI
Sisimiormiuugaluarneq	Sisimiut+MIU-U+GALUAR+NIQ<ental<Absolut
Sisimiormiuugaluarnerallu	Sisimiut+MIU-U+GALUAR+NIQ<ental<deres<Absolut+LU
Sisimiormiuugaluartunga	Sisimiut+MIU-U+GALUAR<Participium<jeg
Sisimiormiuuvorli	Sisimiut+MIU-U<Indikativ<han+LI
Sisimiormiuuvunga	Sisimiut+MIU-U<Indikativ<jeg
Sisimiormiuuit	Sisimiut+MIU-U<Interrogativ<du
Sisimiormiuulaartungali	Sisimiut+MIU-U-LAAR<Participium<jeg+LI
Sisimiormiuulaartartungali	Sisimiut+MIU-U-LAAR=TAR<Participium<jeg+LI
Sisimiormiuunerat	Sisimiut+MIU-U+NIQ<ental<deres<Absolut
Sisimiormiuusunga	Sisimiut+MIU-U<Participium<jeg
Sisimiormiuusimavunga	Sisimiut+MIU-U+SIMA<Indikativ<jeg
Sisimiormiuusimavungali	Sisimiut+MIU-U+SIMA<Indikativ<jeg+LI
Sisimiormiuusimasungali	Sisimiut+MIU-U+SIMA<Participium<jeg+LI
Sisimiormiuusimasartunga	Sisimiut+MIU-U+SIMA=TAR<Participium<jeg
Sisimiormiuusaraluartunga	Sisimiut+MIU-U+TAR=GALUAR<Participium<jeg
Sisimiormiuusarpungali	Sisimiut+MIU-U+TAR<Indikativ<jeg+LI
Sisimiormiuusarnerillu	Sisimiut+MIU-U+TAR+NIQ<flertal<Absolut+LU
Sisimiormiuusartungali	Sisimiut+MIU-U+TAR<Participium<jeg+LI
Sisimiormiuusassagaluarnernullu	Sisimiut+MIU-U+TAR=SSA=GALUAR+NIQ<flertal<Terminalis+LU
Sisimiormiuusassavoq	Sisimiut+MIU-U+TAR=SSA<Indikativ<han
Sisimiormiuusassanerli	Sisimiut+MIU-U+TAR=SSA+NIQ<ental<Absolut+LI
suligaluarporlu	suli+GALUAR<Indikativ<han+LU
suligaluarpunga	suli+GALUAR<Indikativ<jeg
suligaluarnertut	suli+GALUAR+NIQ<ental<Aequalis
suligaluartunga	suli+GALUAR<Participium<jeg
suligaluartungalu	suli+GALUAR<Participium<jeg+LU
sulivoq	suli<Indikativ<han
sulivorlu	suli<Indikativ<han+LU
sulivungali	suli<Indikativ<jeg+LI
sulivungalu	suli<Indikativ<jeg+LU
sulivugut	suli<Indikativ<vi
sulivit	suli<Interrogativ<du
sulilaarpunga	suli-LAAR<Indikativ<jeg
sulilaarneq	suli-LAAR+NIQ<ental<Absolut
sulilaarnerni	suli-LAAR+NIQ<flertal<Lokalis
sulilaarnerit	suli-LAAR+NIQ<flertal<Relativ
sulilaartunga	suli-LAAR<Participium<jeg
sulilaartungali	suli-LAAR<Participium<jeg+LI
sulilaartarpoq	suli-LAAR=TAR<Indikativ<han
sulilaartarpugut	suli-LAAR=TAR<Indikativ<vi
sulilaartarpit	suli-LAAR=TAR<Interrogativ<du
sulilaartarnerit	suli-LAAR=TAR+NIQ<flertal<Absolut
sulilaartarnerilli	suli-LAAR=TAR+NIQ<flertal<Relativ+LI
sulilaartartunga	suli-LAAR=TAR<Participium<jeg
sulilaartartungali	suli-LAAR=TAR<Participium<jeg+LI
sulilaartartungalu	suli-LAAR=TAR<Participium<jeg+LU
sulineq	suli+NIQ<ental<Absolut
sulinerat	suli+NIQ<ental<deres<Absolut
sulinerit	suli+NIQ<flertal<Absolut
sulinerilli	suli+NIQ<flertal<Absolut+LI
sulinernillu	suli+NIQ<flertal<Instrumentalis+LU
sulinernili	suli+NIQ<flertal<Lokalis+LI
sulinerillu	suli+NIQ<flertal<Relativ+LU
sulisunga	suli<Participium<jeg
sulisungali	suli<Participium<jeg+LI
sulisungalu	suli<Participium<jeg+LU
SULI	SULI<Partikel
SULIli	SULI<Partikel+LI
SULIlu	SULI<Partikel+LU
sulisimavorli	suli+SIMA<Indikativ<han+LI
sulisimavungali	suli+SIMA<Indikativ<jeg+LI
sulisimavugullu	suli+SIMA<Indikativ<vi+LU
sulisimavit	suli+SIMA<Interrogativ<du
sulisimasunga	suli+SIMA<Participium<jeg
sulisimasarnerat	suli+SIMA=TAR+NIQ<ental<deres<Absolut
sulisimasartunga	suli+SIMA=TAR<Participium<jeg
sulisimasartungali	suli+SIMA=TAR<Participium<jeg+LI
sulissagaluarpoq	suli-SSA=GALUAR<Indikativ<han
sulissagaluarporlu	suli-SSA=GALUAR<Indikativ<han+LU
sulissagaluarpunga	suli-SSA=GALUAR<Indikativ<jeg
sulissagaluarpugullu	suli-SSA=GALUAR<Indikativ<vi+LU
sulissagaluartunga	suli-SSA=GALUAR<Participium<jeg
sulissagaluartungali	suli-SSA=GALUAR<Participium<jeg+LI
sulissavoq	suli-SSA<Indikativ<han
sulissavunga	suli-SSA<Indikativ<jeg
sulissaneralli	suli-SSA+NIQ<ental<deres<Absolut+LI
sulissanerilli	suli-SSA+NIQ<flertal<Absolut+LI
sulissasunga	suli-SSA<Participium<jeg
sulissasungali	suli-SSA<Participium<jeg+LI
sulissasungalu	suli-SSA<Participium<jeg+LU
sulisaraluarnerilli	suli+TAR=GALUAR+NIQ<flertal<Relativ+LI
sulisaraluartunga	suli+TAR=GALUAR<Participium<jeg
sulisaraluartungali	suli+TAR=GALUAR<Participium<jeg+LI
sulisarporlu	suli+TAR<Indikativ<han+LU
sulisarpunga	suli+TAR<Indikativ<jeg
sulisarnerilli	suli+TAR+NIQ<flertal<Relativ+LI
sulisartunga	suli+TAR<Participium<jeg
sulisassagaluarpit	suli+TAR=SSA=GALUAR<Interrogativ<du
sulisassagaluarnertut	suli+TAR=SSA=GALUAR+NIQ<ental<Aequalis
sulisassagaluarnermullu	suli+TAR=SSA=GALUAR+NIQ<ental<Terminalis+LU
sulisassagaluarnernik	suli+TAR=SSA=GALUAR+NIQ<flertal<Instrumentalis
sulisassagaluarnernili	suli+TAR=SSA=GALUAR+NIQ<flertal<Lokalis+LI
sulisassagaluartunga	suli+TAR=SSA=GALUAR<Participium<jeg
sulisassavoq	suli+TAR=SSA<Indikativ<han
sulisassavorli	suli+TAR=SSA<Indikativ<han+LI
sulisassavunga	suli+TAR=SSA<Indikativ<jeg
sulisassanernullu	suli+TAR=SSA+NIQ<flertal<Terminalis+LU
sulisassasunga	suli+TAR=SSA<Participium<jeg
taagaluarpaannga	taa+GALUAR<Indikativ<DeMig
taagaluarpaanngalu	taa+GALUAR<Indikativ<DeMig+LU
taagaluarpassi	taa+GALUAR<Indikativ<JegJer
taavaa	taa<Indikativ<HanHam
taavassilu	taa<Indikativ<JegJer+LU
taaviuk	taa<Interrogativ<DuHam
taalaarpiuk	taa-LAAR<Interrogativ<DuHam
taanna	taanna<Pronomen
taassagaluarpiuk	taa-SSA=GALUAR<Interrogativ<DuHam
taassaviuk	taa-SSA<Interrogativ<DuHam
taasarpaannga	taa+TAR<Indikativ<DeMig
taasarpassi	taa+TAR<Indikativ<JegJer
taasarpiuk	taa+TAR<Interrogativ<DuHam
taasassavassi	taa+TAR=SSA<Indikativ<JegJer
tallimallu	tallimat<Absolut+LU
tallimatut	tallimat<Aequalis
tallimatullu	tallimat<Aequalis+LU
tallimaat	tallimat<ental<deres
tallimaalli	tallimat<ental<deres+LI
tallimaannaat	tallimat-INNAQ<flertal<Absolut
tallimaannartut	tallimat-INNAQ<flertal<Aequalis
tallimaannartulli	tallimat-INNAQ<flertal<Aequalis+LI
tallimaannarnulli	tallimat-INNAQ<flertal<Terminalis+LI
tallimaannalerisunga	tallimat-INNAQ-LIRI<Participium<jeg
tallimaannalerisaraluarpunga	tallimat-INNAQ-LIRI+TAR=GALUAR<Indikativ<jeg
tallimaannanngulaartartungali	tallimat-INNAQ-NNGUR-LAAR=TAR<Participium<jeg+LI
tallimaannanngussasunga	tallimat-INNAQ-NNGUR-SSA<Participium<jeg
tallimanik	tallimat<Instrumentalis
tallimanilli	tallimat<Instrumentalis+LI
tallimaliit	tallimat-LIK<flertal<Relativ
tallimalinnulli	tallimat-LIK<flertal<Terminalis+LI
tallimaleqalaartarpungalu	tallimat-LIK-QAR-LAAR=TAR<Indikativ<jeg+LU
tallimaleqalaartartunga	tallimat-LIK-QAR-LAAR=TAR<Participium<jeg
tallimaleqartungali	tallimat-LIK-QAR<Participium<jeg+LI
tallimaleqartarnertullu	tallimat-LIK-QAR+TAR+NIQ<ental<Aequalis+LU
tallimaliusunga	tallimat-LIK-U<Participium<jeg
tallimani	tallimat<Lokalis
tallimanili	tallimat<Lokalis+LI
tallimanngulaartunga	tallimat-NNGUR-LAAR<Participium<jeg
tallimanngussagaluarnertullu	tallimat-NNGUR-SSA=GALUAR+NIQ<ental<Aequalis+LU
tallimanngussavit	tallimat-NNGUR-SSA<Interrogativ<du
tallimanut	tallimat<Terminalis<flertal
tallimanulli	tallimat<Terminalis<flertal+LI
tamarmik	tamarmik<Adjektiv
tamarmilli	tamarmik<Adjektiv+LI
tamarmillu	tamarmik<Adjektiv+LU
Tasiilaq	Tasiilaq<Absolut
Tasiilarli	Tasiilaq<Absolut+LI
Tasiilarlu	Tasiilaq<Absolut+LU
Tasiilamik	Tasiilaq<Instrumentalis
Tasiilamilli	Tasiilaq<Instrumentalis+LI
Tasiilamillu	Tasiilaq<Instrumentalis+LU
Tasiilami	Tasiilaq<Lokalis
Tasiilamili	Tasiilaq<Lokalis+LI
Tasiilamilu	Tasiilaq<Lokalis+LU
Tasiilarmiu	Tasiilaq+MIU<ental<Absolut
Tasiilarmiumik	Tasiilaq+MIU<ental<Instrumentalis
Tasiilarmiumili	Tasiilaq+MIU<ental<Lokalis+LI
Tasiilarmiunik	Tasiilaq+MIU<flertal<Instrumentalis
Tasiilarmiuni	Tasiilaq+MIU<flertal<Lokalis
Tasiilarmiunili	Tasiilaq+MIU<flertal<Lokalis+LI
Tasiilarmiulerivorli	Tasiilaq+MIU-LIRI<Indikativ<han+LI
Tasiilarmiulerivit	Tasiilaq+MIU-LIRI<Interrogativ<du
Tasiilarmiulerinerit	Tasiilaq+MIU-LIRI+NIQ<flertal<Relativ
Tasiilarmiulerisarpungali	Tasiilaq+MIU-LIRI+TAR<Indikativ<jeg+LI
Tasiilarmiulerisassavit	Tasiilaq+MIU-LIRI+TAR=SSA<Interrogativ<du
Tasiilarmiunngoraluarpit	Tasiilaq+MIU-NNGUR+GALUAR<Interrogativ<du
Tasiilarmiunngulaartarnernulli	Tasiilaq+MIU-NNGUR-LAAR=TAR+NIQ<flertal<Terminalis+LI
Tasiilarmiunngortungalu	Tasiilaq+MIU-NNGUR<Participium<jeg+LU
Tasiilarmiunngussanernulli	Tasiilaq+MIU-NNGUR-SSA+NIQ<flertal<Terminalis+LI
Tasiilarmioqarpoq	Tasiilaq+MIU-QAR<Indikativ<han
Tasiilarmioqarporli	Tasiilaq+MIU-QAR<Indikativ<han+LI
Tasiilarmioqarporlu	Tasiilaq+MIU-QAR<Indikativ<han+LU
Tasiilarmioqarneq	Tasiilaq+MIU-QAR+NIQ
Tasiilarmioqarnerli	Tasiilaq+MIU-QAR+NIQ+LI
Tasiilarmioqarnerlu	Tasiilaq+MIU-QAR+NIQ+LU
Tasiilarmiuugaluarpit	Tasiilaq+MIU-U+GALUAR<Interrogativ<du
Tasiilarmiuuvunga	Tasiilaq+MIU-U<Indikativ<jeg
Tasiilarmiuuvungali	Tasiilaq+MIU-U<Indikativ<jeg+LI
Tasiilarmiuuvugut	Tasiilaq+MIU-U<Indikativ<vi
Tasiilarmiuuit	Tasiilaq+MIU-U<Interrogativ<du
Tasiilarmiuulaarneq	Tasiilaq+MIU-U-LAAR+NIQ<ental<Absolut
Tasiilarmiuulaartungali	Tasiilaq+MIU-U-LAAR<Participium<jeg+LI
Tasiilarmiuulaartarpunga	Tasiilaq+MIU-U-LAAR=TAR<Indikativ<jeg
Tasiilarmiuulaartartungali	Tasiilaq+MIU-U-LAAR=TAR<Participium<jeg+LI
Tasiilarmiuunerli	Tasiilaq+MIU-U+NIQ<ental<Absolut+LI
Tasiilarmiuusunga	Tasiilaq+MIU-U<Participium<jeg
Tasiilarmiuusungali	Tasiilaq+MIU-U<Participium<jeg+LI
Tasiilarmiuusimanerli	Tasiilaq+MIU-U+SIMA+NIQ<ental<Absolut+LI
Tasiilarmiuusimanerilli	Tasiilaq+MIU-U+SIMA+NIQ<flertal<Absolut+LI
Tasiilarmiuusimasarnerit	Tasiilaq+MIU-U+SIMA=TAR+NIQ<flertal<Relativ
Tasiilarmiuussagaluarpit	Tasiilaq+MIU-U-SSA=GALUAR<Interrogativ<du
Tasiilarmiuussagaluarnerilli	Tasiilaq+MIU-U-SSA=GALUAR+NIQ<flertal<Absolut+LI
Tasiilarmiuussagaluarnerillu	Tasiilaq+MIU-U-SSA=GALUAR+NIQ<flertal<Absolut+LU
Tasiilarmiuussagaluartunga	Tasiilaq+MIU-U-SSA=GALUAR<Participium<jeg
Tasiilarmiuussavugulli	Tasiilaq+MIU-U-SSA<Indikativ<vi+LI
Tasiilarmiuussaneq	Tasiilaq+MIU-U-SSA+NIQ<ental<Absolut
Tasiilarmiuusaraluarpit	Tasiilaq+MIU-U+TAR=GALUAR<Interrogativ<du
Tasiilarmiuusassagaluarpugut	Tasiilaq+MIU-U+TAR=SSA=GALUAR<Indikativ<vi
Tasiilarmiuusassavunga	Tasiilaq+MIU-U+TAR=SSA<Indikativ<jeg
Tasiilarmiuusassavungali	Tasiilaq+MIU-U+TAR=SSA<Indikativ<jeg+LI
Tasiilarmiuusassavit	Tasiilaq+MIU-U+TAR=SSA<Interrogativ<du
Tasiilarmiuusassanertullu	Tasiilaq+MIU-U+TAR=SSA+NIQ<ental<Aequalis+LU
Tasiilarmiuusassasungali	Tasiilaq+MIU-U+TAR=SSA<Participium<jeg+LI
Tasiilamut	Tasiilaq<Terminalis
Tasiilamulli	Tasiilaq<Terminalis+LI
Tasiilamullu	Tasiilaq<Terminalis+LU
tassa	tassa<Partikel
tassali	tassa<Partikel+LI
tassalu	tassa<Partikel+LU
tutsiuteqqikkaluarporli	tutsiuteqqip+GALUAR<Indikativ<han+LI
tutsiuteqqikkaluarpunga	tutsiuteqqip+GALUAR<Indikativ<jeg
tutsiuteqqikkaluarpugut	tutsiuteqqip+GALUAR<Indikativ<vi
tutsiuteqqikkaluarpugullu	tutsiuteqqip+GALUAR<Indikativ<vi+LU
tutsiuteqqikkaluarpit	tutsiuteqqip+GALUAR<Interrogativ<du
tutsiuteqqikkaluarneq	tutsiuteqqip+GALUAR+NIQ<ental<Absolut
tutsiuteqqikkaluarnerit	tutsiuteqqip+GALUAR+NIQ<flertal<Absolut
tutsiuteqqikkaluarnernik	tutsiuteqqip+GALUAR+NIQ<flertal<Instrumentalis
tutsiuteqqikkaluarnerni	tutsiuteqqip+GALUAR+NIQ<flertal<Lokalis
tutsiuteqqikkaluartunga	tutsiuteqqip+GALUAR<Participium<jeg
tutsiuteqqikkaluartungali	tutsiuteqqip+GALUAR<Participium<jeg+LI
tutsiuteqqikkaluartungalu	tutsiuteqqip+GALUAR<Participium<jeg+LU
tutsiuteqqippoq	tutsiuteqqip<Indikativ<han
tutsiuteqqippunga	tutsiuteqqip<Indikativ<jeg
tutsiuteqqippungali	tutsiuteqqip<Indikativ<jeg+LI
tutsiuteqqippugut	tutsiuteqqip<Indikativ<vi
tutsiuteqqippugullu	tutsiuteqqip<Indikativ<vi+LU
tutsiuteqqippit	tutsiuteqqip<Interrogativ<du
tutsiuteqqilaarpit	tutsiuteqqip-LAAR<Interrogativ<du
tutsiuteqqilaarnerallu	tutsiuteqqip-LAAR+NIQ<ental<deres<Absolut+LU
tutsiuteqqilaarnerit	tutsiuteqqip-LAAR+NIQ<flertal<Relativ
tutsiuteqqilaartungalu	tutsiuteqqip-LAAR<Participium<jeg+LU
tutsiuteqqilaartarpugulli	tutsiuteqqip-LAAR=TAR<Indikativ<vi+LI
tutsiuteqqilaartarnerat	tutsiuteqqip-LAAR=TAR+NIQ<ental<deres<Absolut
tutsiuteqqilaartarnernili	tutsiuteqqip-LAAR=TAR+NIQ<flertal<Lokalis+LI
tutsiuteqqilaartartunga	tutsiuteqqip-LAAR=TAR<Participium<jeg
tutsiuteqqinneq	tutsiuteqqip+NIQ<ental<Absolut
tutsiuteqqinnerat	tutsiuteqqip+NIQ<ental<deres<Absolut
tutsiuteqqinnerallu	tutsiuteqqip+NIQ<ental<deres<Absolut+LU
tutsiuteqqinnermulli	tutsiuteqqip+NIQ<ental<Terminalis+LI
tutsiuteqqinnerilli	tutsiuteqqip+NIQ<flertal<Absolut+LI
tutsiuteqqinnernik	tutsiuteqqip+NIQ<flertal<Instrumentalis
tutsiuteqqinnernilli	tutsiuteqqip+NIQ<flertal<Instrumentalis+LI
tutsiuteqqinnernili	tutsiuteqqip+NIQ<flertal<Lokalis+LI
tutsiuteqqinnerilli	tutsiuteqqip+NIQ<flertal<Relativ+LI
tutsiuteqqittunga	tutsiuteqqip<Participium<jeg
tutsiuteqqittungali	tutsiuteqqip<Participium<jeg+LI
tutsiuteqqittungalu	tutsiuteqqip<Participium<jeg+LU
tutsiuteqqissimanerit	tutsiuteqqip+SIMA+NIQ<flertal<Relativ
tutsiuteqqissimasunga	tutsiuteqqip+SIMA<Participium<jeg
tutsiuteqqissimasungalu	tutsiuteqqip+SIMA<Participium<jeg+LU
tutsiuteqqissimasarporli	tutsiuteqqip+SIMA=TAR<Indikativ<han+LI
tutsiuteqqissimasarporlu	tutsiuteqqip+SIMA=TAR<Indikativ<han+LU
tutsiuteqqissimasarpugut	tutsiuteqqip+SIMA=TAR<Indikativ<vi
tutsiuteqqissimasarpugullu	tutsiuteqqip+SIMA=TAR<Indikativ<vi+LU
tutsiuteqqissimasarpit	tutsiuteqqip+SIMA=TAR<Interrogativ<du
tutsiuteqqissimasarnermut	tutsiuteqqip+SIMA=TAR+NIQ<ental<Terminalis
tutsiuteqqissimasarnerni	tutsiuteqqip+SIMA=TAR+NIQ<flertal<Lokalis
tutsiuteqqissimasartunga	tutsiuteqqip+SIMA=TAR<Participium<jeg
tutsiuteqqissimasartungali	tutsiuteqqip+SIMA=TAR<Participium<jeg+LI
tutsiuteqqissagaluarnerni	tutsiuteqqip-SSA=GALUAR+NIQ<flertal<Lokalis
tutsiuteqqissagaluarnerilli	tutsiuteqqip-SSA=GALUAR+NIQ<flertal<Relativ+LI
tutsiuteqqissagaluartunga	tutsiuteqqip-SSA=GALUAR<Participium<jeg
tutsiuteqqissagaluartungali	tutsiuteqqip-SSA=GALUAR<Participium<jeg+LI
tutsiuteqqissavorlu	tutsiuteqqip-SSA<Indikativ<han+LU
tutsiuteqqissavunga	tutsiuteqqip-SSA<Indikativ<jeg
tutsiuteqqissavit	tutsiuteqqip-SSA<Interrogativ<du
tutsiuteqqissanerit	tutsiuteqqip-SSA+NIQ<flertal<Absolut
tutsiuteqqissanernut	tutsiuteqqip-SSA+NIQ<flertal<Terminalis
tutsiuteqqissasunga	tutsiuteqqip-SSA<Participium<jeg
tutsiuteqqissasungali	tutsiuteqqip-SSA<Participium<jeg+LI
tutsiuteqqittaraluarpunga	tutsiuteqqip+TAR=GALUAR<Indikativ<jeg
tutsiuteqqittaraluarneq	tutsiuteqqip+TAR=GALUAR+NIQ<ental<Absolut
tutsiuteqqittaraluarnerit	tutsiuteqqip+TAR=GALUAR+NIQ<flertal<Absolut
tutsiuteqqittaraluartunga	tutsiuteqqip+TAR=GALUAR<Participium<jeg
tutsiuteqqittarneq	tutsiuteqqip+TAR+NIQ<ental<Absolut
tutsiuteqqittartungali	tutsiuteqqip+TAR<Participium<jeg+LI
tutsiuteqqittartungalu	tutsiuteqqip+TAR<Participium<jeg+LU
tutsiuteqqittassagaluarpugut	tutsiuteqqip+TAR=SSA=GALUAR<Indikativ<vi
tutsiuteqqittassagaluartunga	tutsiuteqqip+TAR=SSA=GALUAR<Participium<jeg
tutsiuteqqittassavugut	tutsiuteqqip+TAR=SSA<Indikativ<vi
tutsiuteqqittassavit	tutsiuteqqip+TAR=SSA<Interrogativ<du
tutsiuteqqittassanerlu	tutsiuteqqip+TAR=SSA+NIQ<ental<Absolut+LU
tutsiuteqqittassanerillu	tutsiuteqqip+TAR=SSA+NIQ<flertal<Relativ+LU
tutsiuteqqittassasungali	tutsiuteqqip+TAR=SSA<Participium<jeg+LI
uanga	uanga<Pronomen
uangali	uanga<Pronomen+LI
uangalu	uanga<Pronomen+LU
ukioq	ukioq<ental>Absolut
ukiorli	ukioq<ental>Absolut+LI
ukiorlu	ukioq<ental>Absolut+LU
ukiuat	ukioq<ental<deres>Absolut
ukiumik	ukioq<ental<Instrumentalis
ukiumilli	ukioq<ental<Instrumentalis+LI
ukiumili	ukioq<ental<Lokalis+LI
ukiumilu	ukioq<ental<Lokalis+LU
ukiunilli	ukioq<flertal<Instrumentalis+LI
ukiunillu	ukioq<flertal<Instrumentalis+LU
ukiuni	ukioq<flertal<Lokalis
ukiunut	ukioq<flertal<Terminalis
ukiuinnaallu	ukioq-INNAQ<flertal<Absolut+LU
ukiuinnarnullu	ukioq-INNAQ<flertal<Terminalis+LU
ukiuinnanngorsimavit	ukioq-INNAQ-NNGUR+SIMA<Interrogativ<du
ukiuinnaasarneq	ukioq-INNAQ-U+TAR+NIQ<ental<Absolut
ukiuinnaasassagaluartungali	ukioq-INNAQ-U+TAR=SSA=GALUAR<Participium<jeg+LI
ukiulimmut	ukioq-LIK<ental<Terminalis
ukiullit	ukioq-LIK<flertal<Absolut
ukiullillu	ukioq-LIK<flertal<Relativ+LU
ukiulinngulaartarpit	ukioq-LIK-NNGUR-LAAR=TAR<Interrogativ<du
ukiunngorpoq	ukioq-NNGUR<Indikativ<han
ukiunngulaartarporlu	ukioq-NNGUR-LAAR=TAR<Indikativ<han+LU
ukiunngulaartarnerli	ukioq-NNGUR-LAAR=TAR+NIQ+LI
ukiunngulaartarnerlu	ukioq-NNGUR-LAAR=TAR+NIQ+LU
ukiunngorsimasarpoq	ukioq-NNGUR+SIMA=TAR<Indikativ<han
ukiunngussanerli	ukioq-NNGUR-SSA+NIQ+LI
ukiunngortassagaluarnerli	ukioq-NNGUR+TAR=SSA=GALUAR+NIQ+LI
ukiorpassuit	ukioq+PASSUAQ<flertal<Absolut
ukiorpassuilli	ukioq+PASSUAQ<flertal<Absolut+LI
ukiorpassuartut	ukioq+PASSUAQ<flertal<Aequalis
ukiorpassuartulli	ukioq+PASSUAQ<flertal<Aequalis+LI
ukiorpassuartullu	ukioq+PASSUAQ<flertal<Aequalis+LU
ukiorpassuarni	ukioq+PASSUAQ<flertal<Lokalis
ukiorpassuarnili	ukioq+PASSUAQ<flertal<Lokalis+LI
ukiorpassuarnulli	ukioq+PASSUAQ<flertal<Terminalis+LI
ukiorpassuarnullu	ukioq+PASSUAQ<flertal<Terminalis+LU
ukioqarpoq	ukioq-QAR<Indikativ<han
ukioqalaarpoq	ukioq-QAR-LAAR<Indikativ<han
ukioqalaarnerli	ukioq-QAR-LAAR+NIQ+LI
ukioqalaarnerlu	ukioq-QAR-LAAR+NIQ+LU
ukioqalaartarpoq	ukioq-QAR-LAAR=TAR<Indikativ<han
ukioqalaartarnerli	ukioq-QAR-LAAR=TAR+NIQ+LI
ukioqarnerli	ukioq-QAR+NIQ+LI
ukioqarsimaneq	ukioq-QAR+SIMA+NIQ
ukioqassagaluarporli	ukioq-QAR-SSA=GALUAR<Indikativ<han+LI
ukioqassagaluarporlu	ukioq-QAR-SSA=GALUAR<Indikativ<han+LU
ukioqassavoq	ukioq-QAR-SSA<Indikativ<han
ukioqassavorlu	ukioq-QAR-SSA<Indikativ<han+LU
ukiuugaluarpungalu	ukioq-U+GALUAR<Indikativ<jeg+LU
ukiuugaluartungali	ukioq-U+GALUAR<Participium<jeg+LI
ukiuugaluartungalu	ukioq-U+GALUAR<Participium<jeg+LU
ukiuusunga	ukioq-U<Participium<jeg
ukiuusungali	ukioq-U<Participium<jeg+LI
ukiuusimanerli	ukioq-U+SIMA+NIQ<ental<Absolut+LI
ukiuusimasunga	ukioq-U+SIMA<Participium<jeg
ukiuussagaluarpit	ukioq-U-SSA=GALUAR<Interrogativ<du
ukiuusaraluarpoq	ukioq-U+TAR=GALUAR<Indikativ<han
ukiuusarpit	ukioq-U+TAR<Interrogativ<du
ukiuusartungalu	ukioq-U+TAR<Participium<jeg+LU
ulloq	ulloq<ental>Absolut
ullorlu	ulloq<ental>Absolut+LU
ullutut	ulloq<ental<Aequalis
ullumilli	ulloq<ental<Instrumentalis+LI
ullumi	ulloq<ental<Lokalis
ullumilu	ulloq<ental<Lokalis+LU
ullumulli	ulloq<ental<Terminalis+LI
ullumullu	ulloq<ental<Terminalis+LU
ullunik	ulloq<flertal<Instrumentalis
ullunilli	ulloq<flertal<Instrumentalis+LI
ulluni	ulloq<flertal<Lokalis
ulluinnaq	ulloq-INNAQ<ental>Absolut
ulluinnaallu	ulloq-INNAQ<ental<deres>Absolut+LU
ulluinnaqalaartartunga	ulloq-INNAQ-QAR-LAAR=TAR<Participium<jeg
ullulik	ulloq-LIK<ental<Absolut
ullulerisunga	ulloq-LIRI<Participium<jeg
ullulerisimasartungali	ulloq-LIRI+SIMA=TAR<Participium<jeg+LI
ullulerissaneq	ulloq-LIRI-SSA+NIQ<ental<Absolut
ullormiunili	ulloq+MIU<flertal<Lokalis+LI
ullormiunullu	ulloq+MIU<flertal<Terminalis+LU
ullormiulerisassagaluarpunga	ulloq+MIU-LIRI+TAR=SSA=GALUAR<Indikativ<jeg
ullormioqarneq	ulloq+MIU-QAR+NIQ
ullormiuuit	ulloq+MIU-U<Interrogativ<du
ullormiuusassanernullu	ulloq+MIU-U+TAR=SSA+NIQ<flertal<Terminalis+LU
ullunngulaarnerlu	ulloq-NNGUR-LAAR+NIQ<ental<Absolut+LU
ullunngulaarnermut	ulloq-NNGUR-LAAR+NIQ<ental<Terminalis
ullunngulaartartunga	ulloq-NNGUR-LAAR=TAR<Participium<jeg
ullunngortunga	ulloq-NNGUR<Participium<jeg
ullunngorsimasungali	ulloq-NNGUR+SIMA<Participium<jeg+LI
ullunngorsimasarpit	ulloq-NNGUR+SIMA=TAR<Interrogativ<du
ullunngussaneq	ulloq-NNGUR-SSA+NIQ<ental<Absolut
ullunngussasunga	ulloq-NNGUR-SSA<Participium<jeg
ullorpassuarnilu	ulloq+PASSUAQ<flertal<Lokalis+LU
ulloqalaarpugut	ulloq-QAR-LAAR<Indikativ<vi
ulloqalaarnerat	ulloq-QAR-LAAR+NIQ<ental<deres<Absolut
ulloqalaartarpunga	ulloq-QAR-LAAR=TAR<Indikativ<jeg
ulloqalaartarpit	ulloq-QAR-LAAR=TAR<Interrogativ<du
ulloqalaartarnerni	ulloq-QAR-LAAR=TAR+NIQ<flertal<Lokalis
ulloqalaartartungali	ulloq-QAR-LAAR=TAR<Participium<jeg+LI
ulloqarnernik	ulloq-QAR+NIQ<flertal<Instrumentalis
ulloqassaneralli	ulloq-QAR-SSA+NIQ<ental<deres<Absolut+LI
ulloqassasunga	ulloq-QAR-SSA<Participium<jeg
ulloqassasungalu	ulloq-QAR-SSA<Participium<jeg+LU
ulluugaluartungalu	ulloq-U+GALUAR<Participium<jeg+LU
ulluuvoq	ulloq-U<Indikativ<han
ulluusimavit	ulloq-U+SIMA<Interrogativ<du
ulluusimanerat	ulloq-U+SIMA+NIQ<ental<deres<Absolut
ulluussasunga	ulloq-U-SSA<Participium<jeg
ullumi	ullumi<Partikel
ullumili	ullumi<Partikel+LI
ullumilu	ullumi<Partikel+LU
Upernavik	Upernavik<Absolut
Upernavilli	Upernavik<Absolut+LI
Upernavillu	Upernavik<Absolut+LU
Upernavimmik	Upernavik<Instrumentalis
Upernavimmillu	Upernavik<Instrumentalis+LU
Upernavimmi	Upernavik<Lokalis
Upernavimmili	Upernavik<Lokalis+LI
Upernavimmilu	Upernavik<Lokalis+LU
Upernavimmiumik	Upernavik+MIU<ental<Instrumentalis
Upernavimmiumilli	Upernavik+MIU<ental<Instrumentalis+LI
Upernavimmiumilu	Upernavik+MIU<ental<Lokalis+LU
Upernavimmiumulli	Upernavik+MIU<ental<Terminalis+LI
Upernavimmiunilli	Upernavik+MIU<flertal<Instrumentalis+LI
Upernavimmiuni	Upernavik+MIU<flertal<Lokalis
Upernavimmiunulli	Upernavik+MIU<flertal<Terminalis+LI
Upernavimmiulerilaarporlu	Upernavik+MIU-LIRI-LAAR<Indikativ<han+LU
Upernavimmiulerinertulli	Upernavik+MIU-LIRI+NIQ<ental<Aequalis+LI
Upernavimmiulerisimasarpit	Upernavik+MIU-LIRI+SIMA=TAR<Interrogativ<du
Upernavimmiunngulaartarnerit	Upernavik+MIU-NNGUR-LAAR=TAR+NIQ<flertal<Absolut
Upernavimmioqarpoq	Upernavik+MIU-QAR<Indikativ<han
Upernavimmioqarporli	Upernavik+MIU-QAR<Indikativ<han+LI
Upernavimmioqarporlu	Upernavik+MIU-QAR<Indikativ<han+LU
Upernavimmioqarneq	Upernavik+MIU-QAR+NIQ
Upernavimmioqarnerli	Upernavik+MIU-QAR+NIQ+LI
Upernavimmiuugaluarpit	Upernavik+MIU-U+GALUAR<Interrogativ<du
Upernavimmiuugaluarnernilli	Upernavik+MIU-U+GALUAR+NIQ<flertal<Instrumentalis+LI
Upernavimmiuulaarneq	Upernavik+MIU-U-LAAR+NIQ<ental<Absolut
Upernavimmiuusungalu	Upernavik+MIU-U<Participium<jeg+LU
Upernavimmiuussagaluartunga	Upernavik+MIU-U-SSA=GALUAR<Participium<jeg
Upernavimmiuusartungali	Upernavik+MIU-U+TAR<Participium<jeg+LI
Upernavimmiuusassagaluarnerit	Upernavik+MIU-U+TAR=SSA=GALUAR+NIQ<flertal<Absolut
Upernavimmiuusassagaluartunga	Upernavik+MIU-U+TAR=SSA=GALUAR<Participium<jeg
Upernavimmullu	Upernavik<Terminalis+LU
Uummannaq	Uummannaq<Absolut
Uummannarli	Uummannaq<Absolut+LI
Uummannarlu	Uummannaq<Absolut+LU
Uummannamik	Uummannaq<Instrumentalis
Uummannamilli	Uummannaq<Instrumentalis+LI
Uummannamillu	Uummannaq<Instrumentalis+LU
Uummannami	Uummannaq<Lokalis
Uummannamili	Uummannaq<Lokalis+LI
Uummannamilu	Uummannaq<Lokalis+LU
Uummannarmiu	Uummannaq+MIU<ental<Absolut
Uummannarmiuli	Uummannaq+MIU<ental<Absolut+LI
Uummannarmiumillu	Uummannaq+MIU<ental<Instrumentalis+LU
Uummannarmiunilli	Uummannaq+MIU<flertal<Instrumentalis+LI
Uummannarmiuni	Uummannaq+MIU<flertal<Lokalis
Uummannarmiunili	Uummannaq+MIU<flertal<Lokalis+LI
Uummannarmiunngoraluarnerat	Uummannaq+MIU-NNGUR+GALUAR+NIQ<ental<deres<Absolut
Uummannarmiunngortungali	Uummannaq+MIU-NNGUR<Participium<jeg+LI
Uummannarmiunngussagaluarnerilli	Uummannaq+MIU-NNGUR-SSA=GALUAR+NIQ<flertal<Absolut+LI
Uummannarmiunngortarpit	Uummannaq+MIU-NNGUR+TAR<Interrogativ<du
Uummannarmiunngortassagaluarnertullu	Uummannaq+MIU-NNGUR+TAR=SSA=GALUAR+NIQ<ental<Aequalis+LU
Uummannarmiunngortassagaluarnerit	Uummannaq+MIU-NNGUR+TAR=SSA=GALUAR+NIQ<flertal<Absolut
Uummannarmioqarpoq	Uummannaq+MIU-QAR<Indikativ<han
Uummannarmioqarporlu	Uummannaq+MIU-QAR<Indikativ<han+LU
Uummannarmioqarneq	Uummannaq+MIU-QAR+NIQ
Uummannarmioqarnerli	Uummannaq+MIU-QAR+NIQ+LI
Uummannarmiuuvugulli	Uummannaq+MIU-U<Indikativ<vi+LI
Uummannarmiuulaarnermullu	Uummannaq+MIU-U-LAAR+NIQ<ental<Terminalis+LU
Uummannarmiuulaartungali	Uummannaq+MIU-U-LAAR<Participium<jeg+LI
Uummannarmiuuneq	Uummannaq+MIU-U+NIQ<ental<Absolut
Uummannarmiuusimasartungali	Uummannaq+MIU-U+SIMA=TAR<Participium<jeg+LI
Uummannarmiuussagaluarpugut	Uummannaq+MIU-U-SSA=GALUAR<Indikativ<vi
Uummannarmiuussavorli	Uummannaq+MIU-U-SSA<Indikativ<han+LI
Uummannarmiuusarpugullu	Uummannaq+MIU-U+TAR<Indikativ<vi+LU
Uummannarmiuusarnerni	Uummannaq+MIU-U+TAR+NIQ<flertal<Lokalis
Uummannarmiuusassagaluarporli	Uummannaq+MIU-U+TAR=SSA=GALUAR<Indikativ<han+LI
Uummannarmiuusassasunga	Uummannaq+MIU-U+TAR=SSA<Participium<jeg
Uummannamut	Uummannaq<Terminalis
Uummannamulli	Uummannaq<Terminalis+LI
Uummannamullu	Uummannaq<Terminalis+LU
