aleqa	aleqa<ental<Absolut
aleqaa	aleqa<ental<hans<Absolut
aleqami	aleqa<ental<Lokalis
aleqamiillutik	aleqa<ental<Lokalis+IP<Ledsagemåde<de_selv
aleqamiinniarpoq	aleqa<ental<Lokalis+IP+NIAR<Indikativ<han
aleqamiinngitsoq	aleqa<ental<Lokalis+IP-NNGIT<Participium<han
aleqamiissinnaasoq	aleqa<ental<Lokalis+IP+SINNAA<Participium<han
aleqaa	aleqa<flertal<hans<Absolut
aleqani	aleqa<flertal<Lokalis
aleqaniipput	aleqa<flertal<Lokalis+IP<Indikativ<de
aleqaniippoq	aleqa<flertal<Lokalis+IP<Indikativ<han
aleqaniillutik	aleqa<flertal<Lokalis+IP<Ledsagemåde<de_selv
aleqaniinniarpoq	aleqa<flertal<Lokalis+IP+NIAR<Indikativ<han
aleqaniinniarnatik	aleqa<flertal<Lokalis+IP+NIAR=NNGIT<Ledsagemåde<de_selv
aleqaniinniartut	aleqa<flertal<Lokalis+IP+NIAR<Participium<de
aleqaniinngilaq	aleqa<flertal<Lokalis+IP-NNGIT<Indikativ<han
aleqaniinngitsut	aleqa<flertal<Lokalis+IP-NNGIT<Participium<de
aleqaniissinnaallutik	aleqa<flertal<Lokalis+IP+SINNAA<Ledsagemåde<de_selv
aleqaniissinnaasoq	aleqa<flertal<Lokalis+IP+SINNAA<Participium<han
aleqagitigit	aleqa+GӘ<Imperativ<ViDem
aleqagivaa	aleqa+GӘ<Indikativ<HanHam
aleqagivakka	aleqa+GӘ<Indikativ<JegDem
aleqagivagut	aleqa+GӘ<Indikativ<ViDem
aleqaginngilakka	aleqa+GӘ-NNGIT<Indikativ<JegDem
aleqaginngilagut	aleqa+GӘ-NNGIT<Indikativ<ViDem
angaju	angaju<ental<Absolut
angajua	angaju<ental<hans<Absolut
angajui	angaju<flertal<hans<Absolut
angajuni	angaju<flertal<Lokalis
angajuniinniarnatik	angaju<flertal<Lokalis+IP+NIAR=NNGIT<Ledsagemåde<de_selv
angajuniinniartoq	angaju<flertal<Lokalis+IP+NIAR<Participium<han
angajugitigit	angaju+GӘ<Imperativ<ViDem
angajugivaa	angaju+GӘ<Indikativ<HanHam
angajugivakka	angaju+GӘ<Indikativ<JegDem
angajugivagut	angaju+GӘ<Indikativ<ViDem
angajuginngilakka	angaju+GӘ-NNGIT<Indikativ<JegDem
angajuginngilagut	angaju+GӘ-NNGIT<Indikativ<ViDem
angut	angut<ental<Absolut
angummi	angut<ental<Lokalis
angummiipput	angut<ental<Lokalis+IP<Indikativ<de
angummiippoq	angut<ental<Lokalis+IP<Indikativ<han
angummiillutik	angut<ental<Lokalis+IP<Ledsagemåde<de_selv
angummiinniarlutik	angut<ental<Lokalis+IP+NIAR<Ledsagemåde<de_selv
angummiinniarnatik	angut<ental<Lokalis+IP+NIAR=NNGIT<Ledsagemåde<de_selv
angummiinnianngitsut	angut<ental<Lokalis+IP+NIAR=NNGIT<Participium<de
angummiittut	angut<ental<Lokalis+IP<Participium<de
angummiittoq	angut<ental<Lokalis+IP<Participium<han
angutini	angut<flertal<Lokalis
angutiniippoq	angut<flertal<Lokalis+IP<Indikativ<han
angutiniinngitsut	angut<flertal<Lokalis+IP-NNGIT<Participium<de
angutigitigit	angut+GӘ<Imperativ<ViDem
angutigivagut	angut+GӘ<Indikativ<ViDem
angutiginngilagut	angut+GӘ-NNGIT<Indikativ<ViDem
ani	ani<ental<Absolut
ania	ani<ental<hans<Absolut
animi	ani<ental<Lokalis
animiillutik	ani<ental<Lokalis+IP<Ledsagemåde<de_selv
animiinniarpoq	ani<ental<Lokalis+IP+NIAR<Indikativ<han
animiinnianngitsoq	ani<ental<Lokalis+IP+NIAR=NNGIT<Participium<han
animiinngilaq	ani<ental<Lokalis+IP-NNGIT<Indikativ<han
anii	ani<flertal<hans<Absolut
anini	ani<flertal<Lokalis
aniniillutik	ani<flertal<Lokalis+IP<Ledsagemåde<de_selv
aniniinniarlutik	ani<flertal<Lokalis+IP+NIAR<Ledsagemåde<de_selv
aniniinnianngilaq	ani<flertal<Lokalis+IP+NIAR=NNGIT<Indikativ<han
aniniinngillat	ani<flertal<Lokalis+IP-NNGIT<Indikativ<de
aniniittoq	ani<flertal<Lokalis+IP<Participium<han
aniniissinnaallutik	ani<flertal<Lokalis+IP+SINNAA<Ledsagemåde<de_selv
anigitigit	ani+GӘ<Imperativ<ViDem
anigivaa	ani+GӘ<Indikativ<HanHam
anigivakka	ani+GӘ<Indikativ<JegDem
anigivagut	ani+GӘ<Indikativ<ViDem
aniginngilakka	ani+GӘ-NNGIT<Indikativ<JegDem
aniginngilagut	ani+GӘ-NNGIT<Indikativ<ViDem
aqqalu	aqqalu<ental<Absolut
aqqalua	aqqalu<ental<hans<Absolut
aqqalumi	aqqalu<ental<Lokalis
aqqalumiipput	aqqalu<ental<Lokalis+IP<Indikativ<de
aqqalumiinnianngilaq	aqqalu<ental<Lokalis+IP+NIAR=NNGIT<Indikativ<han
aqqalumiissinnaallutik	aqqalu<ental<Lokalis+IP+SINNAA<Ledsagemåde<de_selv
aqqalui	aqqalu<flertal<hans<Absolut
aqqaluni	aqqalu<flertal<Lokalis
aqqaluniillutik	aqqalu<flertal<Lokalis+IP<Ledsagemåde<de_selv
aqqaluniinniarput	aqqalu<flertal<Lokalis+IP+NIAR<Indikativ<de
aqqaluniinniarlutik	aqqalu<flertal<Lokalis+IP+NIAR<Ledsagemåde<de_selv
aqqaluniinnianngitsut	aqqalu<flertal<Lokalis+IP+NIAR=NNGIT<Participium<de
aqqaluniinnianngitsoq	aqqalu<flertal<Lokalis+IP+NIAR=NNGIT<Participium<han
aqqaluniinngitsoq	aqqalu<flertal<Lokalis+IP-NNGIT<Participium<han
aqqaluniittut	aqqalu<flertal<Lokalis+IP<Participium<de
aqqaluniittoq	aqqalu<flertal<Lokalis+IP<Participium<han
aqqaluniissinnaallutik	aqqalu<flertal<Lokalis+IP+SINNAA<Ledsagemåde<de_selv
aqqaluniissinnaasut	aqqalu<flertal<Lokalis+IP+SINNAA<Participium<de
aqqaluniissinnaasoq	aqqalu<flertal<Lokalis+IP+SINNAA<Participium<han
aqqalugitigit	aqqalu+GӘ<Imperativ<ViDem
aqqalugivaa	aqqalu+GӘ<Indikativ<HanHam
aqqalugivakka	aqqalu+GӘ<Indikativ<JegDem
aqqalugivagut	aqqalu+GӘ<Indikativ<ViDem
aqqaluginngilakka	aqqalu+GӘ-NNGIT<Indikativ<JegDem
aqqaluginngilagut	aqqalu+GӘ-NNGIT<Indikativ<ViDem
assersuut	assersuut<ental<Absolut
assersuutaa	assersuut<ental<hans<Absolut
assersuummi	assersuut<ental<Lokalis
assersuummiipput	assersuut<ental<Lokalis+IP<Indikativ<de
assersuummiippoq	assersuut<ental<Lokalis+IP<Indikativ<han
assersuummiillutik	assersuut<ental<Lokalis+IP<Ledsagemåde<de_selv
assersuummiinniarpoq	assersuut<ental<Lokalis+IP+NIAR<Indikativ<han
assersuummiinniarlutik	assersuut<ental<Lokalis+IP+NIAR<Ledsagemåde<de_selv
assersuummiinnianngitsut	assersuut<ental<Lokalis+IP+NIAR=NNGIT<Participium<de
assersuummiinnianngitsoq	assersuut<ental<Lokalis+IP+NIAR=NNGIT<Participium<han
assersuummiinniartut	assersuut<ental<Lokalis+IP+NIAR<Participium<de
assersuummiinngillat	assersuut<ental<Lokalis+IP-NNGIT<Indikativ<de
assersuummiinnatik	assersuut<ental<Lokalis+IP-NNGIT<Ledsagemåde<de_selv
assersuummiinngitsoq	assersuut<ental<Lokalis+IP-NNGIT<Participium<han
assersuummiissinnaavoq	assersuut<ental<Lokalis+IP+SINNAA<Indikativ<han
assersuummiissinnaallutik	assersuut<ental<Lokalis+IP+SINNAA<Ledsagemåde<de_selv
assersuummiissinnaasoq	assersuut<ental<Lokalis+IP+SINNAA<Participium<han
assersuutai	assersuut<flertal<hans<Absolut
assersuutini	assersuut<flertal<Lokalis
assersuutiniillutik	assersuut<flertal<Lokalis+IP<Ledsagemåde<de_selv
assersuutiniinniarpoq	assersuut<flertal<Lokalis+IP+NIAR<Indikativ<han
assersuutiniinniarnatik	assersuut<flertal<Lokalis+IP+NIAR=NNGIT<Ledsagemåde<de_selv
assersuutiniinngillat	assersuut<flertal<Lokalis+IP-NNGIT<Indikativ<de
assersuutiniinnatik	assersuut<flertal<Lokalis+IP-NNGIT<Ledsagemåde<de_selv
assersuutiniinngitsoq	assersuut<flertal<Lokalis+IP-NNGIT<Participium<han
assersuutiniittut	assersuut<flertal<Lokalis+IP<Participium<de
assersuutiniittoq	assersuut<flertal<Lokalis+IP<Participium<han
assersuutigitigit	assersuut+GӘ<Imperativ<ViDem
assersuutigivakka	assersuut+GӘ<Indikativ<JegDem
assersuutigivagut	assersuut+GӘ<Indikativ<ViDem
assersuutiginngilakka	assersuut+GӘ-NNGIT<Indikativ<JegDem
assersuutiginngilagut	assersuut+GӘ-NNGIT<Indikativ<ViDem
ataaseq	ataaseq<Talord<Absolut
atorpoq	ator<Indikativ<han
atorniarput	ator+NIAR<Indikativ<de
atorniarpoq	ator+NIAR<Indikativ<han
atorniarlutik	ator+NIAR<Ledsagemåde<de_selv
atornianngillat	ator+NIAR=NNGIT<Indikativ<de
atornianngilaq	ator+NIAR=NNGIT<Indikativ<han
atorniarnatik	ator+NIAR=NNGIT<Ledsagemåde<de_selv
atornianngitsut	ator+NIAR=NNGIT<Participium<de
atornianngitsoq	ator+NIAR=NNGIT<Participium<han
atorniartoq	ator+NIAR<Participium<han
atunngillat	ator-NNGIT<Indikativ<de
atunngilaq	ator-NNGIT<Indikativ<han
atornatik	ator-NNGIT<Ledsagemåde<de_selv
atunngitsut	ator-NNGIT<Participium<de
atunngitsoq	ator-NNGIT<Participium<han
atortut	ator<Participium<de
atorsinnaavoq	ator+SINNAA<Indikativ<han
atorsinnaallutik	ator+SINNAA<Ledsagemåde<de_selv
atorsinnaasut	ator+SINNAA<Participium<de
atorsinnaasoq	ator+SINNAA<Participium<han
ilaqutariit	ilaqutariit<flertal<Absolut
ilaqutariivi	ilaqutariit<flertal<hans<Absolut
ilaqutariinni	ilaqutariit<flertal<Lokalis
ilaqutariinniipput	ilaqutariit<flertal<Lokalis+IP<Indikativ<de
ilaqutariinniippoq	ilaqutariit<flertal<Lokalis+IP<Indikativ<han
ilaqutariinniillutik	ilaqutariit<flertal<Lokalis+IP<Ledsagemåde<de_selv
ilaqutariinniinniarput	ilaqutariit<flertal<Lokalis+IP+NIAR<Indikativ<de
ilaqutariinniinniarlutik	ilaqutariit<flertal<Lokalis+IP+NIAR<Ledsagemåde<de_selv
ilaqutariinniinnianngillat	ilaqutariit<flertal<Lokalis+IP+NIAR=NNGIT<Indikativ<de
ilaqutariinniinniarnatik	ilaqutariit<flertal<Lokalis+IP+NIAR=NNGIT<Ledsagemåde<de_selv
ilaqutariinniinngilaq	ilaqutariit<flertal<Lokalis+IP-NNGIT<Indikativ<han
ilaqutariinniinnatik	ilaqutariit<flertal<Lokalis+IP-NNGIT<Ledsagemåde<de_selv
ilaqutariinniinngitsut	ilaqutariit<flertal<Lokalis+IP-NNGIT<Participium<de
ilaqutariinniinngitsoq	ilaqutariit<flertal<Lokalis+IP-NNGIT<Participium<han
ilaqutariinniittut	ilaqutariit<flertal<Lokalis+IP<Participium<de
ilaqutariinniittoq	ilaqutariit<flertal<Lokalis+IP<Participium<han
ilaqutariinniissinnaapput	ilaqutariit<flertal<Lokalis+IP+SINNAA<Indikativ<de
ilaqutariinniissinnaavoq	ilaqutariit<flertal<Lokalis+IP+SINNAA<Indikativ<han
ilaqutariinniissinnaasut	ilaqutariit<flertal<Lokalis+IP+SINNAA<Participium<de
ilaqutariinniissinnaasoq	ilaqutariit<flertal<Lokalis+IP+SINNAA<Participium<han
imaapput	imaap<Indikativ<de
imaappoq	imaap<Indikativ<han
imaallutik	imaap<Ledsagemåde<de_selv
imaanniarput	imaap+NIAR<Indikativ<de
imaanniarpoq	imaap+NIAR<Indikativ<han
imaanniarlutik	imaap+NIAR<Ledsagemåde<de_selv
imaannianngillat	imaap+NIAR=NNGIT<Indikativ<de
imaannianngilaq	imaap+NIAR=NNGIT<Indikativ<han
imaanniarnatik	imaap+NIAR=NNGIT<Ledsagemåde<de_selv
imaannianngitsoq	imaap+NIAR=NNGIT<Participium<han
imaanniartut	imaap+NIAR<Participium<de
imaanniartoq	imaap+NIAR<Participium<han
imaanngillat	imaap-NNGIT<Indikativ<de
imaanngilaq	imaap-NNGIT<Indikativ<han
imaannatik	imaap-NNGIT<Ledsagemåde<de_selv
imaanngitsut	imaap-NNGIT<Participium<de
imaanngitsoq	imaap-NNGIT<Participium<han
imaattut	imaap<Participium<de
imaattoq	imaap<Participium<han
imaassinnaapput	imaap+SINNAA<Indikativ<de
imaassinnaavoq	imaap+SINNAA<Indikativ<han
imaassinnaallutik	imaap+SINNAA<Ledsagemåde<de_selv
imaassinnaasut	imaap+SINNAA<Participium<de
imaassinnaasoq	imaap+SINNAA<Participium<han
inunngorput	inunngor<Indikativ<de
inunngorpoq	inunngor<Indikativ<han
inunngorlutik	inunngor<Ledsagemåde<de_selv
inunngorniarput	inunngor+NIAR<Indikativ<de
inunngorniarpoq	inunngor+NIAR<Indikativ<han
inunngorniarlutik	inunngor+NIAR<Ledsagemåde<de_selv
inunngornianngillat	inunngor+NIAR=NNGIT<Indikativ<de
inunngornianngilaq	inunngor+NIAR=NNGIT<Indikativ<han
inunngorniarnatik	inunngor+NIAR=NNGIT<Ledsagemåde<de_selv
inunngornianngitsut	inunngor+NIAR=NNGIT<Participium<de
inunngornianngitsoq	inunngor+NIAR=NNGIT<Participium<han
inunngorniartut	inunngor+NIAR<Participium<de
inunngorniartoq	inunngor+NIAR<Participium<han
inunngunngillat	inunngor-NNGIT<Indikativ<de
inunngunngilaq	inunngor-NNGIT<Indikativ<han
inunngornatik	inunngor-NNGIT<Ledsagemåde<de_selv
inunngunngitsut	inunngor-NNGIT<Participium<de
inunngunngitsoq	inunngor-NNGIT<Participium<han
inunngortut	inunngor<Participium<de
inunngortoq	inunngor<Participium<han
inunngorsinnaapput	inunngor+SINNAA<Indikativ<de
inunngorsinnaavoq	inunngor+SINNAA<Indikativ<han
inunngorsinnaallutik	inunngor+SINNAA<Ledsagemåde<de_selv
inunngorsinnaasut	inunngor+SINNAA<Participium<de
inunngorsinnaasoq	inunngor+SINNAA<Participium<han
isuma	isuma<ental<Absolut
isumaa	isuma<ental<hans<Absolut
isumami	isuma<ental<Lokalis
isumamiillutik	isuma<ental<Lokalis+IP<Ledsagemåde<de_selv
isumamiinniartoq	isuma<ental<Lokalis+IP+NIAR<Participium<han
isumamiinngitsoq	isuma<ental<Lokalis+IP-NNGIT<Participium<han
isumaa	isuma<flertal<hans<Absolut
isumani	isuma<flertal<Lokalis
isumaniippoq	isuma<flertal<Lokalis+IP<Indikativ<han
isumaniillutik	isuma<flertal<Lokalis+IP<Ledsagemåde<de_selv
isumaniinnatik	isuma<flertal<Lokalis+IP-NNGIT<Ledsagemåde<de_selv
isumaniinngitsoq	isuma<flertal<Lokalis+IP-NNGIT<Participium<han
isumaniittut	isuma<flertal<Lokalis+IP<Participium<de
isumaniittoq	isuma<flertal<Lokalis+IP<Participium<han
isumagitigit	isuma+GӘ<Imperativ<ViDem
isumagivaa	isuma+GӘ<Indikativ<HanHam
isumagivakka	isuma+GӘ<Indikativ<JegDem
isumagivagut	isuma+GӘ<Indikativ<ViDem
isumaginngilakka	isuma+GӘ-NNGIT<Indikativ<JegDem
isumaginngilagut	isuma+GӘ-NNGIT<Indikativ<ViDem
isumaqarput	isumaqar<Indikativ<de
isumaqarpoq	isumaqar<Indikativ<han
isumaqarlutik	isumaqar<Ledsagemåde<de_selv
isumaqarniarpoq	isumaqar+NIAR<Indikativ<han
isumaqarnianngillat	isumaqar+NIAR=NNGIT<Indikativ<de
isumaqarnianngilaq	isumaqar+NIAR=NNGIT<Indikativ<han
isumaqarniarnatik	isumaqar+NIAR=NNGIT<Ledsagemåde<de_selv
isumaqarnianngitsut	isumaqar+NIAR=NNGIT<Participium<de
isumaqarniartut	isumaqar+NIAR<Participium<de
isumaqarniartoq	isumaqar+NIAR<Participium<han
isumaqanngillat	isumaqar-NNGIT<Indikativ<de
isumaqanngilaq	isumaqar-NNGIT<Indikativ<han
isumaqarnatik	isumaqar-NNGIT<Ledsagemåde<de_selv
isumaqanngitsut	isumaqar-NNGIT<Participium<de
isumaqanngitsoq	isumaqar-NNGIT<Participium<han
isumaqartut	isumaqar<Participium<de
isumaqartoq	isumaqar<Participium<han
isumaqarsinnaapput	isumaqar+SINNAA<Indikativ<de
isumaqarsinnaallutik	isumaqar+SINNAA<Ledsagemåde<de_selv
isumaqarsinnaasoq	isumaqar+SINNAA<Participium<han
kiisa	kiisa<Partikel
kisimi	kisimi<Adjektiv
makku	makku<Pronomen<flertal
manna	manna<Pronomen<ental
marluk	marluk<Talord<flertal<Absolut
massakkut	massakkut<Partikel
naja	naja<ental<Absolut
najaa	naja<ental<hans<Absolut
najami	naja<ental<Lokalis
najamiipput	naja<ental<Lokalis+IP<Indikativ<de
najamiippoq	naja<ental<Lokalis+IP<Indikativ<han
najamiillutik	naja<ental<Lokalis+IP<Ledsagemåde<de_selv
najamiinniarpoq	naja<ental<Lokalis+IP+NIAR<Indikativ<han
najamiinniarnatik	naja<ental<Lokalis+IP+NIAR=NNGIT<Ledsagemåde<de_selv
najamiinniartoq	naja<ental<Lokalis+IP+NIAR<Participium<han
najamiinngitsut	naja<ental<Lokalis+IP-NNGIT<Participium<de
najamiissinnaavoq	naja<ental<Lokalis+IP+SINNAA<Indikativ<han
najaa	naja<flertal<hans<Absolut
najani	naja<flertal<Lokalis
najaniipput	naja<flertal<Lokalis+IP<Indikativ<de
najaniippoq	naja<flertal<Lokalis+IP<Indikativ<han
najaniillutik	naja<flertal<Lokalis+IP<Ledsagemåde<de_selv
najaniinnianngitsut	naja<flertal<Lokalis+IP+NIAR=NNGIT<Participium<de
najaniinngilaq	naja<flertal<Lokalis+IP-NNGIT<Indikativ<han
najaniinnatik	naja<flertal<Lokalis+IP-NNGIT<Ledsagemåde<de_selv
najaniittoq	naja<flertal<Lokalis+IP<Participium<han
najaniissinnaallutik	naja<flertal<Lokalis+IP+SINNAA<Ledsagemåde<de_selv
najaniissinnaasoq	naja<flertal<Lokalis+IP+SINNAA<Participium<han
najagitigit	naja+GӘ<Imperativ<ViDem
najagivaa	naja+GӘ<Indikativ<HanHam
najagivakka	naja+GӘ<Indikativ<JegDem
najagivagut	naja+GӘ<Indikativ<ViDem
najaginngilakka	naja+GӘ-NNGIT<Indikativ<JegDem
najaginngilagut	naja+GӘ-NNGIT<Indikativ<ViDem
nalunarput	nalunar<Indikativ<de
nalunarpoq	nalunar<Indikativ<han
nalunarlutik	nalunar<Ledsagemåde<de_selv
nalunarniarput	nalunar+NIAR<Indikativ<de
nalunarniarpoq	nalunar+NIAR<Indikativ<han
nalunarniarlutik	nalunar+NIAR<Ledsagemåde<de_selv
nalunarnianngillat	nalunar+NIAR=NNGIT<Indikativ<de
nalunarnianngilaq	nalunar+NIAR=NNGIT<Indikativ<han
nalunarniarnatik	nalunar+NIAR=NNGIT<Ledsagemåde<de_selv
nalunarnianngitsoq	nalunar+NIAR=NNGIT<Participium<han
nalunarniartut	nalunar+NIAR<Participium<de
nalunarniartoq	nalunar+NIAR<Participium<han
nalunanngillat	nalunar-NNGIT<Indikativ<de
nalunanngilaq	nalunar-NNGIT<Indikativ<han
nalunarnatik	nalunar-NNGIT<Ledsagemåde<de_selv
nalunanngitsut	nalunar-NNGIT<Participium<de
nalunanngitsoq	nalunar-NNGIT<Participium<han
nalunartut	nalunar<Participium<de
nalunartoq	nalunar<Participium<han
nalunarsinnaapput	nalunar+SINNAA<Indikativ<de
nalunarsinnaavoq	nalunar+SINNAA<Indikativ<han
nalunarsinnaallutik	nalunar+SINNAA<Ledsagemåde<de_selv
nalunarsinnaasut	nalunar+SINNAA<Participium<de
nalunarsinnaasoq	nalunar+SINNAA<Participium<han
nuka	nuka<ental<Absolut
nukaa	nuka<ental<hans<Absolut
nukami	nuka<ental<Lokalis
nukamiipput	nuka<ental<Lokalis+IP<Indikativ<de
nukamiippoq	nuka<ental<Lokalis+IP<Indikativ<han
nukamiillutik	nuka<ental<Lokalis+IP<Ledsagemåde<de_selv
nukamiinnianngillat	nuka<ental<Lokalis+IP+NIAR=NNGIT<Indikativ<de
nukamiinniarnatik	nuka<ental<Lokalis+IP+NIAR=NNGIT<Ledsagemåde<de_selv
nukamiinnatik	nuka<ental<Lokalis+IP-NNGIT<Ledsagemåde<de_selv
nukamiinngitsut	nuka<ental<Lokalis+IP-NNGIT<Participium<de
nukamiinngitsoq	nuka<ental<Lokalis+IP-NNGIT<Participium<han
nukamiittut	nuka<ental<Lokalis+IP<Participium<de
nukamiittoq	nuka<ental<Lokalis+IP<Participium<han
nukamiissinnaallutik	nuka<ental<Lokalis+IP+SINNAA<Ledsagemåde<de_selv
nukamiissinnaasut	nuka<ental<Lokalis+IP+SINNAA<Participium<de
nukaa	nuka<flertal<hans<Absolut
nukani	nuka<flertal<Lokalis
nukaniipput	nuka<flertal<Lokalis+IP<Indikativ<de
nukaniippoq	nuka<flertal<Lokalis+IP<Indikativ<han
nukaniillutik	nuka<flertal<Lokalis+IP<Ledsagemåde<de_selv
nukaniinniarpoq	nuka<flertal<Lokalis+IP+NIAR<Indikativ<han
nukaniinniartut	nuka<flertal<Lokalis+IP+NIAR<Participium<de
nukaniinniartoq	nuka<flertal<Lokalis+IP+NIAR<Participium<han
nukaniinngillat	nuka<flertal<Lokalis+IP-NNGIT<Indikativ<de
nukaniinngilaq	nuka<flertal<Lokalis+IP-NNGIT<Indikativ<han
nukaniinngitsoq	nuka<flertal<Lokalis+IP-NNGIT<Participium<han
nukaniittoq	nuka<flertal<Lokalis+IP<Participium<han
nukaniissinnaavoq	nuka<flertal<Lokalis+IP+SINNAA<Indikativ<han
nukaniissinnaallutik	nuka<flertal<Lokalis+IP+SINNAA<Ledsagemåde<de_selv
nukaniissinnaasut	nuka<flertal<Lokalis+IP+SINNAA<Participium<de
nukaniissinnaasoq	nuka<flertal<Lokalis+IP+SINNAA<Participium<han
nukagitigit	nuka+GӘ<Imperativ<ViDem
nukagivaa	nuka+GӘ<Indikativ<HanHam
nukagivakka	nuka+GӘ<Indikativ<JegDem
nukagivagut	nuka+GӘ<Indikativ<ViDem
nukaginngilakka	nuka+GӘ-NNGIT<Indikativ<JegDem
nukaginngilagut	nuka+GӘ-NNGIT<Indikativ<ViDem
Nuuk	Nuuk<Absolut
Nuummi	Nuuk<Lokalis
Nuummiipput	Nuuk<Lokalis+IP<Indikativ<de
Nuummiippoq	Nuuk<Lokalis+IP<Indikativ<han
Nuummiillutik	Nuuk<Lokalis+IP<Ledsagemåde<de_selv
Nuummiinniarput	Nuuk<Lokalis+IP+NIAR<Indikativ<de
Nuummiinniarpoq	Nuuk<Lokalis+IP+NIAR<Indikativ<han
Nuummiinniarlutik	Nuuk<Lokalis+IP+NIAR<Ledsagemåde<de_selv
Nuummiinnianngillat	Nuuk<Lokalis+IP+NIAR=NNGIT<Indikativ<de
Nuummiinnianngilaq	Nuuk<Lokalis+IP+NIAR=NNGIT<Indikativ<han
Nuummiinniarnatik	Nuuk<Lokalis+IP+NIAR=NNGIT<Ledsagemåde<de_selv
Nuummiinnianngitsut	Nuuk<Lokalis+IP+NIAR=NNGIT<Participium<de
Nuummiinnianngitsoq	Nuuk<Lokalis+IP+NIAR=NNGIT<Participium<han
Nuummiinniartut	Nuuk<Lokalis+IP+NIAR<Participium<de
Nuummiinniartoq	Nuuk<Lokalis+IP+NIAR<Participium<han
Nuummiinngillat	Nuuk<Lokalis+IP-NNGIT<Indikativ<de
Nuummiinngilaq	Nuuk<Lokalis+IP-NNGIT<Indikativ<han
Nuummiinnatik	Nuuk<Lokalis+IP-NNGIT<Ledsagemåde<de_selv
Nuummiinngitsut	Nuuk<Lokalis+IP-NNGIT<Participium<de
Nuummiinngitsoq	Nuuk<Lokalis+IP-NNGIT<Participium<han
Nuummiittut	Nuuk<Lokalis+IP<Participium<de
Nuummiittoq	Nuuk<Lokalis+IP<Participium<han
Nuummiissinnaapput	Nuuk<Lokalis+IP+SINNAA<Indikativ<de
Nuummiissinnaavoq	Nuuk<Lokalis+IP+SINNAA<Indikativ<han
Nuummiissinnaallutik	Nuuk<Lokalis+IP+SINNAA<Ledsagemåde<de_selv
Nuummiissinnaasut	Nuuk<Lokalis+IP+SINNAA<Participium<de
Nuummiissinnaasoq	Nuuk<Lokalis+IP+SINNAA<Participium<han
Nuummiu	Nuuk+MIU<ental<Absolut
pingasut	pingasut<Talord<flertal<Absolut
sisamat	sisamat<Talord<flertal<Absolut
taaguut	taaguut<ental<Absolut
taaguutaa	taaguut<ental<hans<Absolut
taaguummi	taaguut<ental<Lokalis
taaguummiipput	taaguut<ental<Lokalis+IP<Indikativ<de
taaguummiippoq	taaguut<ental<Lokalis+IP<Indikativ<han
taaguummiillutik	taaguut<ental<Lokalis+IP<Ledsagemåde<de_selv
taaguummiinniarput	taaguut<ental<Lokalis+IP+NIAR<Indikativ<de
taaguummiinniarpoq	taaguut<ental<Lokalis+IP+NIAR<Indikativ<han
taaguummiinniarlutik	taaguut<ental<Lokalis+IP+NIAR<Ledsagemåde<de_selv
taaguummiinnianngillat	taaguut<ental<Lokalis+IP+NIAR=NNGIT<Indikativ<de
taaguummiinniarnatik	taaguut<ental<Lokalis+IP+NIAR=NNGIT<Ledsagemåde<de_selv
taaguummiinnianngitsut	taaguut<ental<Lokalis+IP+NIAR=NNGIT<Participium<de
taaguummiinnianngitsoq	taaguut<ental<Lokalis+IP+NIAR=NNGIT<Participium<han
taaguummiinniartut	taaguut<ental<Lokalis+IP+NIAR<Participium<de
taaguummiinniartoq	taaguut<ental<Lokalis+IP+NIAR<Participium<han
taaguummiinngillat	taaguut<ental<Lokalis+IP-NNGIT<Indikativ<de
taaguummiinngilaq	taaguut<ental<Lokalis+IP-NNGIT<Indikativ<han
taaguummiinnatik	taaguut<ental<Lokalis+IP-NNGIT<Ledsagemåde<de_selv
taaguummiinngitsut	taaguut<ental<Lokalis+IP-NNGIT<Participium<de
taaguummiinngitsoq	taaguut<ental<Lokalis+IP-NNGIT<Participium<han
taaguummiittut	taaguut<ental<Lokalis+IP<Participium<de
taaguummiittoq	taaguut<ental<Lokalis+IP<Participium<han
taaguummiissinnaapput	taaguut<ental<Lokalis+IP+SINNAA<Indikativ<de
taaguummiissinnaavoq	taaguut<ental<Lokalis+IP+SINNAA<Indikativ<han
taaguummiissinnaallutik	taaguut<ental<Lokalis+IP+SINNAA<Ledsagemåde<de_selv
taaguummiissinnaasut	taaguut<ental<Lokalis+IP+SINNAA<Participium<de
taaguummiissinnaasoq	taaguut<ental<Lokalis+IP+SINNAA<Participium<han
taaguutai	taaguut<flertal<hans<Absolut
taaguutini	taaguut<flertal<Lokalis
taaguutiniipput	taaguut<flertal<Lokalis+IP<Indikativ<de
taaguutiniippoq	taaguut<flertal<Lokalis+IP<Indikativ<han
taaguutiniillutik	taaguut<flertal<Lokalis+IP<Ledsagemåde<de_selv
taaguutiniinniarpoq	taaguut<flertal<Lokalis+IP+NIAR<Indikativ<han
taaguutiniinniarlutik	taaguut<flertal<Lokalis+IP+NIAR<Ledsagemåde<de_selv
taaguutiniinnianngillat	taaguut<flertal<Lokalis+IP+NIAR=NNGIT<Indikativ<de
taaguutiniinniarnatik	taaguut<flertal<Lokalis+IP+NIAR=NNGIT<Ledsagemåde<de_selv
taaguutiniinniartut	taaguut<flertal<Lokalis+IP+NIAR<Participium<de
taaguutiniinniartoq	taaguut<flertal<Lokalis+IP+NIAR<Participium<han
taaguutiniinngillat	taaguut<flertal<Lokalis+IP-NNGIT<Indikativ<de
taaguutiniinngilaq	taaguut<flertal<Lokalis+IP-NNGIT<Indikativ<han
taaguutiniinnatik	taaguut<flertal<Lokalis+IP-NNGIT<Ledsagemåde<de_selv
taaguutiniinngitsut	taaguut<flertal<Lokalis+IP-NNGIT<Participium<de
taaguutiniittut	taaguut<flertal<Lokalis+IP<Participium<de
taaguutiniissinnaallutik	taaguut<flertal<Lokalis+IP+SINNAA<Ledsagemåde<de_selv
taaguutiniissinnaasut	taaguut<flertal<Lokalis+IP+SINNAA<Participium<de
taaguutiniissinnaasoq	taaguut<flertal<Lokalis+IP+SINNAA<Participium<han
taaguutigitigit	taaguut+GӘ<Imperativ<ViDem
taaguutigivaa	taaguut+GӘ<Indikativ<HanHam
taaguutigivakka	taaguut+GӘ<Indikativ<JegDem
taaguutigivagut	taaguut+GӘ<Indikativ<ViDem
taaguutiginngilakka	taaguut+GӘ-NNGIT<Indikativ<JegDem
taaguutiginngilagut	taaguut+GӘ-NNGIT<Indikativ<ViDem
uagut	uagut<Pronomen<flertal
ukioq	ukioq<ental<Absolut
