aamma	aamma<Partikel
aammali	aamma<Partikel+LI
aammaana	aamma<Partikel+UNA
aappaaguli	aappaagu<Partikel+LI
aappaagulu	aappaagu<Partikel+LU
aappaaguuna	aappaagu<Partikel+UNA
aap	aap<Partikel
aalli	aap<Partikel+LI
aallu	aap<Partikel+LU
aapuna	aap<Partikel+UNA
Aasiaat	Aasiaat<Absolut
Aasiaalli	Aasiaat<Absolut+LI
Aasiaallu	Aasiaat<Absolut+LU
Aasiaanuna	Aasiaat<Absolut+UNA
Aasiannik	Aasiaat<Instrumentalis
Aasiannilli	Aasiaat<Instrumentalis+LI
Aasiannillu	Aasiaat<Instrumentalis+LU
Aasianninguna	Aasiaat<Instrumentalis+UNA
Aasianni	Aasiaat<Lokalis
Aasiannili	Aasiaat<Lokalis+LI
Aasiannilu	Aasiaat<Lokalis+LU
Aasianniuna	Aasiaat<Lokalis+UNA
Aasiammiu	Aasiaat+MIU<ental<Absolut
Aasiammiumut	Aasiaat+MIU<ental<Terminalis
Aasiammiuniuna	Aasiaat+MIU<flertal<Lokalis+UNA
Aasiammiulerilaarnernut	Aasiaat+MIU-LIRI-LAAR+NIQ<flertal<Terminalis
Aasiammiulerilaartarpugulli	Aasiaat+MIU-LIRI-LAAR=TAR<Indikativ<vi+LI
Aasiammiulerissavit	Aasiaat+MIU-LIRI-SSA<Interrogativ<du
Aasiammiunngorniarnatinguna	Aasiaat+MIU-NNGUR+NIAR=NNGIT<Ledsagemåde<de_selv+UNA
Aasiammioqarpoq	Aasiaat+MIU-QAR<Indikativ<han
Aasiammioqarporli	Aasiaat+MIU-QAR<Indikativ<han+LI
Aasiammioqarporuna	Aasiaat+MIU-QAR<Indikativ<han+UNA
Aasiammioqarneq	Aasiaat+MIU-QAR+NIQ
Aasiammioqarnerli	Aasiaat+MIU-QAR+NIQ+LI
Aasiammioqartorlu	Aasiaat+MIU-QAR<Participium<han+LU
Aasiammiuugaluarpit	Aasiaat+MIU-U+GALUAR<Interrogativ<du
Aasiammiuuvunga	Aasiaat+MIU-U<Indikativ<jeg
Aasiammiuuit	Aasiaat+MIU-U<Interrogativ<du
Aasiammiuuniarpununa	Aasiaat+MIU-U+NIAR<Indikativ<de+UNA
Aasiammiuunermut	Aasiaat+MIU-U+NIQ<ental<Terminalis
Aasiammiuunermulli	Aasiaat+MIU-U+NIQ<ental<Terminalis+LI
Aasiammiuunngillallu	Aasiaat+MIU-U-NNGIT<Indikativ<de+LU
Aasiammiuunnginnera	Aasiaat+MIU-U-NNGIT+NIQ<ental<hans<Absolut
Aasiammiuusut	Aasiaat+MIU-U<Participium<de
Aasiammiuusimasarpoq	Aasiaat+MIU-U+SIMA=TAR<Indikativ<han
Aasiammiuusinnaavit	Aasiaat+MIU-U+SINNAA<Interrogativ<du
akisuuanuna	akisooq<ental<deres<Absolut+UNA
akisuuniissinnaavit	akisooq<flertal<Lokalis+IP+SINNAA<Interrogativ<du
akisuunulli	akisooq<flertal<Terminalis+LI
akisuunullu	akisooq<flertal<Terminalis+LU
akisoorigaluarpiuk	akisooq+GӘ+GALUAR<Interrogativ<DuHam
akisoorisinnaavassi	akisooq+GӘ+SINNAA<Indikativ<JegJer
akisuuinnaqalaartarpit	akisooq-INNAQ-QAR-LAAR=TAR<Interrogativ<du
akisuullilli	akisooq-LIK<flertal<Relativ+LI
akisuunngornianngilaq	akisooq-NNGUR+NIAR=NNGIT<Indikativ<han
akisuunngunnginnermullu	akisooq-NNGUR-NNGIT+NIQ<ental<Terminalis+LU
akisuunngorsimanerli	akisooq-NNGUR+SIMA+NIQ+LI
akisuunngorsimasarnerlu	akisooq-NNGUR+SIMA=TAR+NIQ+LU
akisoorpassuartut	akisooq+PASSUAQ<flertal<Aequalis
akisoorpassui	akisooq+PASSUAQ<flertal<hans<Absolut
akisooqalaarneruna	akisooq-QAR-LAAR+NIQ+UNA
akisooqalaartarpoq	akisooq-QAR-LAAR=TAR<Indikativ<han
akisooqalaartartorli	akisooq-QAR-LAAR=TAR<Participium<han+LI
akisooqassagaluarporuna	akisooq-QAR-SSA=GALUAR<Indikativ<han+UNA
akisooqassagaluarneruna	akisooq-QAR-SSA=GALUAR+NIQ+UNA
akisooqassasorli	akisooq-QAR-SSA<Participium<han+LI
akisuujulaartarpit	akisooq-U-LAAR=TAR<Interrogativ<du
akisuujunatik	akisooq-U-NNGIT<Ledsagemåde<de_selv
akisuujusarnertut	akisooq-U+TAR+NIQ<ental<Aequalis
aleqatut	aleqa<ental<Aequalis
aleqaminguna	aleqa<ental<Instrumentalis+UNA
aleqamullu	aleqa<ental<Terminalis+LU
aleqamununa	aleqa<ental<Terminalis+UNA
aleqaauna	aleqa<flertal<hans<Absolut+UNA
aleqani	aleqa<flertal<Lokalis
aleqaniittoq	aleqa<flertal<Lokalis+IP<Participium<han
aleqaniissimasunga	aleqa<flertal<Lokalis+IP+SIMA<Participium<jeg
aleqanili	aleqa<flertal<Lokalis+LI
aleqagiviuk	aleqa+GӘ<Interrogativ<DuHam
aleqagisimaviuk	aleqa+GӘ+SIMA<Interrogativ<DuHam
aleqagissagaluarpassilu	aleqa+GӘ-SSA=GALUAR<Indikativ<JegJer+LU
aleqagisartigit	aleqa+GӘ+TAR<Imperativ<ViDem
aleqaannaali	aleqa-INNAQ<ental<hans<Absolut+LI
aleqaannalerinerillu	aleqa-INNAQ-LIRI+NIQ<flertal<Relativ+LU
aleqalittulli	aleqa-LIK<ental<Aequalis+LI
aleqallilli	aleqa-LIK<flertal<Relativ+LI
aleqalerilaarpugut	aleqa-LIRI-LAAR<Indikativ<vi
aleqalerissaanga	aleqa-LIRI-SSA<Indikativ<jeg
aleqamiuni	aleqa+MIU<flertal<Lokalis
aleqamioqarporli	aleqa+MIU-QAR<Indikativ<han+LI
aleqamioqartoq	aleqa+MIU-QAR<Participium<han
aleqamioqartorli	aleqa+MIU-QAR<Participium<han+LI
aleqamioqartorlu	aleqa+MIU-QAR<Participium<han+LU
aleqamiuunngilangaana	aleqa+MIU-U-NNGIT<Indikativ<jeg+UNA
aleqamiuusimasarnerali	aleqa+MIU-U+SIMA=TAR+NIQ<ental<hans<Absolut+LI
aleqamiuussasoruna	aleqa+MIU-U-SSA<Participium<han+UNA
aleqanngulaartarpugut	aleqa-NNGUR-LAAR=TAR<Indikativ<vi
aleqanngorneri	aleqa-NNGUR+NIQ<flertal<hans<Absolut
aleqarpassuilli	aleqa+PASSUAQ<flertal<Absolut+LI
aleqarpassuili	aleqa+PASSUAQ<flertal<hans<Absolut+LI
aleqarpassuiuna	aleqa+PASSUAQ<flertal<hans<Absolut+UNA
aleqarpassuarnik	aleqa+PASSUAQ<flertal<Instrumentalis
aleqaqassagaluarpit	aleqa-QAR-SSA=GALUAR<Interrogativ<du
aleqaasimavugununa	aleqa-U+SIMA<Indikativ<vi+UNA
aleqaasimavit	aleqa-U+SIMA<Interrogativ<du
anaanani	anaana<flertal<Lokalis
anaanagisinnaatigilli	anaana+GӘ+SINNAA<Imperativ<ViDem+LI
anaanaannalerisartununa	anaana-INNAQ-LIRI+TAR<Participium<de+UNA
anaanalimmullu	anaana-LIK<ental<Terminalis+LU
anaanamiulerisinnaaneranuna	anaana+MIU-LIRI+SINNAA+NIQ<ental<deres+UNA
anaanamiunngunngilagununa	anaana+MIU-NNGUR-NNGIT<Indikativ<vi+UNA
anaanamioqarpoq	anaana+MIU-QAR<Indikativ<han
angajulinniinnianngilagununa	angaju-LIK<flertal<Lokalis+IP+NIAR=NNGIT<Indikativ<vi+UNA
angajumioqarporli	angaju+MIU-QAR<Indikativ<han+LI
angajorpassuit	angaju+PASSUAQ<flertal<Absolut
angajorpassuartulli	angaju+PASSUAQ<flertal<Aequalis+LI
angajorpassuarniuna	angaju+PASSUAQ<flertal<Lokalis+UNA
angullu	angut<ental<Absolut+LU
angummik	angut<ental<Instrumentalis
angummi	angut<ental<Lokalis
aniga	ani<ental<min<Absolut
aniinnaat	ani-INNAQ<flertal<Relativ
aniinnaqalaarpit	ani-INNAQ-QAR-LAAR<Interrogativ<du
animiunilu	ani+MIU<flertal<Lokalis+LU
aninngulaarpit	ani-NNGUR-LAAR<Interrogativ<du
anerpassuilli	ani+PASSUAQ<flertal<Absolut+LI
anerpassuartut	ani+PASSUAQ<flertal<Aequalis
anerpassuarniilaartarlutilli	ani+PASSUAQ<flertal<Lokalis+IP-LAAR=TAR<Ledsagemåde<de_selv+LI
anerpassuarnulli	ani+PASSUAQ<flertal<Terminalis+LI
aneqalaartarpungaana	ani-QAR-LAAR=TAR<Indikativ<jeg+UNA
aqqaluga	aqqalu<ental<min<Absolut
aqqalumi	aqqalu<enta<Lokalisl
aqqalumiilaarneq	aqqalu<enta<Lokalisl+IP-LAAR+NIQ<ental<Absolut
aqqalumiittarpit	aqqalu<enta<Lokalisl+IP+TAR<Interrogativ<du
aqqalumilu	aqqalu<enta<Lokalisl+LU
aqqalugissagaluartigit	aqqalu+GӘ-SSA=GALUAR<Imperativ<ViDem
aqqaluinnaa	aqqalu-INNAQ<ental<hans<Absolut
aqqalullit	aqqalu-LIK<flertal<Relativ
aqqalullillu	aqqalu-LIK<flertal<Relativ+LU
aqqalulinngulaartarpugut	aqqalu-LIK-NNGUR-LAAR=TAR<Indikativ<vi
aqqalulerisorlu	aqqalu-LIRI<Participium<han+LU
aqqalumiuniuna	aqqalu+MIU<flertal<Lokalis+UNA
aqqalumiulerisunga	aqqalu+MIU-LIRI<Participium<jeg
aqqalumioqartoq	aqqalu+MIU-QAR<Participium<han
aqqalumiuulaarnermulli	aqqalu+MIU-U-LAAR+NIQ<ental<Terminalis+LI
aqqalumiuunianngitsut	aqqalu+MIU-U+NIAR=NNGIT<Participium<de
aqqalumiuusimallutinguna	aqqalu+MIU-U+SIMA<Ledsagemåde<de_selv+UNA
aqqalunngulaartarpunga	aqqalu-NNGUR-LAAR=TAR<Indikativ<jeg
aqqalunngulaartarnerni	aqqalu-NNGUR-LAAR=TAR+NIQ<flertal<Lokalis
aqqalunngortoq	aqqalu-NNGUR<Participium<han
aqqalorpassuillu	aqqalu+PASSUAQ<flertal<Absolut+LU
aqqalorpassuinuna	aqqalu+PASSUAQ<flertal<Absolut+UNA
aqqalorpassuartut	aqqalu+PASSUAQ<flertal<Aequalis
aqqalorpassuartulli	aqqalu+PASSUAQ<flertal<Aequalis+LI
aqqalorpassuartununa	aqqalu+PASSUAQ<flertal<Aequalis+UNA
aqqalorpassui	aqqalu+PASSUAQ<flertal<hans<Absolut
aqqalorpassuilu	aqqalu+PASSUAQ<flertal<hans<Absolut+LU
aqqalorpassuarnilli	aqqalu+PASSUAQ<flertal<Instrumentalis+LI
aqqaloqaraluarlutillu	aqqalu-QAR+GALUAR<Ledsagemåde<de_selv+LU
aqqaloqalaarpununa	aqqalu-QAR-LAAR<Indikativ<de+UNA
aqqaloqarniarnatillu	aqqalu-QAR+NIAR=NNGIT<Ledsagemåde<de_selv+LU
aqqaloqanngitsunga	aqqalu-QAR-NNGIT<Participium<jeg
aqqaluusimasarporlu	aqqalu-U+SIMA=TAR<Indikativ<han+LU
arnaq	arnaq<ental<Absolut
arnaa	arnaq<ental<hans<Absolut
arnamilli	arnaq<ental<Instrumentalis+LI
arnara	arnaq<ental<min<Absolut
arnami	arnaq<enta<Lokalisl
arnaa	arnaq<flertal<hans<Absolut
arnarigaluartigillu	arnaq+GӘ+GALUAR<Imperativ<ViDem+LU
arnaritigit	arnaq+GӘ<Imperativ<ViDem
arnarilaarpiuk	arnaq+GӘ-LAAR<Interrogativ<DuHam
arnaannaallu	arnaq-INNAQ<ental<deres<Absolut+LU
arnaannalerilaarpununa	arnaq-INNAQ-LIRI-LAAR<Indikativ<de+UNA
arnallilli	arnaq-LIK<flertal<Relativ+LI
arnarmiumi	arnaq+MIU<ental<Lokalis
arnarmiuni	arnaq+MIU<flertal<Lokalis
arnarmioqartoq	arnaq+MIU-QAR<Participium<han
arnarmiuusinnaallutilli	arnaq+MIU-U+SINNAA<Ledsagemåde<de_selv+LI
arnarmiuusartunga	arnaq+MIU-U+TAR<Participium<jeg
arnanngulaartartungaana	arnaq-NNGUR-LAAR=TAR<Participium<jeg+UNA
arnarpassuilu	arnaq+PASSUAQ<flertal<hans<Absolut+LU
arnaqaraluarlutik	arnaq-QAR+GALUAR<Ledsagemåde<de_selv
arnaqaraluartunga	arnaq-QAR+GALUAR<Participium<jeg
arnaallutinguna	arnaq-U<Ledsagemåde<de_selv+UNA
arnaanerniillutilli	arnaq-U+NIQ<flertal<Lokalis+IP<Ledsagemåde<de_selv+LI
arnaasunga	arnaq-U<Participium<jeg
assersuulli	assersuut<ental<Absolut+LI
assersuullu	assersuut<ental<Absolut+LU
assersuununa	assersuut<ental<Absolut+UNA
assersuummi	assersuut<ental<Lokalis
assersuummiinniarnatilli	assersuut<ental<Lokalis+IP+NIAR=NNGIT<Ledsagemåde<de_selv+LI
assersuummut	assersuut<ental<Terminalis
assersuummulli	assersuut<ental<Terminalis+LI
assersuummununa	assersuut<ental<Terminalis+UNA
assersuutaannaq	assersuut-INNAQ<ental<Absolut
assersuutaannaa	assersuut-INNAQ<flertal<hans<Absolut
assersuutimiunili	assersuut+MIU<flertal<Lokalis+LI
assersuutimiunngorpununa	assersuut+MIU-NNGUR<Indikativ<de+UNA
assersuutimiunngortarlutillu	assersuut+MIU-NNGUR+TAR<Ledsagemåde<de_selv+LU
assersuutinngulaartarnera	assersuut-NNGUR-LAAR=TAR+NIQ<ental<hans<Absolut
assersuuterpassui	assersuut+PASSUAQ<flertal<hans<Absolut
assersuuteqaraluarpungaana	assersuut-QAR+GALUAR<Indikativ<jeg+UNA
assersuuteqassagaluarpit	assersuut-QAR-SSA=GALUAR<Interrogativ<du
assersuutaagaluarnerinuna	assersuut-U+GALUAR+NIQ<flertal<Relativ+UNA
assersuutaaniarput	assersuut-U+NIAR<Indikativ<de
ataasillit	ataaseq-LIK<flertal<Relativ
ataatsimik	ataaseq<Talord<Instrumentalis
ataatagisaraluartigilli	ataata+GӘ+TAR=GALUAR<Imperativ<ViDem+LI
ataataannalerisimasarpunga	ataata-INNAQ-LIRI+SIMA=TAR<Indikativ<jeg
ateq	ateq<ental<Absolut
atianuna	ateq<ental<deres<Absolut+UNA
atillit	ateq-LIK<flertal<Relativ
ateqalaarporuna	ateq-QAR-LAAR<Indikativ<han+UNA
ateqalaartarlutik	ateq-QAR-LAAR=TAR<Ledsagemåde<de_selv
ateqarlutinguna	ateq-QAR<Ledsagemåde<de_selv+UNA
ateqanngilangali	ateq-QAR-NNGIT<Indikativ<jeg+LI
ateqartungaana	ateq-QAR<Participium<jeg+UNA
atorpit	ator<Interrogativ<du
atulaarnermulli	ator-LAAR+NIQ<ental<Terminalis+LI
atorlutinguna	ator<Ledsagemåde<de_selv+UNA
atorniartoruna	ator+NIAR<Participium<han+UNA
atornatilli	ator-NNGIT<Ledsagemåde<de_selv+LI
atunnginnerinuna	ator-NNGIT+NIQ<flertal<Relativ+UNA
atorsimanernilu	ator+SIMA+NIQ<flertal<Lokalis+LU
atorsimasarnera	ator+SIMA=TAR+NIQ<ental<hans<Absolut
atussagaluarpakkaana	ator-SSA=GALUAR<Indikativ<JegDem+UNA
Avanersuaq	Avanersuaq<Absolut
Avanersuarli	Avanersuaq<Absolut+LI
Avanersuarlu	Avanersuaq<Absolut+LU
Avanersuaruna	Avanersuaq<Absolut+UNA
Avanersuarmik	Avanersuaq<Instrumentalis
Avanersuarmilli	Avanersuaq<Instrumentalis+LI
Avanersuarmillu	Avanersuaq<Instrumentalis+LU
Avanersuarminguna	Avanersuaq<Instrumentalis+UNA
Avanersuarmi	Avanersuaq<Lokalis
Avanersuarmiu	Avanersuaq+MIU<ental<Absolut
Avanersuarmiumilli	Avanersuaq+MIU<ental<Instrumentalis+LI
Avanersuarmiumi	Avanersuaq+MIU<ental<Lokalis
Avanersuarmiumullu	Avanersuaq+MIU<ental<Terminalis+LU
Avanersuarmiumununa	Avanersuaq+MIU<ental<Terminalis+UNA
Avanersuarmiunilli	Avanersuaq+MIU<flertal<Instrumentalis+LI
Avanersuarmiunillu	Avanersuaq+MIU<flertal<Instrumentalis+LU
Avanersuarmiuninguna	Avanersuaq+MIU<flertal<Instrumentalis+UNA
Avanersuarmiuni	Avanersuaq+MIU<flertal<Lokalis
Avanersuarmiuniuna	Avanersuaq+MIU<flertal<Lokalis+UNA
Avanersuarmiulerilaarnerit	Avanersuaq+MIU-LIRI-LAAR+NIQ<flertal<Relativ
Avanersuarmiuleriniartoq	Avanersuaq+MIU-LIRI+NIAR<Participium<han
Avanersuarmiulerisoruna	Avanersuaq+MIU-LIRI<Participium<han+UNA
Avanersuarmiulerissagaluartunga	Avanersuaq+MIU-LIRI-SSA=GALUAR<Participium<jeg
Avanersuarmiunngoraluarpit	Avanersuaq+MIU-NNGUR+GALUAR<Interrogativ<du
Avanersuarmiunngoraluarneri	Avanersuaq+MIU-NNGUR+GALUAR+NIQ<flertal<hans<Absolut
Avanersuarmiunngulaarneq	Avanersuaq+MIU-NNGUR-LAAR+NIQ<ental<Absolut
Avanersuarmiunngulaartarpoq	Avanersuaq+MIU-NNGUR-LAAR=TAR<Indikativ<han
Avanersuarmiunngulaartarlutik	Avanersuaq+MIU-NNGUR-LAAR=TAR<Ledsagemåde<de_selv
Avanersuarmiunngorlutik	Avanersuaq+MIU-NNGUR<Ledsagemåde<de_selv
Avanersuarmiunngornatik	Avanersuaq+MIU-NNGUR-NNGIT<Ledsagemåde<de_selv
Avanersuarmiunngorsimasarnerit	Avanersuaq+MIU-NNGUR+SIMA=TAR+NIQ<flertal<Absolut
Avanersuarmioqarpoq	Avanersuaq+MIU-QAR<Indikativ<han
Avanersuarmioqarporli	Avanersuaq+MIU-QAR<Indikativ<han+LI
Avanersuarmioqarporuna	Avanersuaq+MIU-QAR<Indikativ<han+UNA
Avanersuarmioqarneq	Avanersuaq+MIU-QAR+NIQ
Avanersuarmioqarnerli	Avanersuaq+MIU-QAR+NIQ+LI
Avanersuarmioqartoq	Avanersuaq+MIU-QAR<Participium<han
Avanersuarmioqartorli	Avanersuaq+MIU-QAR<Participium<han+LI
Avanersuarmioqartoruna	Avanersuaq+MIU-QAR<Participium<han+UNA
Avanersuarmiuugaluarpit	Avanersuaq+MIU-U+GALUAR<Interrogativ<du
Avanersuarmiuuvunga	Avanersuaq+MIU-U<Indikativ<jeg
Avanersuarmiuuvungalu	Avanersuaq+MIU-U<Indikativ<jeg+LU
Avanersuarmiuuvungaana	Avanersuaq+MIU-U<Indikativ<jeg+UNA
Avanersuarmiuuit	Avanersuaq+MIU-U<Interrogativ<du
Avanersuarmiuulaartarpit	Avanersuaq+MIU-U-LAAR=TAR<Interrogativ<du
Avanersuarmiuulaartartungalu	Avanersuaq+MIU-U-LAAR=TAR<Participium<jeg+LU
Avanersuarmiuullutillu	Avanersuaq+MIU-U<Ledsagemåde<de_selv+LU
Avanersuarmiuuniarpit	Avanersuaq+MIU-U+NIAR<Interrogativ<du
Avanersuarmiuuniarlutilli	Avanersuaq+MIU-U+NIAR<Ledsagemåde<de_selv+LI
Avanersuarmiuuniarnerilli	Avanersuaq+MIU-U+NIAR+NIQ<flertal<Relativ+LI
Avanersuarmiuunernilli	Avanersuaq+MIU-U+NIQ<flertal<Instrumentalis+LI
Avanersuarmiuunngilanga	Avanersuaq+MIU-U-NNGIT<Indikativ<jeg
Avanersuarmiuunatillu	Avanersuaq+MIU-U-NNGIT<Ledsagemåde<de_selv+LU
Avanersuarmiuunnginnera	Avanersuaq+MIU-U-NNGIT+NIQ<ental<hans<Absolut
Avanersuarmiuusunga	Avanersuaq+MIU-U<Participium<jeg
Avanersuarmiuusimasarnermullu	Avanersuaq+MIU-U+SIMA=TAR+NIQ<ental<Terminalis+LU
Avanersuarmiuussagaluarpulli	Avanersuaq+MIU-U-SSA=GALUAR<Indikativ<de+LI
Avanersuarmiuussagaluarneq	Avanersuaq+MIU-U-SSA=GALUAR+NIQ<ental<Absolut
Avanersuarmiuussagaluartungalu	Avanersuaq+MIU-U-SSA=GALUAR<Participium<jeg+LU
Avanersuarmiuusaraluarpugullu	Avanersuaq+MIU-U+TAR=GALUAR<Indikativ<vi+LU
Avanersuarmiuusaraluartunga	Avanersuaq+MIU-U+TAR=GALUAR<Participium<jeg
Avanersuarmiuusarnerilli	Avanersuaq+MIU-U+TAR+NIQ<flertal<Relativ+LI
Avanersuarmut	Avanersuaq<Terminalis
Avanersuarmulli	Avanersuaq<Terminalis+LI
Avanersuarmununa	Avanersuaq<Terminalis+UNA
eqqaamagaluartigit	eqqaama+GALUAR<Imperativ<ViDem
eqqaamagaluartigillu	eqqaama+GALUAR<Imperativ<ViDem+LU
eqqaamagaluarpaalli	eqqaama+GALUAR<Indikativ<DeHam+LI
eqqaamagaluarpakka	eqqaama+GALUAR<Indikativ<JegDem
eqqaamagaluarpakkaana	eqqaama+GALUAR<Indikativ<JegDem+UNA
eqqaamatigit	eqqaama<Imperativ<ViDem
eqqaamatiginuna	eqqaama<Imperativ<ViDem+UNA
eqqaamavaat	eqqaama<Indikativ<DeHam
eqqaamavaanuna	eqqaama<Indikativ<DeHam+UNA
eqqaamavaannga	eqqaama<Indikativ<DeMig
eqqaamavaali	eqqaama<Indikativ<HanHam+LI
eqqaamavassi	eqqaama<Indikativ<JegJer
eqqaamavagullu	eqqaama<Indikativ<ViDem+LU
eqqaamaviuk	eqqaama<Interrogativ<DuHam
eqqaamalaartigit	eqqaama-LAAR<Imperativ<ViDem
eqqaamalaartigillu	eqqaama-LAAR<Imperativ<ViDem+LU
eqqaamalaartiginuna	eqqaama-LAAR<Imperativ<ViDem+UNA
eqqaamalaarpaannga	eqqaama-LAAR<Indikativ<DeMig
eqqaamalaarpakka	eqqaama-LAAR<Indikativ<JegDem
eqqaamalaartartigit	eqqaama-LAAR=TAR<Imperativ<ViDem
eqqaamalaartarpassi	eqqaama-LAAR=TAR<Indikativ<JegJer
eqqaamalaartarpagullu	eqqaama-LAAR=TAR<Indikativ<ViDem+LU
eqqaamaniartiginuna	eqqaama+NIAR<Imperativ<ViDem+UNA
eqqaamaniarpakkali	eqqaama+NIAR<Indikativ<JegDem+LI
eqqaamanngilaat	eqqaama-NNGIT<Indikativ<DeHam
eqqaamanngilaa	eqqaama-NNGIT<Indikativ<HanHam
eqqaamanngilakka	eqqaama-NNGIT<Indikativ<JegDem
eqqaamanngilagulli	eqqaama-NNGIT<Indikativ<ViDem+LI
eqqaamanngiliuk	eqqaama-NNGIT<Interrogativ<DuHam
eqqaamasimatigit	eqqaama+SIMA<Imperativ<ViDem
eqqaamasimatigilli	eqqaama+SIMA<Imperativ<ViDem+LI
eqqaamasimavakka	eqqaama+SIMA<Indikativ<JegDem
eqqaamasimaviuk	eqqaama+SIMA<Interrogativ<DuHam
eqqaamasimasartigit	eqqaama+SIMA=TAR<Imperativ<ViDem
eqqaamasimasartigilli	eqqaama+SIMA=TAR<Imperativ<ViDem+LI
eqqaamasimasarpaalli	eqqaama+SIMA=TAR<Indikativ<DeHam+LI
eqqaamasimasarpakka	eqqaama+SIMA=TAR<Indikativ<JegDem
eqqaamasimasarpassiuna	eqqaama+SIMA=TAR<Indikativ<JegJer+UNA
eqqaamasimasarpiuk	eqqaama+SIMA=TAR<Interrogativ<DuHam
eqqaamasinnaatigit	eqqaama+SINNAA<Imperativ<ViDem
eqqaamasinnaatigilli	eqqaama+SINNAA<Imperativ<ViDem+LI
eqqaamasinnaavaat	eqqaama+SINNAA<Indikativ<DeHam
eqqaamasinnaavaalli	eqqaama+SINNAA<Indikativ<DeHam+LI
eqqaamasinnaavaannga	eqqaama+SINNAA<Indikativ<DeMig
eqqaamasinnaavakkalu	eqqaama+SINNAA<Indikativ<JegDem+LU
eqqaamasinnaavagut	eqqaama+SINNAA<Indikativ<ViDem
eqqaamasinnaaviuk	eqqaama+SINNAA<Interrogativ<DuHam
eqqaamassagaluartigilli	eqqaama-SSA=GALUAR<Imperativ<ViDem+LI
eqqaamassagaluartiginuna	eqqaama-SSA=GALUAR<Imperativ<ViDem+UNA
eqqaamassagaluarpaat	eqqaama-SSA=GALUAR<Indikativ<DeHam
eqqaamassagaluarpakka	eqqaama-SSA=GALUAR<Indikativ<JegDem
eqqaamassagaluarpagut	eqqaama-SSA=GALUAR<Indikativ<ViDem
eqqaamassagaluarpiuk	eqqaama-SSA=GALUAR<Interrogativ<DuHam
eqqaamassatigillu	eqqaama-SSA<Imperativ<ViDem+LU
eqqaamassavaanngaana	eqqaama-SSA<Indikativ<DeMig+UNA
eqqaamassavassilu	eqqaama-SSA<Indikativ<JegJer+LU
eqqaamasaraluartigilli	eqqaama+TAR=GALUAR<Imperativ<ViDem+LI
eqqaamasaraluarpaannga	eqqaama+TAR=GALUAR<Indikativ<DeMig
eqqaamasaraluarpagulli	eqqaama+TAR=GALUAR<Indikativ<ViDem+LI
eqqaamasaraluarpiuk	eqqaama+TAR=GALUAR<Interrogativ<DuHam
eqqaamasartigit	eqqaama+TAR<Imperativ<ViDem
eqqaamasartigilli	eqqaama+TAR<Imperativ<ViDem+LI
eqqaamasartiginuna	eqqaama+TAR<Imperativ<ViDem+UNA
eqqaamasarpakka	eqqaama+TAR<Indikativ<JegDem
eqqaamasarpakkaana	eqqaama+TAR<Indikativ<JegDem+UNA
eqqaamasarpassi	eqqaama+TAR<Indikativ<JegJer
eqqaamasarpagullu	eqqaama+TAR<Indikativ<ViDem+LU
eqqaamasarpiuk	eqqaama+TAR<Interrogativ<DuHam
eqqumiitsuliortoq	eqqumiitsuliortoq<ental<Absolut
eqqumiitsuliortorli	eqqumiitsuliortoq<ental<Absolut+LI
eqqumiitsuliortutut	eqqumiitsuliortoq<ental<Aequalis
eqqumiitsuliortuali	eqqumiitsuliortoq<ental<hans<Absolut+LI
eqqumiitsuliortuaana	eqqumiitsuliortoq<ental<hans<Absolut+UNA
eqqumiitsuliortumilli	eqqumiitsuliortoq<ental<Instrumentalis+LI
eqqumiitsuliortumi	eqqumiitsuliortoq<enta<Lokalisl
eqqumiitsuliortumiikkaluarnerli	eqqumiitsuliortoq<enta<Lokalisl+IP+GALUAR+NIQ<ental<Absolut+LI
eqqumiitsuliortumiilaartartunga	eqqumiitsuliortoq<enta<Lokalisl+IP-LAAR=TAR<Participium<jeg
eqqumiitsuliortumiissagaluartorli	eqqumiitsuliortoq<enta<Lokalisl+IP-SSA=GALUAR<Participium<han+LI
eqqumiitsuliortumiittarpungaana	eqqumiitsuliortoq<enta<Lokalisl+IP+TAR<Indikativ<jeg+UNA
eqqumiitsuliortumilu	eqqumiitsuliortoq<enta<Lokalisl+LU
eqqumiitsuliortumiuna	eqqumiitsuliortoq<enta<Lokalisl+UNA
eqqumiitsuliortuili	eqqumiitsuliortoq<flertal<hans<Absolut+LI
eqqumiitsuliortuni	eqqumiitsuliortoq<flertal<Lokalis
eqqumiitsuliortuniissimapput	eqqumiitsuliortoq<flertal<Lokalis+IP+SIMA<Indikativ<de
eqqumiitsuliortoritigit	eqqumiitsuliortoq+GӘ<Imperativ<ViDem
eqqumiitsuliortorisimavagununa	eqqumiitsuliortoq+GӘ+SIMA<Indikativ<ViDem+UNA
eqqumiitsuliortorisaraluartigit	eqqumiitsuliortoq+GӘ+TAR=GALUAR<Imperativ<ViDem
eqqumiitsuliortorisaraluarpakkaana	eqqumiitsuliortoq+GӘ+TAR=GALUAR<Indikativ<JegDem+UNA
eqqumiitsuliortuinnaq	eqqumiitsuliortoq-INNAQ<ental<Absolut
eqqumiitsuliortuinnarnillu	eqqumiitsuliortoq-INNAQ<flertal<Instrumentalis+LU
eqqumiitsuliortuinnalerilaartarlutinguna	eqqumiitsuliortoq-INNAQ-LIRI-LAAR=TAR<Ledsagemåde<de_selv+UNA
eqqumiitsuliortuinnalerillutik	eqqumiitsuliortoq-INNAQ-LIRI<Ledsagemåde<de_selv
eqqumiitsuliortuinnaqannginnerat	eqqumiitsuliortoq-INNAQ-QAR-NNGIT+NIQ<ental<deres
eqqumiitsuliortuinnaqassagaluarnerillu	eqqumiitsuliortoq-INNAQ-QAR-SSA=GALUAR+NIQ<flertal<Absolut+LU
eqqumiitsuliortuinnaagaluarneraana	eqqumiitsuliortoq-INNAQ-U+GALUAR+NIQ<ental<hans<Absolut+UNA
eqqumiitsuliortulik	eqqumiitsuliortoq-LIK<ental<Absolut
eqqumiitsuliortulittununa	eqqumiitsuliortoq-LIK<ental<Aequalis+UNA
eqqumiitsuliortulimmununa	eqqumiitsuliortoq-LIK<ental<Terminalis+UNA
eqqumiitsuliortulii	eqqumiitsuliortoq-LIK<flertal<hans<Absolut
eqqumiitsuliortullit	eqqumiitsuliortoq-LIK<flertal<Relativ
eqqumiitsuliortullilli	eqqumiitsuliortoq-LIK<flertal<Relativ+LI
eqqumiitsuliortullinuna	eqqumiitsuliortoq-LIK<flertal<Relativ+UNA
eqqumiitsuliortulileriniarporli	eqqumiitsuliortoq-LIK-LIRI+NIAR<Indikativ<han+LI
eqqumiitsuliortulerigaluarpungaana	eqqumiitsuliortoq-LIRI+GALUAR<Indikativ<jeg+UNA
eqqumiitsuliortulerilaarneriuna	eqqumiitsuliortoq-LIRI-LAAR+NIQ<flertal<hans<Absolut+UNA
eqqumiitsuliortuleriniarnatik	eqqumiitsuliortoq-LIRI+NIAR=NNGIT<Ledsagemåde<de_selv
eqqumiitsuliortulerinertullu	eqqumiitsuliortoq-LIRI+NIQ<ental<Aequalis+LU
eqqumiitsuliortulerissagaluarneranuna	eqqumiitsuliortoq-LIRI-SSA=GALUAR+NIQ<ental<deres+UNA
eqqumiitsuliortulerissapput	eqqumiitsuliortoq-LIRI-SSA<Indikativ<de
eqqumiitsuliortulerisarlutik	eqqumiitsuliortoq-LIRI+TAR<Ledsagemåde<de_selv
eqqumiitsuliortormiunngorsimasartunga	eqqumiitsuliortoq+MIU-NNGUR+SIMA=TAR<Participium<jeg
eqqumiitsuliortormioqarporlu	eqqumiitsuliortoq+MIU-QAR<Indikativ<han+LU
eqqumiitsuliortormioqarneruna	eqqumiitsuliortoq+MIU-QAR+NIQ+UNA
eqqumiitsuliortormiuusut	eqqumiitsuliortoq+MIU-U<Participium<de
eqqumiitsuliortormiuussaagununa	eqqumiitsuliortoq+MIU-U-SSA<Indikativ<vi+UNA
eqqumiitsuliortunngorpugut	eqqumiitsuliortoq-NNGUR<Indikativ<vi
eqqumiitsuliortunngorpugullu	eqqumiitsuliortoq-NNGUR<Indikativ<vi+LU
eqqumiitsuliortunngorpit	eqqumiitsuliortoq-NNGUR<Interrogativ<du
eqqumiitsuliortunngulaartarpunga	eqqumiitsuliortoq-NNGUR-LAAR=TAR<Indikativ<jeg
eqqumiitsuliortunngornerni	eqqumiitsuliortoq-NNGUR+NIQ<flertal<Lokalis
eqqumiitsuliortunngornatilli	eqqumiitsuliortoq-NNGUR-NNGIT<Ledsagemåde<de_selv+LI
eqqumiitsuliortunngussagaluarpit	eqqumiitsuliortoq-NNGUR-SSA=GALUAR<Interrogativ<du
eqqumiitsuliortunngussappununa	eqqumiitsuliortoq-NNGUR-SSA<Indikativ<de+UNA
eqqumiitsuliortorpassuilli	eqqumiitsuliortoq+PASSUAQ<flertal<Absolut+LI
eqqumiitsuliortorpassuillu	eqqumiitsuliortoq+PASSUAQ<flertal<Absolut+LU
eqqumiitsuliortorpassuarni	eqqumiitsuliortoq+PASSUAQ<flertal<Lokalis
eqqumiitsuliortorpassuarniissaaruna	eqqumiitsuliortoq+PASSUAQ<flertal<Lokalis+IP-SSA<Indikativ<han+UNA
eqqumiitsuliortorpassuarnili	eqqumiitsuliortoq+PASSUAQ<flertal<Lokalis+LI
eqqumiitsuliortoqarpugulli	eqqumiitsuliortoq-QAR<Indikativ<vi+LI
eqqumiitsuliortoqarpit	eqqumiitsuliortoq-QAR<Interrogativ<du
eqqumiitsuliortoqalaarput	eqqumiitsuliortoq-QAR-LAAR<Indikativ<de
eqqumiitsuliortoqalaarpit	eqqumiitsuliortoq-QAR-LAAR<Interrogativ<du
eqqumiitsuliortoqalaarlutik	eqqumiitsuliortoq-QAR-LAAR<Ledsagemåde<de_selv
eqqumiitsuliortoqalaarneq	eqqumiitsuliortoq-QAR-LAAR+NIQ<ental<Absolut
eqqumiitsuliortoqalaarnerat	eqqumiitsuliortoq-QAR-LAAR+NIQ<ental<deres
eqqumiitsuliortoqalaarneraana	eqqumiitsuliortoq-QAR-LAAR+NIQ<ental<hans<Absolut+UNA
eqqumiitsuliortoqalaartarpunga	eqqumiitsuliortoq-QAR-LAAR=TAR<Indikativ<jeg
eqqumiitsuliortoqalaartarneriuna	eqqumiitsuliortoq-QAR-LAAR=TAR+NIQ<flertal<hans<Absolut+UNA
eqqumiitsuliortoqalaartartungaana	eqqumiitsuliortoq-QAR-LAAR=TAR<Participium<jeg+UNA
eqqumiitsuliortoqarniartullu	eqqumiitsuliortoq-QAR+NIAR<Participium<de+LU
eqqumiitsuliortoqanngilatit	eqqumiitsuliortoq-QAR-NNGIT<Interrogativ<du
eqqumiitsuliortoqannginnerlu	eqqumiitsuliortoq-QAR-NNGIT+NIQ<ental<Absolut+LU
eqqumiitsuliortoqannginneraana	eqqumiitsuliortoq-QAR-NNGIT+NIQ<ental<hans<Absolut+UNA
eqqumiitsuliortoqarsimanerallu	eqqumiitsuliortoq-QAR+SIMA+NIQ<ental<deres+LU
eqqumiitsuliortoqassaarli	eqqumiitsuliortoq-QAR-SSA<Indikativ<han+LI
eqqumiitsuliortoqassallutik	eqqumiitsuliortoq-QAR-SSA<Ledsagemåde<de_selv
eqqumiitsuliortoqassasullu	eqqumiitsuliortoq-QAR-SSA<Participium<de+LU
eqqumiitsuliortoqartartoq	eqqumiitsuliortoq-QAR+TAR<Participium<han
eqqumiitsuliortoqartartoruna	eqqumiitsuliortoq-QAR+TAR<Participium<han+UNA
eqqumiitsuliortuugaluartunga	eqqumiitsuliortoq-U+GALUAR<Participium<jeg
eqqumiitsuliortuulaartartoq	eqqumiitsuliortoq-U-LAAR=TAR<Participium<han
eqqumiitsuliortuuniarnatik	eqqumiitsuliortoq-U+NIAR=NNGIT<Ledsagemåde<de_selv
eqqumiitsuliortuusinnaavugununa	eqqumiitsuliortoq-U+SINNAA<Indikativ<vi+UNA
eqqumiitsuliortuussagaluarnerni	eqqumiitsuliortoq-U-SSA=GALUAR+NIQ<flertal<Lokalis
Esbjerg	Esbjerg<Absolut
Esbjergili	Esbjerg<Absolut+LI
Esbjergilu	Esbjerg<Absolut+LU
Esbjergiuna	Esbjerg<Absolut+UNA
Esbjergimik	Esbjerg<Instrumentalis
Esbjergimilli	Esbjerg<Instrumentalis+LI
Esbjergimillu	Esbjerg<Instrumentalis+LU
Esbjergiminguna	Esbjerg<Instrumentalis+UNA
Esbjergimi	Esbjerg<Lokalis
Esbjergimili	Esbjerg<Lokalis+LI
Esbjergimilu	Esbjerg<Lokalis+LU
Esbjergimiuna	Esbjerg<Lokalis+UNA
Esbjergimiu	Esbjerg+MIU<ental<Absolut
Esbjergimiumi	Esbjerg+MIU<ental<Lokalis
Esbjergimiumut	Esbjerg+MIU<ental<Terminalis
Esbjergimiumulli	Esbjerg+MIU<ental<Terminalis+LI
Esbjergimiumununa	Esbjerg+MIU<ental<Terminalis+UNA
Esbjergimiunik	Esbjerg+MIU<flertal<Instrumentalis
Esbjergimiunilli	Esbjerg+MIU<flertal<Instrumentalis+LI
Esbjergimiuninguna	Esbjerg+MIU<flertal<Instrumentalis+UNA
Esbjergimiuni	Esbjerg+MIU<flertal<Lokalis
Esbjergimiunili	Esbjerg+MIU<flertal<Lokalis+LI
Esbjergimiuniuna	Esbjerg+MIU<flertal<Lokalis+UNA
Esbjergimiulerigaluartoq	Esbjerg+MIU-LIRI+GALUAR<Participium<han
Esbjergimiulerivit	Esbjerg+MIU-LIRI<Interrogativ<du
Esbjergimiulerilaartunga	Esbjerg+MIU-LIRI-LAAR<Participium<jeg
Esbjergimiuleriniarpit	Esbjerg+MIU-LIRI+NIAR<Interrogativ<du
Esbjergimiulerinianngilagut	Esbjerg+MIU-LIRI+NIAR=NNGIT<Indikativ<vi
Esbjergimiulerinerinuna	Esbjerg+MIU-LIRI+NIQ<flertal<Absolut+UNA
Esbjergimiulerisorlu	Esbjerg+MIU-LIRI<Participium<han+LU
Esbjergimiulerisaraluartununa	Esbjerg+MIU-LIRI+TAR=GALUAR<Participium<de+UNA
Esbjergimiulerisarpugununa	Esbjerg+MIU-LIRI+TAR<Indikativ<vi+UNA
Esbjergimiunngorpoq	Esbjerg+MIU-NNGUR<Indikativ<han
Esbjergimiunngorporuna	Esbjerg+MIU-NNGUR<Indikativ<han+UNA
Esbjergimiunngulaarpit	Esbjerg+MIU-NNGUR-LAAR<Interrogativ<du
Esbjergimiunngulaartarlutinguna	Esbjerg+MIU-NNGUR-LAAR=TAR<Ledsagemåde<de_selv+UNA
Esbjergimiunngorniarnatinguna	Esbjerg+MIU-NNGUR+NIAR=NNGIT<Ledsagemåde<de_selv+UNA
Esbjergimiunngunnginnera	Esbjerg+MIU-NNGUR-NNGIT+NIQ<ental<hans<Absolut
Esbjergimiunngorsimavungaana	Esbjerg+MIU-NNGUR+SIMA<Indikativ<jeg+UNA
Esbjergimioqarpoq	Esbjerg+MIU-QAR<Indikativ<han
Esbjergimioqarporli	Esbjerg+MIU-QAR<Indikativ<han+LI
Esbjergimioqarporlu	Esbjerg+MIU-QAR<Indikativ<han+LU
Esbjergimioqarporuna	Esbjerg+MIU-QAR<Indikativ<han+UNA
Esbjergimioqarneq	Esbjerg+MIU-QAR+NIQ
Esbjergimioqarnerlu	Esbjerg+MIU-QAR+NIQ+LU
Esbjergimioqarneruna	Esbjerg+MIU-QAR+NIQ+UNA
Esbjergimioqartoq	Esbjerg+MIU-QAR<Participium<han
Esbjergimioqartorli	Esbjerg+MIU-QAR<Participium<han+LI
Esbjergimioqartorlu	Esbjerg+MIU-QAR<Participium<han+LU
Esbjergimioqartoruna	Esbjerg+MIU-QAR<Participium<han+UNA
Esbjergimiuugaluarlutillu	Esbjerg+MIU-U+GALUAR<Ledsagemåde<de_selv+LU
Esbjergimiuuit	Esbjerg+MIU-U<Interrogativ<du
Esbjergimiuulaarlutillu	Esbjerg+MIU-U-LAAR<Ledsagemåde<de_selv+LU
Esbjergimiuulaarnerniissinnaasut	Esbjerg+MIU-U-LAAR+NIQ<flertal<Lokalis+IP+SINNAA<Participium<de
Esbjergimiuulaartarpugulli	Esbjerg+MIU-U-LAAR=TAR<Indikativ<vi+LI
Esbjergimiuulaartartununa	Esbjerg+MIU-U-LAAR=TAR<Participium<de+UNA
Esbjergimiuullutinguna	Esbjerg+MIU-U<Ledsagemåde<de_selv+UNA
Esbjergimiuunianngillanuna	Esbjerg+MIU-U+NIAR=NNGIT<Indikativ<de+UNA
Esbjergimiuunianngitsoruna	Esbjerg+MIU-U+NIAR=NNGIT<Participium<han+UNA
Esbjergimiuuneranuna	Esbjerg+MIU-U+NIQ<ental<deres+UNA
Esbjergimiuusut	Esbjerg+MIU-U<Participium<de
Esbjergimiuusununa	Esbjerg+MIU-U<Participium<de+UNA
Esbjergimiuusoruna	Esbjerg+MIU-U<Participium<han+UNA
Esbjergimiuusunga	Esbjerg+MIU-U<Participium<jeg
Esbjergimiuusimavit	Esbjerg+MIU-U+SIMA<Interrogativ<du
Esbjergimiuusimallutik	Esbjerg+MIU-U+SIMA<Ledsagemåde<de_selv
Esbjergimiuusimasarput	Esbjerg+MIU-U+SIMA=TAR<Indikativ<de
Esbjergimiuusimasarneralli	Esbjerg+MIU-U+SIMA=TAR+NIQ<ental<deres+LI
Esbjergimiuusimasartorli	Esbjerg+MIU-U+SIMA=TAR<Participium<han+LI
Esbjergimiuusinnaavit	Esbjerg+MIU-U+SINNAA<Interrogativ<du
Esbjergimiuusinnaasungali	Esbjerg+MIU-U+SINNAA<Participium<jeg+LI
Esbjergimiuussagaluartunga	Esbjerg+MIU-U-SSA=GALUAR<Participium<jeg
Esbjergimiuussaagulli	Esbjerg+MIU-U-SSA<Indikativ<vi+LI
Esbjergimiuussasununa	Esbjerg+MIU-U-SSA<Participium<de+UNA
Esbjergimiuusaraluarpungali	Esbjerg+MIU-U+TAR=GALUAR<Indikativ<jeg+LI
Esbjergimiuusaraluarlutik	Esbjerg+MIU-U+TAR=GALUAR<Ledsagemåde<de_selv
Esbjergimiuusarpoq	Esbjerg+MIU-U+TAR<Indikativ<han
Esbjergimut	Esbjerg<Terminalis
Esbjergimulli	Esbjerg<Terminalis+LI
Esbjergimullu	Esbjerg<Terminalis+LU
Esbjergimununa	Esbjerg<Terminalis+UNA
Finland	Finland<Absolut
Finlandili	Finland<Absolut+LI
Finlandilu	Finland<Absolut+LU
Finlandiuna	Finland<Absolut+UNA
Finlandimik	Finland<Instrumentalis
Finlandimilli	Finland<Instrumentalis+LI
Finlandimillu	Finland<Instrumentalis+LU
Finlandiminguna	Finland<Instrumentalis+UNA
Finlandimi	Finland<Lokalis
Finlandimili	Finland<Lokalis+LI
Finlandimilu	Finland<Lokalis+LU
Finlandimiuna	Finland<Lokalis+UNA
Finlandimiu	Finland+MIU<ental<Absolut
Finlandimiuuna	Finland+MIU<ental<Absolut+UNA
Finlandimiumik	Finland+MIU<ental<Instrumentalis
Finlandimiumilli	Finland+MIU<ental<Instrumentalis+LI
Finlandimiuminguna	Finland+MIU<ental<Instrumentalis+UNA
Finlandimiumi	Finland+MIU<ental<Lokalis
Finlandimiumili	Finland+MIU<ental<Lokalis+LI
Finlandimiunilli	Finland+MIU<flertal<Instrumentalis+LI
Finlandimiunillu	Finland+MIU<flertal<Instrumentalis+LU
Finlandimiuninguna	Finland+MIU<flertal<Instrumentalis+UNA
Finlandimiuni	Finland+MIU<flertal<Lokalis
Finlandimiunili	Finland+MIU<flertal<Lokalis+LI
Finlandimiulerigaluarlutinguna	Finland+MIU-LIRI+GALUAR<Ledsagemåde<de_selv+UNA
Finlandimiulerillutik	Finland+MIU-LIRI<Ledsagemåde<de_selv
Finlandimiulerinerallu	Finland+MIU-LIRI+NIQ<ental<deres+LU
Finlandimiulerinngitsut	Finland+MIU-LIRI-NNGIT<Participium<de
Finlandimiunngoraluarnerinuna	Finland+MIU-NNGUR+GALUAR+NIQ<flertal<Absolut+UNA
Finlandimiunngulaarpugulli	Finland+MIU-NNGUR-LAAR<Indikativ<vi+LI
Finlandimiunngortununa	Finland+MIU-NNGUR<Participium<de+UNA
Finlandimiunngorsinnaappununa	Finland+MIU-NNGUR+SINNAA<Indikativ<de+UNA
Finlandimiunngussagaluarlutik	Finland+MIU-NNGUR-SSA=GALUAR<Ledsagemåde<de_selv
Finlandimiunngussagaluarnernik	Finland+MIU-NNGUR-SSA=GALUAR+NIQ<flertal<Instrumentalis
Finlandimiunngortaraluarnerit	Finland+MIU-NNGUR+TAR=GALUAR+NIQ<flertal<Relativ
Finlandimiunngortartununa	Finland+MIU-NNGUR+TAR<Participium<de+UNA
Finlandimioqarpoq	Finland+MIU-QAR<Indikativ<han
Finlandimioqarporli	Finland+MIU-QAR<Indikativ<han+LI
Finlandimioqarporlu	Finland+MIU-QAR<Indikativ<han+LU
Finlandimioqarporuna	Finland+MIU-QAR<Indikativ<han+UNA
Finlandimioqarneq	Finland+MIU-QAR+NIQ
Finlandimioqarnerli	Finland+MIU-QAR+NIQ+LI
Finlandimioqarnerlu	Finland+MIU-QAR+NIQ+LU
Finlandimioqarneruna	Finland+MIU-QAR+NIQ+UNA
Finlandimioqartoq	Finland+MIU-QAR<Participium<han
Finlandimioqartorli	Finland+MIU-QAR<Participium<han+LI
Finlandimioqartorlu	Finland+MIU-QAR<Participium<han+LU
Finlandimioqartoruna	Finland+MIU-QAR<Participium<han+UNA
Finlandimiuugaluarlutillu	Finland+MIU-U+GALUAR<Ledsagemåde<de_selv+LU
Finlandimiuugaluartunga	Finland+MIU-U+GALUAR<Participium<jeg
Finlandimiuugaluartungaana	Finland+MIU-U+GALUAR<Participium<jeg+UNA
Finlandimiuuvorli	Finland+MIU-U<Indikativ<han+LI
Finlandimiuuvorlu	Finland+MIU-U<Indikativ<han+LU
Finlandimiuuvoruna	Finland+MIU-U<Indikativ<han+UNA
Finlandimiuuit	Finland+MIU-U<Interrogativ<du
Finlandimiuulaarpugulli	Finland+MIU-U-LAAR<Indikativ<vi+LI
Finlandimiuulaarpit	Finland+MIU-U-LAAR<Interrogativ<du
Finlandimiuulaarneralli	Finland+MIU-U-LAAR+NIQ<ental<deres+LI
Finlandimiuulaartarneri	Finland+MIU-U-LAAR=TAR+NIQ<flertal<hans<Absolut
Finlandimiuulaartartoruna	Finland+MIU-U-LAAR=TAR<Participium<han+UNA
Finlandimiuullutik	Finland+MIU-U<Ledsagemåde<de_selv
Finlandimiuuniarpungali	Finland+MIU-U+NIAR<Indikativ<jeg+LI
Finlandimiuuniarlutik	Finland+MIU-U+NIAR<Ledsagemåde<de_selv
Finlandimiuuniarnatilli	Finland+MIU-U+NIAR=NNGIT<Ledsagemåde<de_selv+LI
Finlandimiuunianngitsullu	Finland+MIU-U+NIAR=NNGIT<Participium<de+LU
Finlandimiuuneraana	Finland+MIU-U+NIQ<ental<hans<Absolut+UNA
Finlandimiuunatilli	Finland+MIU-U-NNGIT<Ledsagemåde<de_selv+LI
Finlandimiuunatinguna	Finland+MIU-U-NNGIT<Ledsagemåde<de_selv+UNA
Finlandimiuusungalu	Finland+MIU-U<Participium<jeg+LU
Finlandimiuusimavunga	Finland+MIU-U+SIMA<Indikativ<jeg
Finlandimiuusimavugut	Finland+MIU-U+SIMA<Indikativ<vi
Finlandimiuusimasungali	Finland+MIU-U+SIMA<Participium<jeg+LI
Finlandimiuusimasungaana	Finland+MIU-U+SIMA<Participium<jeg+UNA
Finlandimiuusimasarpununa	Finland+MIU-U+SIMA=TAR<Indikativ<de+UNA
Finlandimiuusimasarpunga	Finland+MIU-U+SIMA=TAR<Indikativ<jeg
Finlandimiuusimasarlutilli	Finland+MIU-U+SIMA=TAR<Ledsagemåde<de_selv+LI
Finlandimiuusimasarneranuna	Finland+MIU-U+SIMA=TAR+NIQ<ental<deres+UNA
Finlandimiuusimasartungalu	Finland+MIU-U+SIMA=TAR<Participium<jeg+LU
Finlandimiuusinnaaneraana	Finland+MIU-U+SINNAA+NIQ<ental<hans<Absolut+UNA
Finlandimiuussappununa	Finland+MIU-U-SSA<Indikativ<de+UNA
Finlandimiuusarlutinguna	Finland+MIU-U+TAR<Ledsagemåde<de_selv+UNA
Finlandimut	Finland<Terminalis
Finlandimulli	Finland<Terminalis+LI
Finlandimullu	Finland<Terminalis+LU
Finlandimununa	Finland<Terminalis+UNA
Gentofte	Gentofte<Absolut
Gentofteli	Gentofte<Absolut+LI
Gentoftelu	Gentofte<Absolut+LU
Gentofteuna	Gentofte<Absolut+UNA
Gentoftemik	Gentofte<Instrumentalis
Gentoftemilli	Gentofte<Instrumentalis+LI
Gentoftemillu	Gentofte<Instrumentalis+LU
Gentofteminguna	Gentofte<Instrumentalis+UNA
Gentoftemi	Gentofte<Lokalis
Gentoftemili	Gentofte<Lokalis+LI
Gentoftemilu	Gentofte<Lokalis+LU
Gentoftemiuna	Gentofte<Lokalis+UNA
Gentoftemiua	Gentofte+MIU<ental<hans<Absolut
Gentoftemiuaana	Gentofte+MIU<ental<hans<Absolut+UNA
Gentoftemiumik	Gentofte+MIU<ental<Instrumentalis
Gentoftemiumilli	Gentofte+MIU<ental<Instrumentalis+LI
Gentoftemiuga	Gentofte+MIU<ental<min<Absolut
Gentoftemiumi	Gentofte+MIU<enta<Lokalisl
Gentoftemiuni	Gentofte+MIU<flertal<Lokalis
Gentoftemiuniinnginneraana	Gentofte+MIU<flertal<Lokalis+IP-NNGIT+NIQ<ental<hans<Absolut+UNA
Gentoftemiulerisunga	Gentofte+MIU-LIRI<Participium<jeg
Gentoftemiulerisarlutinguna	Gentofte+MIU-LIRI+TAR<Ledsagemåde<de_selv+UNA
Gentoftemiunngulaarput	Gentofte+MIU-NNGUR-LAAR<Indikativ<de
Gentoftemiunngulaartartoq	Gentofte+MIU-NNGUR-LAAR=TAR<Participium<han
Gentoftemiunngorlutinguna	Gentofte+MIU-NNGUR<Ledsagemåde<de_selv+UNA
Gentoftemiunngunngitsungalu	Gentofte+MIU-NNGUR-NNGIT<Participium<jeg+LU
Gentoftemiunngorsimasarpit	Gentofte+MIU-NNGUR+SIMA=TAR<Interrogativ<du
Gentoftemiunngussagaluarporlu	Gentofte+MIU-NNGUR-SSA=GALUAR<Indikativ<han+LU
Gentoftemiunngussagaluarlutilli	Gentofte+MIU-NNGUR-SSA=GALUAR<Ledsagemåde<de_selv+LI
Gentoftemut	Gentofte<Terminalis
Gentoftemulli	Gentofte<Terminalis+LI
Gentoftemullu	Gentofte<Terminalis+LU
Gentoftemununa	Gentofte<Terminalis+UNA
ilaa	ilaa<Partikel
ilami	ila<enta<Lokalisl
ilani	ila<flertal<Lokalis
ilagisinnaavassiuna	ila+GӘ+SINNAA<Indikativ<JegJer+UNA
ilaannaanuna	ila-INNAQ<flertal<Relativ+UNA
ilaannaqarsimallutinguna	ila-INNAQ-QAR+SIMA<Ledsagemåde<de_selv+UNA
ilalerinatik	ila-LIRI-NNGIT<Ledsagemåde<de_selv
ilamiunik	ila+MIU<flertal<Instrumentalis
ilamiuulaarneruna	ila+MIU-U-LAAR+NIQ<ental<Absolut+UNA
ilanngussasulli	ila-NNGUR-SSA<Participium<de+LI
ilaqassagaluartullu	ila-QAR-SSA=GALUAR<Participium<de+LU
ilaqassavit	ila-QAR-SSA<Interrogativ<du
ilaqutariinnilli	ilaqutariit<flertal<Instrumentalis+LI
ilaqutariit	ilaqutariit<flertal<Relativ
ilaqutariimmioqarpoq	ilaqutariit+MIU-QAR<Indikativ<han
ilaanianngilangaana	ila-U+NIAR=NNGIT<Indikativ<jeg+UNA
ilinnialaarneri	ilinniar-LAAR+NIQ<flertal<hans<Absolut
ilinnialaartoruna	ilinniar-LAAR<Participium<han+UNA
ilinnialaartarpununa	ilinniar-LAAR=TAR<Indikativ<de+UNA
ilinnianngillat	ilinniar-NNGIT<Indikativ<de
ilinnianngilanga	ilinniar-NNGIT<Indikativ<jeg
ilinniartununa	ilinniar<Participium<de+UNA
ilinniartoq	ilinniar<Participium<han
ilinniassagaluarneranuna	ilinniar-SSA=GALUAR+NIQ<ental<deres+UNA
ilinniartaraluarnermut	ilinniar+TAR=GALUAR+NIQ<ental<Terminalis
Ilisimatusarfik	Ilisimatusarfik<ental<Absolut
Ilisimatusarfilli	Ilisimatusarfik<ental<Absolut+LI
Ilisimatusarfiaana	Ilisimatusarfik<ental<hans<Absolut+UNA
Ilisimatusarfimmilli	Ilisimatusarfik<ental<Instrumentalis+LI
Ilisimatusarfinnik	Ilisimatusarfik<flertal<Instrumentalis
Ilisimatusarfinnilli	Ilisimatusarfik<flertal<Instrumentalis+LI
Ilisimatusarfinniittaraluarpunga	Ilisimatusarfik<flertal<Lokalis+IP+TAR=GALUAR<Indikativ<jeg
Ilisimatusarfigitigit	Ilisimatusarfik+GӘ<Imperativ<ViDem
Ilisimatusarfigisimasartigilli	Ilisimatusarfik+GӘ+SIMA=TAR<Imperativ<ViDem+LI
Ilisimatusarfigisinnaatigit	Ilisimatusarfik+GӘ+SINNAA<Imperativ<ViDem
Ilisimatusarfigissaviuk	Ilisimatusarfik+GӘ-SSA<Interrogativ<DuHam
Ilisimatusarfilinngulaartarpunga	Ilisimatusarfik-LIK-NNGUR-LAAR=TAR<Indikativ<jeg
Ilisimatusarfimmiunngulaarpit	Ilisimatusarfik+MIU-NNGUR-LAAR<Interrogativ<du
Ilisimatusarfinngunnginnerilli	Ilisimatusarfik-NNGUR-NNGIT+NIQ<flertal<Relativ+LI
Ilisimatusarfippassuarniinngilatit	Ilisimatusarfik+PASSUAQ<flertal<Lokalis+IP-NNGIT<Interrogativ<du
Ilisimatusarfeqalaartorli	Ilisimatusarfik-QAR-LAAR<Participium<han+LI
Ilisimatusarfeqalaartarpoq	Ilisimatusarfik-QAR-LAAR=TAR<Indikativ<han
Ilisimatusarfeqalaartarnerli	Ilisimatusarfik-QAR-LAAR=TAR+NIQ+LI
Ilisimatusarfeqalaartarneruna	Ilisimatusarfik-QAR-LAAR=TAR+NIQ+UNA
Ilisimatusarfeqarnerlu	Ilisimatusarfik-QAR+NIQ+LU
Ilisimatusarfeqanngilarli	Ilisimatusarfik-QAR-NNGIT<Indikativ<han+LI
Ilisimatusarfeqanngilaruna	Ilisimatusarfik-QAR-NNGIT<Indikativ<han+UNA
Ilisimatusarfeqannginneq	Ilisimatusarfik-QAR-NNGIT+NIQ<ental<Absolut
Ilisimatusarfeqarsimasartorli	Ilisimatusarfik-QAR+SIMA=TAR<Participium<han+LI
Ilisimatusarfeqassagaluarporli	Ilisimatusarfik-QAR-SSA=GALUAR<Indikativ<han+LI
Ilisimatusarfeqassagaluarnerlu	Ilisimatusarfik-QAR-SSA=GALUAR+NIQ+LU
Ilisimatusarfeqassasorlu	Ilisimatusarfik-QAR-SSA<Participium<han+LU
Ilisimatusarfeqartarnerli	Ilisimatusarfik-QAR+TAR+NIQ+LI
Ilisimatusarfiusimasarporuna	Ilisimatusarfik-U+SIMA=TAR<Indikativ<han+UNA
Illoqqortoormiut	Illoqqortoormiut<Absolut
Illoqqortoormiullu	Illoqqortoormiut<Absolut+LU
Illoqqortoormiununa	Illoqqortoormiut<Absolut+UNA
Illoqqortoormiunilli	Illoqqortoormiut<Instrumentalis+LI
Illoqqortoormiunillu	Illoqqortoormiut<Instrumentalis+LU
Illoqqortoormiuninguna	Illoqqortoormiut<Instrumentalis+UNA
Illoqqortoormiuni	Illoqqortoormiut<Lokalis
Illoqqortoormiunili	Illoqqortoormiut<Lokalis+LI
Illoqqortoormiunilu	Illoqqortoormiut<Lokalis+LU
Illoqqortoormiormiu	Illoqqortoormiut+MIU<ental<Absolut
Illoqqortoormiormiuuna	Illoqqortoormiut+MIU<ental<Absolut+UNA
Illoqqortoormiormiunik	Illoqqortoormiut+MIU<flertal<Instrumentalis
Illoqqortoormiormiunillu	Illoqqortoormiut+MIU<flertal<Instrumentalis+LU
Illoqqortoormiormiunngulaarnermullu	Illoqqortoormiut+MIU-NNGUR-LAAR+NIQ<ental<Terminalis+LU
Illoqqortoormiormioqarporli	Illoqqortoormiut+MIU-QAR<Indikativ<han+LI
Illoqqortoormiormioqarporuna	Illoqqortoormiut+MIU-QAR<Indikativ<han+UNA
Illoqqortoormiormioqarnerlu	Illoqqortoormiut+MIU-QAR+NIQ+LU
Illoqqortoormiormioqarneruna	Illoqqortoormiut+MIU-QAR+NIQ+UNA
Illoqqortoormiormioqartoq	Illoqqortoormiut+MIU-QAR<Participium<han
Illoqqortoormiormioqartorli	Illoqqortoormiut+MIU-QAR<Participium<han+LI
Illoqqortoormiormioqartoruna	Illoqqortoormiut+MIU-QAR<Participium<han+UNA
Illoqqortoormiormiuulaartunga	Illoqqortoormiut+MIU-U-LAAR<Participium<jeg
Illoqqortoormiormiuuneq	Illoqqortoormiut+MIU-U+NIQ<ental<Absolut
Illoqqortoormiormiuunerni	Illoqqortoormiut+MIU-U+NIQ<flertal<Lokalis
Illoqqortoormiormiuusimasarpit	Illoqqortoormiut+MIU-U+SIMA=TAR<Interrogativ<du
Illoqqortoormiormiuusimasarlutik	Illoqqortoormiut+MIU-U+SIMA=TAR<Ledsagemåde<de_selv
Illoqqortoormiormiuussagaluarpit	Illoqqortoormiut+MIU-U-SSA=GALUAR<Interrogativ<du
illugitigit	illu+GӘ<Imperativ<ViDem
illulerineri	illu-LIRI+NIQ<flertal<hans<Absolut
illulerinernununa	illu-LIRI+NIQ<flertal<Terminalis+UNA
illunngoraluartungaana	illu-NNGUR+GALUAR<Participium<jeg+UNA
illunngussallutinguna	illu-NNGUR-SSA<Ledsagemåde<de_selv+UNA
illorpassuit	illu+PASSUAQ<flertal<Absolut
illorpassuillu	illu+PASSUAQ<flertal<Absolut+LU
illorpassuili	illu+PASSUAQ<flertal<hans<Absolut+LI
illorpassuarni	illu+PASSUAQ<flertal<Lokalis
illoqalaarpit	illu-QAR-LAAR<Interrogativ<du
illoqalaartungalu	illu-QAR-LAAR<Participium<jeg+LU
illoqalaartarlutillu	illu-QAR-LAAR=TAR<Ledsagemåde<de_selv+LU
illoqanngillalli	illu-QAR-NNGIT<Indikativ<de+LI
illoqanngilangali	illu-QAR-NNGIT<Indikativ<jeg+LI
illoqassavit	illu-QAR-SSA<Interrogativ<du
Ilulissat	Ilulissat<Absolut
Ilulissalli	Ilulissat<Absolut+LI
Ilulissanik	Ilulissat<Instrumentalis
Ilulissani	Ilulissat<Lokalis
Ilulissanili	Ilulissat<Lokalis+LI
Ilulissanilu	Ilulissat<Lokalis+LU
Ilulissaniuna	Ilulissat<Lokalis+UNA
Iluliarmiumilli	Ilulissat+MIU<ental<Instrumentalis+LI
Iluliarmiunillu	Ilulissat+MIU<flertal<Instrumentalis+LU
Iluliarmiulerigaluartungali	Ilulissat+MIU-LIRI+GALUAR<Participium<jeg+LI
Iluliarmiulerisimavit	Ilulissat+MIU-LIRI+SIMA<Interrogativ<du
Iluliarmioqarporli	Ilulissat+MIU-QAR<Indikativ<han+LI
Iluliarmioqarnerli	Ilulissat+MIU-QAR+NIQ+LI
Iluliarmioqarneruna	Ilulissat+MIU-QAR+NIQ+UNA
Iluliarmioqartoruna	Ilulissat+MIU-QAR<Participium<han+UNA
Iluliarmiuunatik	Ilulissat+MIU-U-NNGIT<Ledsagemåde<de_selv
Iluliarmiuusinnaavit	Ilulissat+MIU-U+SINNAA<Interrogativ<du
imaakkaluarpit	imaap+GALUAR<Interrogativ<du
imaakkaluarneri	imaap+GALUAR+NIQ<flertal<hans<Absolut
imaakkaluartut	imaap+GALUAR<Participium<de
imaakkaluartorli	imaap+GALUAR<Participium<han+LI
imaappungalu	imaap<Indikativ<jeg+LU
imaappit	imaap<Interrogativ<du
imaalaarnermut	imaap-LAAR+NIQ<ental<Terminalis
imaalaartartut	imaap-LAAR=TAR<Participium<de
imaallutik	imaap<Ledsagemåde<de_selv
imaallutilli	imaap<Ledsagemåde<de_selv+LI
imaallutinguna	imaap<Ledsagemåde<de_selv+UNA
imaanniarpit	imaap+NIAR<Interrogativ<du
imaanniannginneq	imaap+NIAR=NNGIT+NIQ<ental<Absolut
imaannatik	imaap-NNGIT<Ledsagemåde<de_selv
imaattoq	imaap<Participium<han
imaattunga	imaap<Participium<jeg
imaassimavit	imaap+SIMA<Interrogativ<du
imaassimanerniillutilli	imaap+SIMA+NIQ<flertal<Lokalis+IP<Ledsagemåde<de_selv+LI
imaassimasut	imaap+SIMA<Participium<de
imaassinnaavit	imaap+SINNAA<Interrogativ<du
imaassinnaallutillu	imaap+SINNAA<Ledsagemåde<de_selv+LU
imaassinnaallutinguna	imaap+SINNAA<Ledsagemåde<de_selv+UNA
imaassagaluarlutik	imaap-SSA=GALUAR<Ledsagemåde<de_selv
imaassappulli	imaap-SSA<Indikativ<de+LI
imaattaraluartorli	imaap+TAR=GALUAR<Participium<han+LI
imaattarput	imaap+TAR<Indikativ<de
imaattarlutillu	imaap+TAR<Ledsagemåde<de_selv+LU
imaattartoq	imaap+TAR<Participium<han
immikkoortumili	immikkoortoq<enta<Lokalisl+LI
immikkoortui	immikkoortoq<flertal<hans<Absolut
immikkoortullit	immikkoortoq-LIK<flertal<Absolut
immikkoortulilerilaarpit	immikkoortoq-LIK-LIRI-LAAR<Interrogativ<du
immikkoortormioqarnerli	immikkoortoq+MIU-QAR+NIQ+LI
immikkoortoqalaarlutinguna	immikkoortoq-QAR-LAAR<Ledsagemåde<de_selv+UNA
immikkoortoqarnianngilatit	immikkoortoq-QAR+NIAR=NNGIT<Interrogativ<du
immikkut	immikkut<Partikel
immikkulli	immikkut<Partikel+LI
immikkullu	immikkut<Partikel+LU
immikkununa	immikkut<Partikel+UNA
inunngoraluarpit	inunngor+GALUAR<Interrogativ<du
inunngorpulli	inunngor<Indikativ<de+LI
inunngorporli	inunngor<Indikativ<han+LI
inunngorpit	inunngor<Interrogativ<du
inunngulaarpit	inunngor-LAAR<Interrogativ<du
inunngulaarlutinguna	inunngor-LAAR<Ledsagemåde<de_selv+UNA
inunngulaarneq	inunngor-LAAR+NIQ<ental<Absolut
inunngulaarneri	inunngor-LAAR+NIQ<flertal<hans<Absolut
inunngulaarnernilli	inunngor-LAAR+NIQ<flertal<Instrumentalis+LI
inunngulaartoq	inunngor-LAAR<Participium<han
inunngulaartorlu	inunngor-LAAR<Participium<han+LU
inunngulaartarpunga	inunngor-LAAR=TAR<Indikativ<jeg
inunngulaartarpugut	inunngor-LAAR=TAR<Indikativ<vi
inunngorlutilli	inunngor<Ledsagemåde<de_selv+LI
inunngorniarlutik	inunngor+NIAR<Ledsagemåde<de_selv
inunngornianngilarli	inunngor+NIAR=NNGIT<Indikativ<han+LI
inunngornianngilanga	inunngor+NIAR=NNGIT<Indikativ<jeg
inunngorniarnatilli	inunngor+NIAR=NNGIT<Ledsagemåde<de_selv+LI
inunngunngillallu	inunngor-NNGIT<Indikativ<de+LU
inunngunngilanga	inunngor-NNGIT<Indikativ<jeg
inunngunngilagulli	inunngor-NNGIT<Indikativ<vi+LI
inunngunngilagullu	inunngor-NNGIT<Indikativ<vi+LU
inunngunngilatit	inunngor-NNGIT<Interrogativ<du
inunngornatik	inunngor-NNGIT<Ledsagemåde<de_selv
inunngornatillu	inunngor-NNGIT<Ledsagemåde<de_selv+LU
inunngunnginneri	inunngor-NNGIT+NIQ<flertal<hans<Absolut
inunngunngitsorlu	inunngor-NNGIT<Participium<han+LU
inunngortullu	inunngor<Participium<de+LU
inunngortununa	inunngor<Participium<de+UNA
inunngortorli	inunngor<Participium<han+LI
inunngortunga	inunngor<Participium<jeg
inunngorsimasunga	inunngor+SIMA<Participium<jeg
inunngorsimasarporuna	inunngor+SIMA=TAR<Indikativ<han+UNA
inunngorsimasarpit	inunngor+SIMA=TAR<Interrogativ<du
inunngorsimasarnerilli	inunngor+SIMA=TAR+NIQ<flertal<Relativ+LI
inunngorsinnaanerillu	inunngor+SINNAA+NIQ<flertal<Relativ+LU
inunngussagaluarneralli	inunngor-SSA=GALUAR+NIQ<ental<deres+LI
inunngussagaluarnerilli	inunngor-SSA=GALUAR+NIQ<flertal<Absolut+LI
inunngussavit	inunngor-SSA<Interrogativ<du
inunngussallutilli	inunngor-SSA<Ledsagemåde<de_selv+LI
inunngortaraluarpit	inunngor+TAR=GALUAR<Interrogativ<du
inunngortarpit	inunngor+TAR<Interrogativ<du
inunngortarlutilli	inunngor+TAR<Ledsagemåde<de_selv+LI
inunngortartut	inunngor+TAR<Participium<de
isuma	isuma<ental<Absolut
isumali	isuma<ental<Absolut+LI
isumaalu	isuma<ental<hans<Absolut+LU
isumaga	isuma<ental<min<Absolut
isumagaana	isuma<ental<min<Absolut+UNA
isumami	isuma<enta<Lokalisl
isumamiissimallutinguna	isuma<enta<Lokalisl+IP+SIMA<Ledsagemåde<de_selv+UNA
isumamut	isuma<ental<Terminalis
isumamununa	isuma<ental<Terminalis+UNA
isumaalu	isuma<flertal<hans<Absolut+LU
isumaninguna	isuma<flertal<Instrumentalis+UNA
isumaniinneq	isuma<flertal<Lokalis+IP+NIQ<ental<Absolut
isumagivaa	isuma+GӘ<Indikativ<HanHam
isumagilaartartiginuna	isuma+GӘ-LAAR=TAR<Imperativ<ViDem+UNA
isumaginngilakkalu	isuma+GӘ-NNGIT<Indikativ<JegDem+LU
isumagisimasartigit	isuma+GӘ+SIMA=TAR<Imperativ<ViDem
isumaannarniuna	isuma-INNAQ<flertal<Lokalis+UNA
isumallit	isuma-LIK<flertal<Absolut
isumalerippulli	isuma-LIRI<Indikativ<de+LI
isumalerinianngillat	isuma-LIRI+NIAR=NNGIT<Indikativ<de
isumaleriniannginnernili	isuma-LIRI+NIAR=NNGIT+NIQ<flertal<Lokalis+LI
isumamiunik	isuma+MIU<flertal<Instrumentalis
isumamiulerillutik	isuma+MIU-LIRI<Ledsagemåde<de_selv
isumamiulerissapput	isuma+MIU-LIRI-SSA<Indikativ<de
isumamiunngulaartunga	isuma+MIU-NNGUR-LAAR<Participium<jeg
isumamiunngorniarlutilli	isuma+MIU-NNGUR+NIAR<Ledsagemåde<de_selv+LI
isumamioqarpoq	isuma+MIU-QAR<Indikativ<han
isumamioqarporuna	isuma+MIU-QAR<Indikativ<han+UNA
isumamioqarneruna	isuma+MIU-QAR+NIQ+UNA
isumanngulaarlutillu	isuma-NNGUR-LAAR<Ledsagemåde<de_selv+LU
isumanngulaartarlutinguna	isuma-NNGUR-LAAR=TAR<Ledsagemåde<de_selv+UNA
isumanngortunga	isuma-NNGUR<Participium<jeg
isumanngorsimasarpit	isuma-NNGUR+SIMA=TAR<Interrogativ<du
isumanngussagaluarpit	isuma-NNGUR-SSA=GALUAR<Interrogativ<du
isumanngortaraluarpit	isuma-NNGUR+TAR=GALUAR<Interrogativ<du
isumanngortarnermununa	isuma-NNGUR+TAR+NIQ<ental<Terminalis+UNA
isumarpassuarni	isuma+PASSUAQ<flertal<Lokalis
isumaqalaarpungaana	isuma-QAR-LAAR<Indikativ<jeg+UNA
isumaqalaartarpugununa	isumaqar-LAAR=TAR<Indikativ<vi+UNA
isumaqanngilatit	isuma-QAR-NNGIT<Interrogativ<du
isumaqanngitsunga	isumaqar-NNGIT<Participium<jeg
isumaqartut	isumaqar<Participium<de
isumaqarsimasarneq	isuma-QAR+SIMA=TAR+NIQ<ental<Absolut
isumaqarsimasarnerni	isumaqar+SIMA=TAR+NIQ<flertal<Lokalis
isumaqassapput	isumaqar-SSA<Indikativ<de
isumaqassaanga	isumaqar-SSA<Indikativ<jeg
isumaallutilli	isuma-U<Ledsagemåde<de_selv+LI
isumaallutinguna	isuma-U<Ledsagemåde<de_selv+UNA
isumaaniannginneri	isuma-U+NIAR=NNGIT+NIQ<flertal<hans<Absolut
isumaannginnernillu	isuma-U-NNGIT+NIQ<flertal<Instrumentalis+LU
Ivittuut	Ivittuut<Absolut
Ivittuulli	Ivittuut<Absolut+LI
Ivittuullu	Ivittuut<Absolut+LU
Ivittuununa	Ivittuut<Absolut+UNA
Ivittuunik	Ivittuut<Instrumentalis
Ivittuunilli	Ivittuut<Instrumentalis+LI
Ivittuunillu	Ivittuut<Instrumentalis+LU
Ivittuuninguna	Ivittuut<Instrumentalis+UNA
Ivittuuni	Ivittuut<Lokalis
Ivittuunili	Ivittuut<Lokalis+LI
Ivittuunilu	Ivittuut<Lokalis+LU
Ivittuuniuna	Ivittuut<Lokalis+UNA
Ivittoormiu	Ivittuut+MIU<ental<Absolut
Ivittoormiuuna	Ivittuut+MIU<ental<Absolut+UNA
Ivittoormiuminguna	Ivittuut+MIU<ental<Instrumentalis+UNA
Ivittoormiumi	Ivittuut+MIU<ental<Lokalis
Ivittoormiumili	Ivittuut+MIU<ental<Lokalis+LI
Ivittoormiumilu	Ivittuut+MIU<ental<Lokalis+LU
Ivittoormiunik	Ivittuut+MIU<flertal<Instrumentalis
Ivittoormiunilli	Ivittuut+MIU<flertal<Instrumentalis+LI
Ivittoormiunillu	Ivittuut+MIU<flertal<Instrumentalis+LU
Ivittoormiuni	Ivittuut+MIU<flertal<Lokalis
Ivittoormiunili	Ivittuut+MIU<flertal<Lokalis+LI
Ivittoormiuniuna	Ivittuut+MIU<flertal<Lokalis+UNA
Ivittoormiulerisunga	Ivittuut+MIU-LIRI<Participium<jeg
Ivittoormiulerisungaana	Ivittuut+MIU-LIRI<Participium<jeg+UNA
Ivittoormiunngulaarpununa	Ivittuut+MIU-NNGUR-LAAR<Indikativ<de+UNA
Ivittoormiunngorlutilli	Ivittuut+MIU-NNGUR<Ledsagemåde<de_selv+LI
Ivittoormiunngorlutinguna	Ivittuut+MIU-NNGUR<Ledsagemåde<de_selv+UNA
Ivittoormiunngornatik	Ivittuut+MIU-NNGUR-NNGIT<Ledsagemåde<de_selv
Ivittoormiunngornatilli	Ivittuut+MIU-NNGUR-NNGIT<Ledsagemåde<de_selv+LI
Ivittoormiunngornatinguna	Ivittuut+MIU-NNGUR-NNGIT<Ledsagemåde<de_selv+UNA
Ivittoormiunngunngitsunga	Ivittuut+MIU-NNGUR-NNGIT<Participium<jeg
Ivittoormioqarpoq	Ivittuut+MIU-QAR<Indikativ<han
Ivittoormioqarporli	Ivittuut+MIU-QAR<Indikativ<han+LI
Ivittoormioqarporuna	Ivittuut+MIU-QAR<Indikativ<han+UNA
Ivittoormioqarneq	Ivittuut+MIU-QAR+NIQ
Ivittoormioqarnerli	Ivittuut+MIU-QAR+NIQ+LI
Ivittoormioqarnerlu	Ivittuut+MIU-QAR+NIQ+LU
Ivittoormioqarneruna	Ivittuut+MIU-QAR+NIQ+UNA
Ivittoormioqartoq	Ivittuut+MIU-QAR<Participium<han
Ivittoormioqartorli	Ivittuut+MIU-QAR<Participium<han+LI
Ivittoormioqartorlu	Ivittuut+MIU-QAR<Participium<han+LU
Ivittoormioqartoruna	Ivittuut+MIU-QAR<Participium<han+UNA
Ivittoormiuugaluarlutik	Ivittuut+MIU-U+GALUAR<Ledsagemåde<de_selv
Ivittoormiuugaluarlutilli	Ivittuut+MIU-U+GALUAR<Ledsagemåde<de_selv+LI
Ivittoormiuugaluarnera	Ivittuut+MIU-U+GALUAR+NIQ<ental<hans<Absolut
Ivittoormiuugaluartoq	Ivittuut+MIU-U+GALUAR<Participium<han
Ivittoormiuuvorli	Ivittuut+MIU-U<Indikativ<han+LI
Ivittoormiuuit	Ivittuut+MIU-U<Interrogativ<du
Ivittoormiuulaarpit	Ivittuut+MIU-U-LAAR<Interrogativ<du
Ivittoormiuulaartarpoq	Ivittuut+MIU-U-LAAR=TAR<Indikativ<han
Ivittoormiuulaartarlutinguna	Ivittuut+MIU-U-LAAR=TAR<Ledsagemåde<de_selv+UNA
Ivittoormiuullutik	Ivittuut+MIU-U<Ledsagemåde<de_selv
Ivittoormiuuniarpit	Ivittuut+MIU-U+NIAR<Interrogativ<du
Ivittoormiuuniartunga	Ivittuut+MIU-U+NIAR<Participium<jeg
Ivittoormiuunngilatit	Ivittuut+MIU-U-NNGIT<Interrogativ<du
Ivittoormiuunatik	Ivittuut+MIU-U-NNGIT<Ledsagemåde<de_selv
Ivittoormiuunnginnerilli	Ivittuut+MIU-U-NNGIT+NIQ<flertal<Absolut+LI
Ivittoormiuusungalu	Ivittuut+MIU-U<Participium<jeg+LU
Ivittoormiuusimasunga	Ivittuut+MIU-U+SIMA<Participium<jeg
Ivittoormiuusimasarnerilli	Ivittuut+MIU-U+SIMA=TAR+NIQ<flertal<Absolut+LI
Ivittoormiuusinnaavit	Ivittuut+MIU-U+SINNAA<Interrogativ<du
Ivittoormiuusinnaasunga	Ivittuut+MIU-U+SINNAA<Participium<jeg
Ivittoormiuussallutillu	Ivittuut+MIU-U-SSA<Ledsagemåde<de_selv+LU
Ivittoormiuussasoruna	Ivittuut+MIU-U-SSA<Participium<han+UNA
Ivittoormiuusarnermununa	Ivittuut+MIU-U+TAR+NIQ<ental<Terminalis+UNA
kalaaleq	kalaaleq<ental<Absolut
kalaaleruna	kalaaleq<ental<Absolut+UNA
kalaallimillu	kalaaleq<ental<Instrumentalis+LU
kalaallimi	kalaaleq<ental<Lokalis
kalaallimiinngilanga	kalaaleq<ental<Lokalis+IP-NNGIT<Indikativ<jeg
kalaallimilu	kalaaleq<ental<Lokalis+LU
kalaallimut	kalaaleq<ental<Terminalis
kalaallimununa	kalaaleq<ental<Terminalis+UNA
kalaallinilli	kalaaleq<flertal<Instrumentalis+LI
kalaallininguna	kalaaleq<flertal<Instrumentalis+UNA
kalaallini	kalaaleq<flertal<Lokalis
kalaalliniikkaluartungaana	kalaaleq<flertal<Lokalis+IP+GALUAR<Participium<jeg+UNA
kalaallinili	kalaaleq<flertal<Lokalis+LI
kalaalliniuna	kalaaleq<flertal<Lokalis+UNA
kalaalerigaluartigilli	kalaaleq+GӘ+GALUAR<Imperativ<ViDem+LI
kalaaleritiginuna	kalaaleq+GӘ<Imperativ<ViDem+UNA
kalaalerinianngilaat	kalaaleq+GӘ+NIAR=NNGIT<Indikativ<DeHam
kalaalerinianngilaa	kalaaleq+GӘ+NIAR=NNGIT<Indikativ<HanHam
kalaalerissatigillu	kalaaleq+GӘ-SSA<Imperativ<ViDem+LU
kalaalerisaraluartigillu	kalaaleq+GӘ+TAR=GALUAR<Imperativ<ViDem+LU
kalaaliinnaat	kalaaleq-INNAQ<flertal<Relativ
kalaaliinnalerillutilli	kalaaleq-INNAQ-LIRI<Ledsagemåde<de_selv+LI
kalaaliinnalerinngilangaana	kalaaleq-INNAQ-LIRI-NNGIT<Indikativ<jeg+UNA
kalaaliinnaavit	kalaaleq-INNAQ-U<Interrogativ<du
kalaalilik	kalaaleq-LIK<ental<Absolut
kalaalilimmulli	kalaaleq-LIK<ental<Terminalis+LI
kalaalinngulaarpoq	kalaaleq-NNGUR-LAAR<Indikativ<han
kalaalinngulaartarpit	kalaaleq-NNGUR-LAAR=TAR<Interrogativ<du
kalaalerpassuili	kalaaleq+PASSUAQ<flertal<hans<Absolut+LI
kalaaleqalaartoq	kalaaleq-QAR-LAAR<Participium<han
kalaaleqalaartarneq	kalaaleq-QAR-LAAR=TAR+NIQ
kalaaleqanngilaq	kalaaleq-QAR-NNGIT<Indikativ<han
kalaaleqassagaluarnerli	kalaaleq-QAR-SSA=GALUAR+NIQ+LI
kalaaliuvunga	kalaaleq-U<Indikativ<jeg
kalaaliusimasarpit	kalaaleq-U+SIMA=TAR<Interrogativ<du
kalaaliussagaluarpunga	kalaaleq-U-SSA=GALUAR<Indikativ<jeg
kalaaliussavit	kalaaleq-U-SSA<Interrogativ<du
kalaallisut	kalaallisut<Partikel
kalaallisulli	kalaallisut<Partikel+LI
kalaallisullu	kalaallisut<Partikel+LU
kalaallisununa	kalaallisut<Partikel+UNA
Kangaatsiaq	Kangaatsiaq<Absolut
Kangaatsiarli	Kangaatsiaq<Absolut+LI
Kangaatsiarlu	Kangaatsiaq<Absolut+LU
Kangaatsiaruna	Kangaatsiaq<Absolut+UNA
Kangaatsiamik	Kangaatsiaq<Instrumentalis
Kangaatsiamilli	Kangaatsiaq<Instrumentalis+LI
Kangaatsiamillu	Kangaatsiaq<Instrumentalis+LU
Kangaatsiaminguna	Kangaatsiaq<Instrumentalis+UNA
Kangaatsiami	Kangaatsiaq<Lokalis
Kangaatsiamilu	Kangaatsiaq<Lokalis+LU
Kangaatsiamiuna	Kangaatsiaq<Lokalis+UNA
Kangaatsiarmiu	Kangaatsiaq+MIU<ental<Absolut
Kangaatsiarmiulerivit	Kangaatsiaq+MIU-LIRI<Interrogativ<du
Kangaatsiarmiulerilaartarpunga	Kangaatsiaq+MIU-LIRI-LAAR=TAR<Indikativ<jeg
Kangaatsiarmiulerinianngilatit	Kangaatsiaq+MIU-LIRI+NIAR=NNGIT<Interrogativ<du
Kangaatsiarmiunngorlutik	Kangaatsiaq+MIU-NNGUR<Ledsagemåde<de_selv
Kangaatsiarmiunngussagaluarlutinguna	Kangaatsiaq+MIU-NNGUR-SSA=GALUAR<Ledsagemåde<de_selv+UNA
Kangaatsiarmioqarnerli	Kangaatsiaq+MIU-QAR+NIQ+LI
Kangaatsiarmioqarneruna	Kangaatsiaq+MIU-QAR+NIQ+UNA
Kangaatsiarmioqartorli	Kangaatsiaq+MIU-QAR<Participium<han+LI
Kangaatsiarmioqartoruna	Kangaatsiaq+MIU-QAR<Participium<han+UNA
Kangaatsiarmiuugaluarlutilli	Kangaatsiaq+MIU-U+GALUAR<Ledsagemåde<de_selv+LI
Kangaatsiarmiuulaartarpulli	Kangaatsiaq+MIU-U-LAAR=TAR<Indikativ<de+LI
Kangaatsiarmiuunngilangalu	Kangaatsiaq+MIU-U-NNGIT<Indikativ<jeg+LU
Kangaatsiarmiuusut	Kangaatsiaq+MIU-U<Participium<de
Kangaatsiarmiuusunga	Kangaatsiaq+MIU-U<Participium<jeg
Kangaatsiarmiuusimaneq	Kangaatsiaq+MIU-U+SIMA+NIQ<ental<Absolut
Kangaatsiarmiuusimasarpununa	Kangaatsiaq+MIU-U+SIMA=TAR<Indikativ<de+UNA
Kangaatsiarmiuussagaluarlutinguna	Kangaatsiaq+MIU-U-SSA=GALUAR<Ledsagemåde<de_selv+UNA
Kangaatsiarmiuussaangali	Kangaatsiaq+MIU-U-SSA<Indikativ<jeg+LI
Kangaatsiamut	Kangaatsiaq<Terminalis
Kangaatsiamulli	Kangaatsiaq<Terminalis+LI
Kangaatsiamununa	Kangaatsiaq<Terminalis+UNA
Kangerlussuaq	Kangerlussuaq<Absolut
Kangerlussuarli	Kangerlussuaq<Absolut+LI
Kangerlussuarlu	Kangerlussuaq<Absolut+LU
Kangerlussuaruna	Kangerlussuaq<Absolut+UNA
Kangerlussuarmik	Kangerlussuaq<Instrumentalis
Kangerlussuarminguna	Kangerlussuaq<Instrumentalis+UNA
Kangerlussuarmi	Kangerlussuaq<Lokalis
Kangerlussuarmiuna	Kangerlussuaq<Lokalis+UNA
Kangerlussuarmiu	Kangerlussuaq+MIU<ental<Absolut
Kangerlussuarmiumununa	Kangerlussuaq+MIU<ental<Terminalis+UNA
Kangerlussuarmiunillu	Kangerlussuaq+MIU<flertal<Instrumentalis+LU
Kangerlussuarmiuni	Kangerlussuaq+MIU<flertal<Lokalis
Kangerlussuarmiuleriniarneriuna	Kangerlussuaq+MIU-LIRI+NIAR+NIQ<flertal<hans<Absolut+UNA
Kangerlussuarmiulerisimasarnerniinnianngilatit	Kangerlussuaq+MIU-LIRI+SIMA=TAR+NIQ<flertal<Lokalis+IP+NIAR=NNGIT<Interrogativ<du
Kangerlussuarmiunngornianngillat	Kangerlussuaq+MIU-NNGUR+NIAR=NNGIT<Indikativ<de
Kangerlussuarmiunngussagaluarpoq	Kangerlussuaq+MIU-NNGUR-SSA=GALUAR<Indikativ<han
Kangerlussuarmioqarpoq	Kangerlussuaq+MIU-QAR<Indikativ<han
Kangerlussuarmioqarnerli	Kangerlussuaq+MIU-QAR+NIQ+LI
Kangerlussuarmiuuit	Kangerlussuaq+MIU-U<Interrogativ<du
Kangerlussuarmiuuniarnerinuna	Kangerlussuaq+MIU-U+NIAR+NIQ<flertal<Relativ+UNA
Kangerlussuarmiuunatik	Kangerlussuaq+MIU-U-NNGIT<Ledsagemåde<de_selv
Kangerlussuarmiuusunga	Kangerlussuaq+MIU-U<Participium<jeg
Kangerlussuarmiuusimallutilli	Kangerlussuaq+MIU-U+SIMA<Ledsagemåde<de_selv+LI
Kangerlussuarmiuussagaluarpunga	Kangerlussuaq+MIU-U-SSA=GALUAR<Indikativ<jeg
Kangerlussuarmiuussagaluartunga	Kangerlussuaq+MIU-U-SSA=GALUAR<Participium<jeg
Kangerlussuarmut	Kangerlussuaq<Terminalis
Kangerlussuarmulli	Kangerlussuaq<Terminalis+LI
Kangerlussuarmununa	Kangerlussuaq<Terminalis+UNA
kiisa	kiisa<Partikel
kiisali	kiisa<Partikel+LI
kiisalu	kiisa<Partikel+LU
kiisaana	kiisa<Partikel+UNA
kingulleq	kingulleq<ental<Absolut
kingulliat	kingulleq<ental<deres<Absolut
kingullermilli	kingulleq<ental<Instrumentalis+LI
kingulliit	kingulleq<flertal<Relativ
kingulliilli	kingulleq<flertal<Relativ+LI
kingulliinnanngulaarnermullu	kingulleq-INNAQ-NNGUR-LAAR+NIQ<ental<Terminalis+LU
kingulliinnaqalaartartoq	kingulleq-INNAQ-QAR-LAAR=TAR<Participium<han
kingulliinnaqannginnerni	kingulleq-INNAQ-QAR-NNGIT+NIQ<flertal<Lokalis
kingulliliat	kingulleq-LIK<ental<deres
kingulliliaana	kingulleq-LIK<ental<hans<Absolut+UNA
kingullilimmut	kingulleq-LIK<ental<Terminalis
kingullileriniarnatillu	kingulleq-LIRI+NIAR=NNGIT<Ledsagemåde<de_selv+LU
kingullilerinernilli	kingulleq-LIRI+NIQ<flertal<Instrumentalis+LI
kingullilerisaraluarnerinuna	kingulleq-LIRI+TAR=GALUAR+NIQ<flertal<Relativ+UNA
kingullermioqartoruna	kingulleq+MIU-QAR<Participium<han+UNA
kingulleqalaarpoq	kingulleq-QAR-LAAR<Indikativ<han
kingulleqassagaluarpugulli	kingulleq-QAR-SSA=GALUAR<Indikativ<vi+LI
kingulleqassagaluartut	kingulleq-QAR-SSA=GALUAR<Participium<de
kingulleqassaaq	kingulleq-QAR-SSA<Indikativ<han
kingulliulaartununa	kingulleq-U-LAAR<Participium<de+UNA
kisimi	kisimi<Adjektiv
kisimili	kisimi<Adjektiv+LI
kisimilu	kisimi<Adjektiv+LU
kisimiuna	kisimi<Adjektiv+UNA
kunngimik	kunngi<ental<Instrumentalis
kunngimi	kunngi<enta<Lokalisl
kunnginiilaarpoq	kunngi<flertal<Lokalis+IP-LAAR<Indikativ<han
kunngigigaluarpiuk	kunngi+GӘ+GALUAR<Interrogativ<DuHam
kunngiginiartigit	kunngi+GӘ+NIAR<Imperativ<ViDem
kunngiginianngilaa	kunngi+GӘ+NIAR=NNGIT<Indikativ<HanHam
kunngigisarpiuk	kunngi+GӘ+TAR<Interrogativ<DuHam
kunngiinnaq	kunngi-INNAQ<ental<Absolut
kunngiinnalerisarnernik	kunngi-INNAQ-LIRI+TAR+NIQ<flertal<Instrumentalis
kunngiinnanngortaraluarlutillu	kunngi-INNAQ-NNGUR+TAR=GALUAR<Ledsagemåde<de_selv+LU
kunngillinuna	kunngi-LIK<flertal<Relativ+UNA
kunngilerivit	kunngi-LIRI<Interrogativ<du
kunngilerissallutillu	kunngi-LIRI-SSA<Ledsagemåde<de_selv+LU
kunngilerisartunga	kunngi-LIRI+TAR<Participium<jeg
kunngimioqarneq	kunngi+MIU-QAR+NIQ
kunngimioqarnerlu	kunngi+MIU-QAR+NIQ+LU
kunngimioqarneruna	kunngi+MIU-QAR+NIQ+UNA
kunngimioqartorli	kunngi+MIU-QAR<Participium<han+LI
kunngimioqartoruna	kunngi+MIU-QAR<Participium<han+UNA
kunngimiuulaartarpungalu	kunngi+MIU-U-LAAR=TAR<Indikativ<jeg+LU
kunngimiuusarnerat	kunngi+MIU-U+TAR+NIQ<ental<deres
kunnginngorsinnaanerni	kunngi-NNGUR+SINNAA+NIQ<flertal<Lokalis
kunnginngussasoq	kunngi-NNGUR-SSA<Participium<han
kunngerpassuilli	kunngi+PASSUAQ<flertal<Absolut+LI
kunngerpassuinuna	kunngi+PASSUAQ<flertal<Absolut+UNA
kunngerpassuartut	kunngi+PASSUAQ<flertal<Aequalis
kunngerpassui	kunngi+PASSUAQ<flertal<hans<Absolut
kunngerpassuiuna	kunngi+PASSUAQ<flertal<hans<Absolut+UNA
kunngerpassuarnik	kunngi+PASSUAQ<flertal<Instrumentalis
kunngerpassuarnilli	kunngi+PASSUAQ<flertal<Instrumentalis+LI
kunngerpassuarnillu	kunngi+PASSUAQ<flertal<Instrumentalis+LU
kunngerpassuarni	kunngi+PASSUAQ<flertal<Lokalis
kunngerpassuarniippugut	kunngi+PASSUAQ<flertal<Lokalis+IP<Indikativ<vi
kunngerpassuarniilaarpit	kunngi+PASSUAQ<flertal<Lokalis+IP-LAAR<Interrogativ<du
kunngerpassuarniuna	kunngi+PASSUAQ<flertal<Lokalis+UNA
kunngerpassuarnullu	kunngi+PASSUAQ<flertal<Terminalis+LU
kunngeqarpungali	kunngi-QAR<Indikativ<jeg+LI
kunngeqalaarlutik	kunngi-QAR-LAAR<Ledsagemåde<de_selv
kunngeqalaartoruna	kunngi-QAR-LAAR<Participium<han+UNA
kunngeqalaartungali	kunngi-QAR-LAAR<Participium<jeg+LI
kunngeqalaartartununa	kunngi-QAR-LAAR=TAR<Participium<de+UNA
kunngeqarniarnatillu	kunngi-QAR+NIAR=NNGIT<Ledsagemåde<de_selv+LU
kunngeqanngilaq	kunngi-QAR-NNGIT<Indikativ<han
kunngeqanngilatit	kunngi-QAR-NNGIT<Interrogativ<du
kunngeqannginnerniuna	kunngi-QAR-NNGIT+NIQ<flertal<Lokalis+UNA
kunngeqarsinnaaneq	kunngi-QAR+SINNAA+NIQ<ental<Absolut
kunngeqassagaluarlutinguna	kunngi-QAR-SSA=GALUAR<Ledsagemåde<de_selv+UNA
kunngeqassagaluartunga	kunngi-QAR-SSA=GALUAR<Participium<jeg
kunngeqassaanga	kunngi-QAR-SSA<Indikativ<jeg
kunngeqassasulli	kunngi-QAR-SSA<Participium<de+LI
kunngeqassasullu	kunngi-QAR-SSA<Participium<de+LU
kunngeqartarpununa	kunngi-QAR+TAR<Indikativ<de+UNA
kunngiulaarpoq	kunngi-U-LAAR<Indikativ<han
kunngiusaraluarnernununa	kunngi-U+TAR=GALUAR+NIQ<flertal<Terminalis+UNA
makku	makku<Pronomen<flertal
makkuli	makku<Pronomen<flertal+LI
makkulu	makku<Pronomen<flertal+LU
makkuuna	makku<Pronomen<flertal+UNA
Maniitsoq	Maniitsoq<Absolut
Maniitsorli	Maniitsoq<Absolut+LI
Maniitsorlu	Maniitsoq<Absolut+LU
Maniitsoruna	Maniitsoq<Absolut+UNA
Maniitsumik	Maniitsoq<Instrumentalis
Maniitsumilli	Maniitsoq<Instrumentalis+LI
Maniitsumillu	Maniitsoq<Instrumentalis+LU
Maniitsuminguna	Maniitsoq<Instrumentalis+UNA
Maniitsumi	Maniitsoq<Lokalis
Maniitsumili	Maniitsoq<Lokalis+LI
Maniitsumilu	Maniitsoq<Lokalis+LU
Maniitsumiuna	Maniitsoq<Lokalis+UNA
Maniitsormiu	Maniitsoq+MIU<ental<Absolut
Maniitsormiulu	Maniitsoq+MIU<ental<Absolut+LU
Maniitsormiumut	Maniitsoq+MIU<ental<Terminalis
Maniitsormiumulli	Maniitsoq+MIU<ental<Terminalis+LI
Maniitsormiunik	Maniitsoq+MIU<flertal<Instrumentalis
Maniitsormiunillu	Maniitsoq+MIU<flertal<Instrumentalis+LU
Maniitsormiuninguna	Maniitsoq+MIU<flertal<Instrumentalis+UNA
Maniitsormiuni	Maniitsoq+MIU<flertal<Lokalis
Maniitsormiunilu	Maniitsoq+MIU<flertal<Lokalis+LU
Maniitsormiulerigaluarnerinuna	Maniitsoq+MIU-LIRI+GALUAR+NIQ<flertal<Relativ+UNA
Maniitsormiulerisarlutik	Maniitsoq+MIU-LIRI+TAR<Ledsagemåde<de_selv
Maniitsormiunngorpit	Maniitsoq+MIU-NNGUR<Interrogativ<du
Maniitsormiunngulaarpit	Maniitsoq+MIU-NNGUR-LAAR<Interrogativ<du
Maniitsormiunngulaartunga	Maniitsoq+MIU-NNGUR-LAAR<Participium<jeg
Maniitsormiunngornianngilatit	Maniitsoq+MIU-NNGUR+NIAR=NNGIT<Interrogativ<du
Maniitsormiunngornerillu	Maniitsoq+MIU-NNGUR+NIQ<flertal<Absolut+LU
Maniitsormiunngunngilatit	Maniitsoq+MIU-NNGUR-NNGIT<Interrogativ<du
Maniitsormiunngortut	Maniitsoq+MIU-NNGUR<Participium<de
Maniitsormiunngortununa	Maniitsoq+MIU-NNGUR<Participium<de+UNA
Maniitsormiunngortoruna	Maniitsoq+MIU-NNGUR<Participium<han+UNA
Maniitsormioqarpoq	Maniitsoq+MIU-QAR<Indikativ<han
Maniitsormioqarporli	Maniitsoq+MIU-QAR<Indikativ<han+LI
Maniitsormioqarporlu	Maniitsoq+MIU-QAR<Indikativ<han+LU
Maniitsormioqarporuna	Maniitsoq+MIU-QAR<Indikativ<han+UNA
Maniitsormioqarneq	Maniitsoq+MIU-QAR+NIQ
Maniitsormioqarnerli	Maniitsoq+MIU-QAR+NIQ+LI
Maniitsormioqarneruna	Maniitsoq+MIU-QAR+NIQ+UNA
Maniitsormioqartoq	Maniitsoq+MIU-QAR<Participium<han
Maniitsormioqartorli	Maniitsoq+MIU-QAR<Participium<han+LI
Maniitsormioqartorlu	Maniitsoq+MIU-QAR<Participium<han+LU
Maniitsormioqartoruna	Maniitsoq+MIU-QAR<Participium<han+UNA
Maniitsormiuulaartarpit	Maniitsoq+MIU-U-LAAR=TAR<Interrogativ<du
Maniitsormiuulaartarnerili	Maniitsoq+MIU-U-LAAR=TAR+NIQ<flertal<hans<Absolut+LI
Maniitsormiuulaartartoq	Maniitsoq+MIU-U-LAAR=TAR<Participium<han
Maniitsormiuuniarporuna	Maniitsoq+MIU-U+NIAR<Indikativ<han+UNA
Maniitsormiuusorli	Maniitsoq+MIU-U<Participium<han+LI
Maniitsormiuusinnaallutillu	Maniitsoq+MIU-U+SINNAA<Ledsagemåde<de_selv+LU
Maniitsormiuusaraluartunga	Maniitsoq+MIU-U+TAR=GALUAR<Participium<jeg
Maniitsormiuusarpunga	Maniitsoq+MIU-U+TAR<Indikativ<jeg
Maniitsormiuusarlutik	Maniitsoq+MIU-U+TAR<Ledsagemåde<de_selv
Maniitsumut	Maniitsoq<Terminalis
Maniitsumulli	Maniitsoq<Terminalis+LI
Maniitsumullu	Maniitsoq<Terminalis+LU
Maniitsumununa	Maniitsoq<Terminalis+UNA
manna	manna<Pronomen<ental
mannali	manna<Pronomen<ental+LI
mannalu	manna<Pronomen<ental+LU
mannaana	manna<Pronomen<ental+UNA
marluinnaanuna	marluk-INNAQ<flertal<Relativ+UNA
marluinnalerineq	marluk-INNAQ-LIRI+NIQ<ental<Absolut
marlulittullu	marluk-LIK<ental<Aequalis+LU
marlulia	marluk-LIK<ental<hans<Absolut
marluliilli	marluk-LIK<flertal<Absolut+LI
marlulileriniarnera	marluk-LIK-LIRI+NIAR+NIQ<ental<hans<Absolut
marlulilerisimasarnerinuna	marluk-LIK-LIRI+SIMA=TAR+NIQ<flertal<Relativ+UNA
marluleqalaartullu	marluk-LIK-QAR-LAAR<Participium<de+LU
marluleqanngilaq	marluk-LIK-QAR-NNGIT<Indikativ<han
marluleqassagaluarlutinguna	marluk-LIK-QAR-SSA=GALUAR<Ledsagemåde<de_selv+UNA
marlunngulaartartungaana	marluk-NNGUR-LAAR=TAR<Participium<jeg+UNA
marlunngorniarnerni	marluk-NNGUR+NIAR+NIQ<flertal<Lokalis
marlulli	marluk<Talord<Absolut>Pl+LI
marlullu	marluk<Talord<Absolut>Pl+LU
marlunguna	marluk<Talord<Absolut>Pl+UNA
marluniissinnaavit	marluk<Talord<Lokalis+IP+SINNAA<Interrogativ<du
marlunilu	marluk<Talord<Lokalis+LU
massakkut	massakkut<Partikel
massakkulli	massakkut<Partikel+LI
massakkullu	massakkut<Partikel+LU
massakkununa	massakkut<Partikel+UNA
meeraq	meeraq<ental<Absolut
meeraruna	meeraq<ental<Absolut+UNA
meeqqatut	meeraq<ental<Aequalis
meeqqatulli	meeraq<ental<Aequalis+LI
meeqqatullu	meeraq<ental<Aequalis+LU
meeqqatununa	meeraq<ental<Aequalis+UNA
meeraat	meeraq<ental<deres
meeraalli	meeraq<ental<deres+LI
meeqqamut	meeraq<ental<Terminalis
meeqqamulli	meeraq<ental<Terminalis+LI
meeqqamununa	meeraq<ental<Terminalis+UNA
meeraa	meeraq<flertal<hans<Absolut
meeraauna	meeraq<flertal<hans<Absolut+UNA
meeqqanik	meeraq<flertal<Instrumentalis
meeqqanilli	meeraq<flertal<Instrumentalis+LI
meeqqanillu	meeraq<flertal<Instrumentalis+LU
meeqqaninguna	meeraq<flertal<Instrumentalis+UNA
meeqqani	meeraq<flertal<Lokalis
meeqqaniikkaluarneq	meeraq<flertal<Lokalis+IP+GALUAR+NIQ<ental<Absolut
meeqqaniippugulli	meeraq<flertal<Lokalis+IP<Indikativ<vi+LI
meeqqaniillutilli	meeraq<flertal<Lokalis+IP<Ledsagemåde<de_selv+LI
meeqqaniittunga	meeraq<flertal<Lokalis+IP<Participium<jeg
meeqqaniissimaneri	meeraq<flertal<Lokalis+IP+SIMA+NIQ<flertal<hans<Absolut
meeqqaniissimanernik	meeraq<flertal<Lokalis+IP+SIMA+NIQ<flertal<Instrumentalis
meeqqanilu	meeraq<flertal<Lokalis+LU
meeqqaniuna	meeraq<flertal<Lokalis+UNA
meeqqanut	meeraq<flertal<Terminalis
meeqqanulli	meeraq<flertal<Terminalis+LI
meeqqanununa	meeraq<flertal<Terminalis+UNA
meerarigaluarpaannga	meeraq+GӘ+GALUAR<Indikativ<DeMig
meerarigaluarpakka	meeraq+GӘ+GALUAR<Indikativ<JegDem
meeraannaleriniarpununa	meeraq-INNAQ-LIRI+NIAR<Indikativ<de+UNA
meeraannalerisimanermulli	meeraq-INNAQ-LIRI+SIMA+NIQ<ental<Terminalis+LI
meeraannaagaluarporuna	meeraq-INNAQ-U+GALUAR<Indikativ<han+UNA
meerallinuna	meeraq-LIK<flertal<Absolut+UNA
meerallinuna	meeraq-LIK<flertal<Relativ+UNA
meeralinngorniartunga	meeraq-LIK-NNGUR+NIAR<Participium<jeg
meeralerigaluartunga	meeraq-LIRI+GALUAR<Participium<jeg
meeralerinatilli	meeraq-LIRI-NNGIT<Ledsagemåde<de_selv+LI
meerarmiunngussagaluarpununa	meeraq+MIU-NNGUR-SSA=GALUAR<Indikativ<de+UNA
meerarmiunngortaraluartungaana	meeraq+MIU-NNGUR+TAR=GALUAR<Participium<jeg+UNA
meerarmioqarporli	meeraq+MIU-QAR<Indikativ<han+LI
meerarmiuugaluarneralli	meeraq+MIU-U+GALUAR+NIQ<ental<deres+LI
meerarmiuulaartarpunga	meeraq+MIU-U-LAAR=TAR<Indikativ<jeg
meerarmiuussaagullu	meeraq+MIU-U-SSA<Indikativ<vi+LU
meeranngulaarpoq	meeraq-NNGUR-LAAR<Indikativ<han
meeranngornatik	meeraq-NNGUR-NNGIT<Ledsagemåde<de_selv
meeranngorsimavugut	meeraq-NNGUR+SIMA<Indikativ<vi
meeranngorsinnaasunga	meeraq-NNGUR+SINNAA<Participium<jeg
meeranngussavit	meeraq-NNGUR-SSA<Interrogativ<du
meerarpassuili	meeraq+PASSUAQ<flertal<hans<Absolut+LI
najatununa	naja<ental<Aequalis+UNA
najanilli	naja<flertal<Instrumentalis+LI
najani	naja<flertal<Lokalis
najaginiarpaana	naja+GӘ+NIAR<Indikativ<HanHam+UNA
najaginianngiliuk	naja+GӘ+NIAR=NNGIT<Interrogativ<DuHam
najaannaalu	naja-INNAQ<ental<hans<Absolut+LU
najaannaali	naja-INNAQ<flertal<hans<Absolut+LI
najallillu	naja-LIK<flertal<Relativ+LU
najamioqarneq	naja+MIU-QAR+NIQ
najamioqarneruna	naja+MIU-QAR+NIQ+UNA
najamioqartoruna	naja+MIU-QAR<Participium<han+UNA
najamiuunatilli	naja+MIU-U-NNGIT<Ledsagemåde<de_selv+LI
najarpassui	naja+PASSUAQ<flertal<hans<Absolut
najarpassuarni	naja+PASSUAQ<flertal<Lokalis
najaqalaarneranuna	naja-QAR-LAAR+NIQ<ental<deres+UNA
najaqassaarli	naja-QAR-SSA<Indikativ<han+LI
najugaqalaartarlutinguna	najugaqar-LAAR=TAR<Ledsagemåde<de_selv+UNA
najugaqalaartartut	najugaqar-LAAR=TAR<Participium<de
najugaqanngilatit	najugaqar-NNGIT<Interrogativ<du
najukkami	najugaq<ental<Lokalis
najukkamut	najugaq<ental<Terminalis
najukkamulli	najugaq<ental<Terminalis+LI
najugaa	najugaq<flertal<hans<Absolut
najukkanik	najugaq<flertal<Instrumentalis
najukkanilli	najugaq<flertal<Instrumentalis+LI
najukkaninguna	najugaq<flertal<Instrumentalis+UNA
najukkanili	najugaq<flertal<Lokalis+LI
najukkanilu	najugaq<flertal<Lokalis+LU
najukkanulli	najugaq<flertal<Terminalis+LI
najugaliilu	najugaq-LIK<flertal<hans<Absolut+LU
najugalilerineri	najugaq-LIK-LIRI+NIQ<flertal<hans<Absolut
najugarmiunilu	najugaq+MIU<flertal<Lokalis+LU
najugarmiuuit	najugaq+MIU-U<Interrogativ<du
najuganngortunga	najugaq-NNGUR<Participium<jeg
najugarpassui	najugaq+PASSUAQ<flertal<hans<Absolut
nalunaraluarpunga	nalunar+GALUAR<Indikativ<jeg
nalunaraluarnerit	nalunar+GALUAR+NIQ<flertal<Relativ
nalunaraluartunga	nalunar+GALUAR<Participium<jeg
nalunarpit	nalunar<Interrogativ<du
nalunalaarpullu	nalunar-LAAR<Indikativ<de+LU
nalunalaarpit	nalunar-LAAR<Interrogativ<du
nalunalaarlutik	nalunar-LAAR<Ledsagemåde<de_selv
nalunalaarlutillu	nalunar-LAAR<Ledsagemåde<de_selv+LU
nalunalaarlutinguna	nalunar-LAAR<Ledsagemåde<de_selv+UNA
nalunalaarneq	nalunar-LAAR+NIQ<ental<Absolut
nalunalaartungaana	nalunar-LAAR<Participium<jeg+UNA
nalunalaartarpullu	nalunar-LAAR=TAR<Indikativ<de+LU
nalunalaartarpugununa	nalunar-LAAR=TAR<Indikativ<vi+UNA
nalunalaartarpit	nalunar-LAAR=TAR<Interrogativ<du
nalunalaartarnerlu	nalunar-LAAR=TAR+NIQ<ental<Absolut+LU
nalunalaartartut	nalunar-LAAR=TAR<Participium<de
nalunalaartartunga	nalunar-LAAR=TAR<Participium<jeg
nalunarniarlutinguna	nalunar+NIAR<Ledsagemåde<de_selv+UNA
nalunanngillat	nalunar-NNGIT<Indikativ<de
nalunanngilaq	nalunar-NNGIT<Indikativ<han
nalunanngilatit	nalunar-NNGIT<Interrogativ<du
nalunannginnermulli	nalunar-NNGIT+NIQ<ental<Terminalis+LI
nalunannginneri	nalunar-NNGIT+NIQ<flertal<hans<Absolut
nalunartoq	nalunar<Participium<han
nalunartorlu	nalunar<Participium<han+LU
nalunarsimasarnernillu	nalunar+SIMA=TAR+NIQ<flertal<Instrumentalis+LU
nalunarsinnaallutik	nalunar+SINNAA<Ledsagemåde<de_selv
nalunassagaluarpununa	nalunar-SSA=GALUAR<Indikativ<de+UNA
nalunassagaluarnerit	nalunar-SSA=GALUAR+NIQ<flertal<Absolut
nalunassagaluartunga	nalunar-SSA=GALUAR<Participium<jeg
nalunassaanga	nalunar-SSA<Indikativ<jeg
nalunassavit	nalunar-SSA<Interrogativ<du
nalunassallutinguna	nalunar-SSA<Ledsagemåde<de_selv+UNA
nalunassasunga	nalunar-SSA<Participium<jeg
nalunartaraluarlutik	nalunar+TAR=GALUAR<Ledsagemåde<de_selv
nammineq	nammineq<Adjektiv
namminerli	nammineq<Adjektiv+LI
namminerlu	nammineq<Adjektiv+LU
nammineruna	nammineq<Adjektiv+UNA
Nanortalik	Nanortalik<Absolut
Nanortalilli	Nanortalik<Absolut+LI
Nanortalillu	Nanortalik<Absolut+LU
Nanortalinguna	Nanortalik<Absolut+UNA
Nanortalimmilli	Nanortalik<Instrumentalis+LI
Nanortalimmillu	Nanortalik<Instrumentalis+LU
Nanortalimmi	Nanortalik<Lokalis
Nanortalimmilu	Nanortalik<Lokalis+LU
Nanortalimmiuna	Nanortalik<Lokalis+UNA
Nanortalimmiumi	Nanortalik+MIU<ental<Lokalis
Nanortalimmiunillu	Nanortalik+MIU<flertal<Instrumentalis+LU
Nanortalimmiuniuna	Nanortalik+MIU<flertal<Lokalis+UNA
Nanortalimmiulerivit	Nanortalik+MIU-LIRI<Interrogativ<du
Nanortalimmiulerissaaq	Nanortalik+MIU-LIRI-SSA<Indikativ<han
Nanortalimmiunngortaraluarlutik	Nanortalik+MIU-NNGUR+TAR=GALUAR<Ledsagemåde<de_selv
Nanortalimmioqarporlu	Nanortalik+MIU-QAR<Indikativ<han+LU
Nanortalimmioqarporuna	Nanortalik+MIU-QAR<Indikativ<han+UNA
Nanortalimmioqartoruna	Nanortalik+MIU-QAR<Participium<han+UNA
Nanortalimmiuulaarporuna	Nanortalik+MIU-U-LAAR<Indikativ<han+UNA
Nanortalimmiuulaartartoruna	Nanortalik+MIU-U-LAAR=TAR<Participium<han+UNA
Nanortalimmiuusimasarpit	Nanortalik+MIU-U+SIMA=TAR<Interrogativ<du
Nanortalimmiuusimasarnerit	Nanortalik+MIU-U+SIMA=TAR+NIQ<flertal<Relativ
Nanortalimmiuusinnaanerilli	Nanortalik+MIU-U+SINNAA+NIQ<flertal<Relativ+LI
Nanortalimmiuussagaluarlutillu	Nanortalik+MIU-U-SSA=GALUAR<Ledsagemåde<de_selv+LU
Nanortalimmut	Nanortalik<Terminalis
Nanortalimmullu	Nanortalik<Terminalis+LU
Narsaq	Narsaq<Absolut
Narsarli	Narsaq<Absolut+LI
Narsaruna	Narsaq<Absolut+UNA
Narsamik	Narsaq<Instrumentalis
Narsami	Narsaq<Lokalis
Narsamili	Narsaq<Lokalis+LI
Narsarmiu	Narsaq+MIU<ental<Absolut
Narsarmiumi	Narsaq+MIU<ental<Lokalis
Narsarmioqarporlu	Narsaq+MIU-QAR<Indikativ<han+LU
Narsarmioqarporuna	Narsaq+MIU-QAR<Indikativ<han+UNA
Narsarmioqarnerli	Narsaq+MIU-QAR+NIQ+LI
Narsarmioqartoruna	Narsaq+MIU-QAR<Participium<han+UNA
Narsarmiuuneq	Narsaq+MIU-U+NIQ<ental<Absolut
Narsarmiuusinnaavugut	Narsaq+MIU-U+SINNAA<Indikativ<vi
Narsarmiuusinnaaneq	Narsaq+MIU-U+SINNAA+NIQ<ental<Absolut
Narsamut	Narsaq<Terminalis
Narsamullu	Narsaq<Terminalis+LU
Narsamununa	Narsaq<Terminalis+UNA
Narsarsuaq	Narsarsuaq<Absolut
Narsarsuarmik	Narsarsuaq<Instrumentalis
Narsarsuarmi	Narsarsuaq<Lokalis
Narsarsuarmioqarporuna	Narsarsuaq+MIU-QAR<Indikativ<han+UNA
Narsarsuarmut	Narsarsuaq<Terminalis
nuka	nuka<ental<Absolut
nukatununa	nuka<ental<Aequalis+UNA
nukaga	nuka<ental<min<Absolut
nukami	nuka<enta<Lokalisl
nukaali	nuka<flertal<hans<Absolut+LI
nukanik	nuka<flertal<Instrumentalis
nukagigaluarpakkaana	nuka+GӘ+GALUAR<Indikativ<JegDem+UNA
nukagilaarpiuk	nuka+GӘ-LAAR<Interrogativ<DuHam
nukaannaq	nuka-INNAQ<ental<Absolut
nukaannanngulaartarnerillu	nuka-INNAQ-NNGUR-LAAR=TAR+NIQ<flertal<Absolut+LU
nukaannaanianngitsulli	nuka-INNAQ-U+NIAR=NNGIT<Participium<de+LI
nukalerivunga	nuka-LIRI<Indikativ<jeg
nukalerinngilaruna	nuka-LIRI-NNGIT<Indikativ<han+UNA
nukamiumilli	nuka+MIU<ental<Instrumentalis+LI
nukamiumununa	nuka+MIU<ental<Terminalis+UNA
nukamiulerigaluarlutik	nuka+MIU-LIRI+GALUAR<Ledsagemåde<de_selv
nukamiuuit	nuka+MIU-U<Interrogativ<du
nukamiuusimasarporuna	nuka+MIU-U+SIMA=TAR<Indikativ<han+UNA
nukanngorsimasartungalu	nuka-NNGUR+SIMA=TAR<Participium<jeg+LU
nukarpassuartullu	nuka+PASSUAQ<flertal<Aequalis+LU
nukarpassuiuna	nuka+PASSUAQ<flertal<hans<Absolut+UNA
nukarpassuarni	nuka+PASSUAQ<flertal<Lokalis
nukappiaqqatut	nukappiaraq<ental<Aequalis
nukappiaqqanilli	nukappiaraq<flertal<Instrumentalis+LI
nukappiaranngorsimasarpit	nukappiaraq-NNGUR+SIMA=TAR<Interrogativ<du
nukaqassavit	nuka-QAR-SSA<Interrogativ<du
nukaqartarporuna	nuka-QAR+TAR<Indikativ<han+UNA
nukarleqalaartarlutik	nukarleq-QAR-LAAR=TAR<Ledsagemåde<de_selv
nukaasimavit	nuka-U+SIMA<Interrogativ<du
nuliaq	nuliaq<ental<Absolut
nuliara	nuliaq<ental<min<Absolut
nuliaritigit	nuliaq+GӘ<Imperativ<ViDem
nuliaannaq	nuliaq-INNAQ<ental<Absolut
nuliaannaasimasunga	nuliaq-INNAQ-U+SIMA<Participium<jeg
nulialilli	nuliaq-LIK<ental<Absolut+LI
nuliarmiunik	nuliaq+MIU<flertal<Instrumentalis
nuliarmioqarporuna	nuliaq+MIU-QAR<Indikativ<han+UNA
nuliarmioqarnerlu	nuliaq+MIU-QAR+NIQ+LU
nuliarmioqartoruna	nuliaq+MIU-QAR<Participium<han+UNA
nuliarmiuunerillu	nuliaq+MIU-U+NIQ<flertal<Absolut+LU
nuliarmiuusinnaaneq	nuliaq+MIU-U+SINNAA+NIQ<ental<Absolut
nulianngussagaluartunga	nuliaq-NNGUR-SSA=GALUAR<Participium<jeg
nuliarpassuit	nuliaq+PASSUAQ<flertal<Absolut
nuliarpassuillu	nuliaq+PASSUAQ<flertal<Absolut+LU
nuliarpassuartullu	nuliaq+PASSUAQ<flertal<Aequalis+LU
nuliarpassuilu	nuliaq+PASSUAQ<flertal<hans<Absolut+LU
nuliaqanngitsunga	nuliaq-QAR-NNGIT<Participium<jeg
nuliaqassagaluarpit	nuliaq-QAR-SSA=GALUAR<Interrogativ<du
nuliaasorlu	nuliaq-U<Participium<han+LU
nunamilli	nuna<ental<Instrumentalis+LI
nunagaana	nuna<ental<min<Absolut+UNA
nunami	nuna<enta<Lokalisl
nunamiinneranuna	nuna<enta<Lokalisl+IP+NIQ<ental<deres+UNA
nunamiinngitsunga	nuna<enta<Lokalisl+IP-NNGIT<Participium<jeg
nunamiuna	nuna<enta<Lokalisl+UNA
nunamut	nuna<ental<Terminalis
nunani	nuna<flertal<Lokalis
nunaannaqarniarlutinguna	nuna-INNAQ-QAR+NIAR<Ledsagemåde<de_selv+UNA
nunaannaqassaaruna	nuna-INNAQ-QAR-SSA<Indikativ<han+UNA
nunalii	nuna-LIK<flertal<hans<Absolut
nunalinnik	nuna-LIK<flertal<Instrumentalis
nunalerilaarpit	nuna-LIRI-LAAR<Interrogativ<du
nunalerinianngilanga	nuna-LIRI+NIAR=NNGIT<Indikativ<jeg
nunalerisimasarpugununa	nuna-LIRI+SIMA=TAR<Indikativ<vi+UNA
nunalerisarnertut	nuna-LIRI+TAR+NIQ<ental<Aequalis
nunamiumili	nuna+MIU<ental<Lokalis+LI
nunamiumununa	nuna+MIU<ental<Terminalis+UNA
nunamiunik	nuna+MIU<flertal<Instrumentalis
nunamiulerissagaluarlutinguna	nuna+MIU-LIRI-SSA=GALUAR<Ledsagemåde<de_selv+UNA
nunamioqarpoq	nuna+MIU-QAR<Indikativ<han
nunamiuuit	nuna+MIU-U<Interrogativ<du
nunamiuullutinguna	nuna+MIU-U<Ledsagemåde<de_selv+UNA
nunamiuusoq	nuna+MIU-U<Participium<han
nunamiuusinnaanerali	nuna+MIU-U+SINNAA+NIQ<ental<hans<Absolut+LI
nunamiuussallutinguna	nuna+MIU-U-SSA<Ledsagemåde<de_selv+UNA
nunamiuusarpit	nuna+MIU-U+TAR<Interrogativ<du
nunanngorpit	nuna-NNGUR<Interrogativ<du
nunanngunngilatit	nuna-NNGUR-NNGIT<Interrogativ<du
nunarpassui	nuna+PASSUAQ<flertal<hans<Absolut
nunarpassuilu	nuna+PASSUAQ<flertal<hans<Absolut+LU
nunarpassuarni	nuna+PASSUAQ<flertal<Lokalis
nunaqalaarpit	nuna-QAR-LAAR<Interrogativ<du
nunaqalaartarpullu	nuna-QAR-LAAR=TAR<Indikativ<de+LU
nunaqassagaluarneq	nuna-QAR-SSA=GALUAR+NIQ<ental<Absolut
nunaqassagaluarnera	nuna-QAR-SSA=GALUAR+NIQ<ental<hans<Absolut
nunaanerni	nuna-U+NIQ<flertal<Lokalis
nunaasoruna	nuna-U<Participium<han+UNA
nunaasunga	nuna-U<Participium<jeg
Nuuk	Nuuk<Absolut
Nuulli	Nuuk<Absolut+LI
Nuullu	Nuuk<Absolut+LU
Nuunguna	Nuuk<Absolut+UNA
Nuummik	Nuuk<Instrumentalis
Nuummillu	Nuuk<Instrumentalis+LU
Nuumminguna	Nuuk<Instrumentalis+UNA
Nuummi	Nuuk<Lokalis
Nuummili	Nuuk<Lokalis+LI
Nuummilu	Nuuk<Lokalis+LU
Nuummiuna	Nuuk<Lokalis+UNA
Nuummiu	Nuuk+MIU<ental<Absolut
Nuummiuminguna	Nuuk+MIU<ental<Instrumentalis+UNA
Nuummiumi	Nuuk+MIU<ental<Lokalis
Nuummiumulli	Nuuk+MIU<ental<Terminalis+LI
Nuummiuni	Nuuk+MIU<flertal<Lokalis
Nuummiunilu	Nuuk+MIU<flertal<Lokalis+LU
Nuummiulerissagaluarlutik	Nuuk+MIU-LIRI-SSA=GALUAR<Ledsagemåde<de_selv
Nuummiulerisarpugulli	Nuuk+MIU-LIRI+TAR<Indikativ<vi+LI
Nuummiunngussagaluarlutilli	Nuuk+MIU-NNGUR-SSA=GALUAR<Ledsagemåde<de_selv+LI
Nuummioqarporli	Nuuk+MIU-QAR<Indikativ<han+LI
Nuummioqarporlu	Nuuk+MIU-QAR<Indikativ<han+LU
Nuummioqarporuna	Nuuk+MIU-QAR<Indikativ<han+UNA
Nuummioqarneq	Nuuk+MIU-QAR+NIQ
Nuummioqarnerli	Nuuk+MIU-QAR+NIQ+LI
Nuummioqarneruna	Nuuk+MIU-QAR+NIQ+UNA
Nuummioqartoq	Nuuk+MIU-QAR<Participium<han
Nuummioqartorli	Nuuk+MIU-QAR<Participium<han+LI
Nuummiuugaluarlutinguna	Nuuk+MIU-U+GALUAR<Ledsagemåde<de_selv+UNA
Nuummiuugaluarnerillu	Nuuk+MIU-U+GALUAR+NIQ<flertal<Absolut+LU
Nuummiuulaarneraana	Nuuk+MIU-U-LAAR+NIQ<ental<hans<Absolut+UNA
Nuummiuulaartut	Nuuk+MIU-U-LAAR<Participium<de
Nuummiuulaartartungalu	Nuuk+MIU-U-LAAR=TAR<Participium<jeg+LU
Nuummiuullutilli	Nuuk+MIU-U<Ledsagemåde<de_selv+LI
Nuummiuunianngilatit	Nuuk+MIU-U+NIAR=NNGIT<Interrogativ<du
Nuummiuuniarnatillu	Nuuk+MIU-U+NIAR=NNGIT<Ledsagemåde<de_selv+LU
Nuummiuuneranuna	Nuuk+MIU-U+NIQ<ental<deres+UNA
Nuummiuusimanera	Nuuk+MIU-U+SIMA+NIQ<ental<hans<Absolut
Nuummiuusinnaapput	Nuuk+MIU-U+SINNAA<Indikativ<de
Nuummiuussagaluarlutik	Nuuk+MIU-U-SSA=GALUAR<Ledsagemåde<de_selv
Nuummiuussasulli	Nuuk+MIU-U-SSA<Participium<de+LI
Nuummiuusarnera	Nuuk+MIU-U+TAR+NIQ<ental<hans<Absolut
Nuummut	Nuuk<Terminalis
Nuummullu	Nuuk<Terminalis+LU
Nuummununa	Nuuk<Terminalis+UNA
nuukkaluarpunga	nuup+GALUAR<Indikativ<jeg
nuukkaluarnerinuna	nuup+GALUAR+NIQ<flertal<Relativ+UNA
nuukkaluartunga	nuup+GALUAR<Participium<jeg
nuuppunga	nuup<Indikativ<jeg
nuulaarneq	nuup-LAAR+NIQ<ental<Absolut
nuulaartartoq	nuup-LAAR=TAR<Participium<han
nuullutik	nuup<Ledsagemåde<de_selv
nuullutilli	nuup<Ledsagemåde<de_selv+LI
nuunniarpunga	nuup+NIAR<Indikativ<jeg
nuuttullu	nuup<Participium<de+LU
nuussimasarpununa	nuup+SIMA=TAR<Indikativ<de+UNA
nuussinnaavit	nuup+SINNAA<Interrogativ<du
nuussagaluarpit	nuup-SSA=GALUAR<Interrogativ<du
nuuttaraluarpulli	nuup+TAR=GALUAR<Indikativ<de+LI
nuuttaraluarpunga	nuup+TAR=GALUAR<Indikativ<jeg
nuuttaraluarnerit	nuup+TAR=GALUAR+NIQ<flertal<Absolut
nuuttarnernulli	nuup+TAR+NIQ<flertal<Terminalis+LI
nuuttartulli	nuup+TAR<Participium<de+LI
oqaaseq	oqaaseq<ental<Absolut
oqaasera	oqaaseq<ental<Absolut<min
oqaatsitut	oqaaseq<ental<Aequalis
oqaatsitulli	oqaaseq<ental<Aequalis+LI
oqaatsitununa	oqaaseq<ental<Aequalis+UNA
oqaasiat	oqaaseq<ental<deres<Absolut
oqaasia	oqaaseq<ental<hans<Absolut
oqaatsimik	oqaaseq<ental<Instrumentalis
oqaatsimillu	oqaaseq<ental<Instrumentalis+LU
oqaatsiminguna	oqaaseq<ental<Instrumentalis+UNA
oqaatsimi	oqaaseq<ental<Lokalis
oqaatsimiuna	oqaaseq<ental<Lokalis+UNA
oqaatsimut	oqaaseq<ental<Terminalis
oqaasiiuna	oqaaseq<flertal<hans<Absolut+UNA
oqaatsinik	oqaaseq<flertal<Instrumentalis
oqaatsinilli	oqaaseq<flertal<Instrumentalis+LI
oqaatsininguna	oqaaseq<flertal<Instrumentalis+UNA
oqaatsini	oqaaseq<flertal<Lokalis
oqaatsiniikkaluarneranuna	oqaaseq<flertal<Lokalis+IP+GALUAR+NIQ<ental<deres+UNA
oqaatsiniilaartarpunga	oqaaseq<flertal<Lokalis+IP-LAAR=TAR<Indikativ<jeg
oqaatsiniillutilli	oqaaseq<flertal<Lokalis+IP<Ledsagemåde<de_selv+LI
oqaatsinili	oqaaseq<flertal<Lokalis+LI
oqaatsinilu	oqaaseq<flertal<Lokalis+LU
oqaatsinut	oqaaseq<flertal<Terminalis
oqaatsinulli	oqaaseq<flertal<Terminalis+LI
oqaatsinununa	oqaaseq<flertal<Terminalis+UNA
oqaasiinnaalli	oqaaseq-INNAQ<ental<deres<Absolut+LI
oqaasilerivit	oqaaseq-LIRI<Interrogativ<du
oqaasilerillutik	oqaaseq-LIRI<Ledsagemåde<de_selv
oqaasermiuni	oqaaseq+MIU<flertal<Lokalis
oqaasermioqarnerlu	oqaaseq+MIU-QAR+NIQ+LU
oqaaserpassuarnununa	oqaaseq+PASSUAQ<flertal<Terminalis+UNA
oqaaseqalaartarlutik	oqaaseq-QAR-LAAR=TAR<Ledsagemåde<de_selv
oqaaseqalaartarlutillu	oqaaseq-QAR-LAAR=TAR<Ledsagemåde<de_selv+LU
oqaaseqarnera	oqaaseq-QAR+NIQ<ental<hans<Absolut
oqaaseqanngitsut	oqaaseq-QAR-NNGIT<Participium<de
oqaaseqassagaluarlutillu	oqaaseq-QAR-SSA=GALUAR<Ledsagemåde<de_selv+LU
oqaasiuppununa	oqaaseq-U<Indikativ<de+UNA
oqaasiuit	oqaaseq-U<Interrogativ<du
oqaasilerineraana	oqaasilerineq<ental<hans<Absolut+UNA
oqaasilerineri	oqaasilerineq<flertal<hans<Absolut
oqaasilerinillilli	oqaasilerineq-LIK<flertal<Relativ+LI
oqaasilerinilerippununa	oqaasilerineq-LIRI<Indikativ<de+UNA
oqaasilerinilerivunga	oqaasilerineq-LIRI<Indikativ<jeg
oqaasilerisoq	oqaasilerisoq<ental<Absolut
oqaasilerisorpassuarni	oqaasilerisoq+PASSUAQ<flertal<Lokalis
oqaasilerisorpassuarniilaartarnerit	oqaasilerisoq+PASSUAQ<flertal<Lokalis+IP-LAAR=TAR+NIQ<flertal<Absolut
oqaasilerisoqalaarlutik	oqaasilerisoq-QAR-LAAR<Ledsagemåde<de_selv
oqaasilerisoqassagaluarlutilli	oqaasilerisoq-QAR-SSA=GALUAR<Ledsagemåde<de_selv+LI
oqaluttuaraluarlutik	oqaluttuar+GALUAR<Ledsagemåde<de_selv
oqaluttuarpulli	oqaluttuar<Indikativ<de+LI
oqaluttuarpungalu	oqaluttuar<Indikativ<jeg+LU
oqaluttuarpit	oqaluttuar<Interrogativ<du
oqaluttualaarpugulli	oqaluttuar-LAAR<Indikativ<vi+LI
oqaluttualaarlutik	oqaluttuar-LAAR<Ledsagemåde<de_selv
oqaluttualaarlutinguna	oqaluttuar-LAAR<Ledsagemåde<de_selv+UNA
oqaluttualaarneq	oqaluttuar-LAAR+NIQ<ental<Absolut
oqaluttualaarnernillu	oqaluttuar-LAAR+NIQ<flertal<Instrumentalis+LU
oqaluttualaartarpungali	oqaluttuar-LAAR=TAR<Indikativ<jeg+LI
oqaluttualaartarneq	oqaluttuar-LAAR=TAR+NIQ<ental<Absolut
oqaluttualaartarneriuna	oqaluttuar-LAAR=TAR+NIQ<flertal<hans<Absolut+UNA
oqaluttualaartarnerni	oqaluttuar-LAAR=TAR+NIQ<flertal<Lokalis
oqaluttualaartartununa	oqaluttuar-LAAR=TAR<Participium<de+UNA
oqaluttuarlutillu	oqaluttuar<Ledsagemåde<de_selv+LU
oqaluttuarlutinguna	oqaluttuar<Ledsagemåde<de_selv+UNA
oqaluttuarniarneq	oqaluttuar+NIAR+NIQ<ental<Absolut
oqaluttuarniarnatik	oqaluttuar+NIAR=NNGIT<Ledsagemåde<de_selv
oqaluttuarniarnatillu	oqaluttuar+NIAR=NNGIT<Ledsagemåde<de_selv+LU
oqaluttuarnerit	oqaluttuar+NIQ<flertal<Absolut
oqaluttuanngilatit	oqaluttuar-NNGIT<Interrogativ<du
oqaluttuarnatik	oqaluttuar-NNGIT<Ledsagemåde<de_selv
oqaluttuarnatinguna	oqaluttuar-NNGIT<Ledsagemåde<de_selv+UNA
oqaluttuannginnerit	oqaluttuar-NNGIT+NIQ<flertal<Absolut
oqaluttuanngitsoq	oqaluttuar-NNGIT<Participium<han
oqaluttuanngitsunga	oqaluttuar-NNGIT<Participium<jeg
oqaluttuartununa	oqaluttuar<Participium<de+UNA
oqaluttuartorlu	oqaluttuar<Participium<han+LU
oqaluttuartunga	oqaluttuar<Participium<jeg
oqaluttuarsimallutik	oqaluttuar+SIMA<Ledsagemåde<de_selv
oqaluttuarsimanerit	oqaluttuar+SIMA+NIQ<flertal<Absolut
oqaluttuarsimanerninguna	oqaluttuar+SIMA+NIQ<flertal<Instrumentalis+UNA
oqaluttuarsimasartununa	oqaluttuar+SIMA=TAR<Participium<de+UNA
oqaluttuassagaluarpunga	oqaluttuar-SSA=GALUAR<Indikativ<jeg
oqaluttuassagaluarpungaana	oqaluttuar-SSA=GALUAR<Indikativ<jeg+UNA
oqaluttuassagaluarpugununa	oqaluttuar-SSA=GALUAR<Indikativ<vi+UNA
oqaluttuassagaluarpit	oqaluttuar-SSA=GALUAR<Interrogativ<du
oqaluttuassagaluarnerinuna	oqaluttuar-SSA=GALUAR+NIQ<flertal<Relativ+UNA
oqaluttuassagaluartoq	oqaluttuar-SSA=GALUAR<Participium<han
oqaluttuassaaq	oqaluttuar-SSA<Indikativ<han
oqaluttuassaangalu	oqaluttuar-SSA<Indikativ<jeg+LU
oqaluttuassavit	oqaluttuar-SSA<Interrogativ<du
oqaluttuassallutik	oqaluttuar-SSA<Ledsagemåde<de_selv
oqaluttuartarlutillu	oqaluttuar+TAR<Ledsagemåde<de_selv+LU
oqaluttuartarnerat	oqaluttuar+TAR+NIQ<ental<deres
oqaluttuartarnerit	oqaluttuar+TAR+NIQ<flertal<Absolut
oqaraluarpoq	oqar+GALUAR<Indikativ<han
oqaraluarpugununa	oqar+GALUAR<Indikativ<vi+UNA
oqaraluarlutik	oqar+GALUAR<Ledsagemåde<de_selv
oqaraluarnermut	oqar+GALUAR+NIQ<ental<Terminalis
oqaraluartunga	oqar+GALUAR<Participium<jeg
oqarpoq	oqar<Indikativ<han
oqarporlu	oqar<Indikativ<han+LU
oqarpugut	oqar<Indikativ<vi
oqarpit	oqar<Interrogativ<du
oqalaarporlu	oqar-LAAR<Indikativ<han+LU
oqalaarpunga	oqar-LAAR<Indikativ<jeg
oqalaarpungaana	oqar-LAAR<Indikativ<jeg+UNA
oqalaarlutik	oqar-LAAR<Ledsagemåde<de_selv
oqalaarlutilli	oqar-LAAR<Ledsagemåde<de_selv+LI
oqalaarnerat	oqar-LAAR+NIQ<ental<deres
oqalaartununa	oqar-LAAR<Participium<de+UNA
oqalaartarporlu	oqar-LAAR=TAR<Indikativ<han+LU
oqalaartarporuna	oqar-LAAR=TAR<Indikativ<han+UNA
oqalaartarpugut	oqar-LAAR=TAR<Indikativ<vi
oqalaartarpit	oqar-LAAR=TAR<Interrogativ<du
oqalaartarlutik	oqar-LAAR=TAR<Ledsagemåde<de_selv
oqalaartarlutilli	oqar-LAAR=TAR<Ledsagemåde<de_selv+LI
oqalaartarnerat	oqar-LAAR=TAR+NIQ<ental<deres
oqalaartarneralli	oqar-LAAR=TAR+NIQ<ental<deres+LI
oqalaartarnermununa	oqar-LAAR=TAR+NIQ<ental<Terminalis+UNA
oqalaartarneriuna	oqar-LAAR=TAR+NIQ<flertal<hans<Absolut+UNA
oqalaartarnernillu	oqar-LAAR=TAR+NIQ<flertal<Instrumentalis+LU
oqalaartartullu	oqar-LAAR=TAR<Participium<de+LU
oqalaartartorli	oqar-LAAR=TAR<Participium<han+LI
oqalaartartunga	oqar-LAAR=TAR<Participium<jeg
oqalaartartungalu	oqar-LAAR=TAR<Participium<jeg+LU
oqalaartartungaana	oqar-LAAR=TAR<Participium<jeg+UNA
oqarlutik	oqar<Ledsagemåde<de_selv
oqarlutinguna	oqar<Ledsagemåde<de_selv+UNA
oqarniarpugut	oqar+NIAR<Indikativ<vi
oqarniarlutik	oqar+NIAR<Ledsagemåde<de_selv
oqarniarnernut	oqar+NIAR+NIQ<flertal<Terminalis
oqarnianngillanuna	oqar+NIAR=NNGIT<Indikativ<de+UNA
oqarnianngilatit	oqar+NIAR=NNGIT<Interrogativ<du
oqarniarnatik	oqar+NIAR=NNGIT<Ledsagemåde<de_selv
oqarniannginnernilu	oqar+NIAR=NNGIT+NIQ<flertal<Lokalis+LU
oqarniannginnerillu	oqar+NIAR=NNGIT+NIQ<flertal<Relativ+LU
oqarnianngitsoruna	oqar+NIAR=NNGIT<Participium<han+UNA
oqarniartoruna	oqar+NIAR<Participium<han+UNA
oqarniartunga	oqar+NIAR<Participium<jeg
oqarnertullu	oqar+NIQ<ental<Aequalis+LU
oqarneralli	oqar+NIQ<ental<deres+LI
oqarneriuna	oqar+NIQ<flertal<hans<Absolut+UNA
oqarnerni	oqar+NIQ<flertal<Lokalis
oqanngilaq	oqar-NNGIT<Indikativ<han
oqanngilatit	oqar-NNGIT<Interrogativ<du
oqarnatilli	oqar-NNGIT<Ledsagemåde<de_selv+LI
oqarnatinguna	oqar-NNGIT<Ledsagemåde<de_selv+UNA
oqannginneq	oqar-NNGIT+NIQ<ental<Absolut
oqannginnermununa	oqar-NNGIT+NIQ<ental<Terminalis+UNA
oqannginneriuna	oqar-NNGIT+NIQ<flertal<hans<Absolut+UNA
oqanngitsunga	oqar-NNGIT<Participium<jeg
oqanngitsungali	oqar-NNGIT<Participium<jeg+LI
oqartunga	oqar<Participium<jeg
oqarsimallutinguna	oqar+SIMA<Ledsagemåde<de_selv+UNA
oqarsimaneri	oqar+SIMA+NIQ<flertal<hans<Absolut
oqarsimasulli	oqar+SIMA<Participium<de+LI
oqarsimasoruna	oqar+SIMA<Participium<han+UNA
oqarsimasarpit	oqar+SIMA=TAR<Interrogativ<du
oqarsimasarlutinguna	oqar+SIMA=TAR<Ledsagemåde<de_selv+UNA
oqarsimasartungali	oqar+SIMA=TAR<Participium<jeg+LI
oqarsinnaallutik	oqar+SINNAA<Ledsagemåde<de_selv
oqarsinnaasunga	oqar+SINNAA<Participium<jeg
oqassagaluarlutik	oqar-SSA=GALUAR<Ledsagemåde<de_selv
oqassagaluarneri	oqar-SSA=GALUAR+NIQ<flertal<hans<Absolut
oqassagaluarnerillu	oqar-SSA=GALUAR+NIQ<flertal<Relativ+LU
oqassagaluartullu	oqar-SSA=GALUAR<Participium<de+LU
oqassagaluartoq	oqar-SSA=GALUAR<Participium<han
oqassagaluartungalu	oqar-SSA=GALUAR<Participium<jeg+LU
oqassaaq	oqar-SSA<Indikativ<han
oqassaangali	oqar-SSA<Indikativ<jeg+LI
oqassaangalu	oqar-SSA<Indikativ<jeg+LU
oqassallutik	oqar-SSA<Ledsagemåde<de_selv
oqassallutilli	oqar-SSA<Ledsagemåde<de_selv+LI
oqassallutillu	oqar-SSA<Ledsagemåde<de_selv+LU
oqassasulli	oqar-SSA<Participium<de+LI
oqassasullu	oqar-SSA<Participium<de+LU
oqassasoq	oqar-SSA<Participium<han
oqassasunga	oqar-SSA<Participium<jeg
oqassasungalu	oqar-SSA<Participium<jeg+LU
oqartaraluarput	oqar+TAR=GALUAR<Indikativ<de
oqartaraluarpit	oqar+TAR=GALUAR<Interrogativ<du
oqartarput	oqar+TAR<Indikativ<de
oqartartorli	oqar+TAR<Participium<han+LI
Paamiut	Paamiut<Absolut
Paamiulli	Paamiut<Absolut+LI
Paamiullu	Paamiut<Absolut+LU
Paamiununa	Paamiut<Absolut+UNA
Paamiunik	Paamiut<Instrumentalis
Paamiunilli	Paamiut<Instrumentalis+LI
Paamiunillu	Paamiut<Instrumentalis+LU
Paamiuninguna	Paamiut<Instrumentalis+UNA
Paamiuni	Paamiut<Lokalis
Paamiunili	Paamiut<Lokalis+LI
Paamiunilu	Paamiut<Lokalis+LU
Paamiuniuna	Paamiut<Lokalis+UNA
Paamiormiuuna	Paamiut+MIU<ental<Absolut+UNA
Paamiormiumik	Paamiut+MIU<ental<Instrumentalis
Paamiormiumi	Paamiut+MIU<ental<Lokalis
Paamiormiumilu	Paamiut+MIU<ental<Lokalis+LU
Paamiormiumiuna	Paamiut+MIU<ental<Lokalis+UNA
Paamiormiumut	Paamiut+MIU<ental<Terminalis
Paamiormiumulli	Paamiut+MIU<ental<Terminalis+LI
Paamiormiunik	Paamiut+MIU<flertal<Instrumentalis
Paamiormiuninguna	Paamiut+MIU<flertal<Instrumentalis+UNA
Paamiormiuni	Paamiut+MIU<flertal<Lokalis
Paamiormiunilu	Paamiut+MIU<flertal<Lokalis+LU
Paamiormiulerigaluarlutinguna	Paamiut+MIU-LIRI+GALUAR<Ledsagemåde<de_selv+UNA
Paamiormiulerivit	Paamiut+MIU-LIRI<Interrogativ<du
Paamiormiulerillutillu	Paamiut+MIU-LIRI<Ledsagemåde<de_selv+LU
Paamiormiulerillutinguna	Paamiut+MIU-LIRI<Ledsagemåde<de_selv+UNA
Paamiormiuleriniarnerali	Paamiut+MIU-LIRI+NIAR+NIQ<ental<hans<Absolut+LI
Paamiormiulerinerat	Paamiut+MIU-LIRI+NIQ<ental<deres
Paamiormiulerisimasulli	Paamiut+MIU-LIRI+SIMA<Participium<de+LI
Paamiormiulerisimasartoq	Paamiut+MIU-LIRI+SIMA=TAR<Participium<han
Paamiormiulerissallutillu	Paamiut+MIU-LIRI-SSA<Ledsagemåde<de_selv+LU
Paamiormiulerisarnerilli	Paamiut+MIU-LIRI+TAR+NIQ<flertal<Absolut+LI
Paamiormiunngorput	Paamiut+MIU-NNGUR<Indikativ<de
Paamiormiunngulaarlutik	Paamiut+MIU-NNGUR-LAAR<Ledsagemåde<de_selv
Paamiormiunngulaartartulli	Paamiut+MIU-NNGUR-LAAR=TAR<Participium<de+LI
Paamiormiunngornatinguna	Paamiut+MIU-NNGUR-NNGIT<Ledsagemåde<de_selv+UNA
Paamiormiunngussagaluarporlu	Paamiut+MIU-NNGUR-SSA=GALUAR<Indikativ<han+LU
Paamiormiunngussagaluarneri	Paamiut+MIU-NNGUR-SSA=GALUAR+NIQ<flertal<hans<Absolut
Paamiormiunngussagaluartoq	Paamiut+MIU-NNGUR-SSA=GALUAR<Participium<han
Paamiormiunngussaagulli	Paamiut+MIU-NNGUR-SSA<Indikativ<vi+LI
Paamiormioqarpoq	Paamiut+MIU-QAR<Indikativ<han
Paamiormioqarporli	Paamiut+MIU-QAR<Indikativ<han+LI
Paamiormioqarporlu	Paamiut+MIU-QAR<Indikativ<han+LU
Paamiormioqarporuna	Paamiut+MIU-QAR<Indikativ<han+UNA
Paamiormioqarneq	Paamiut+MIU-QAR+NIQ
Paamiormioqarnerli	Paamiut+MIU-QAR+NIQ+LI
Paamiormioqarnerlu	Paamiut+MIU-QAR+NIQ+LU
Paamiormioqarneruna	Paamiut+MIU-QAR+NIQ+UNA
Paamiormioqartoq	Paamiut+MIU-QAR<Participium<han
Paamiormioqartorli	Paamiut+MIU-QAR<Participium<han+LI
Paamiormioqartorlu	Paamiut+MIU-QAR<Participium<han+LU
Paamiormioqartoruna	Paamiut+MIU-QAR<Participium<han+UNA
Paamiormiuugaluarlutik	Paamiut+MIU-U+GALUAR<Ledsagemåde<de_selv
Paamiormiuugaluarneri	Paamiut+MIU-U+GALUAR+NIQ<flertal<hans<Absolut
Paamiormiuuvungaana	Paamiut+MIU-U<Indikativ<jeg+UNA
Paamiormiuuvugulli	Paamiut+MIU-U<Indikativ<vi+LI
Paamiormiuuvugununa	Paamiut+MIU-U<Indikativ<vi+UNA
Paamiormiuuit	Paamiut+MIU-U<Interrogativ<du
Paamiormiuulaarlutilli	Paamiut+MIU-U-LAAR<Ledsagemåde<de_selv+LI
Paamiormiuulaarlutillu	Paamiut+MIU-U-LAAR<Ledsagemåde<de_selv+LU
Paamiormiuulaarneraana	Paamiut+MIU-U-LAAR+NIQ<ental<hans<Absolut+UNA
Paamiormiuulaartartungali	Paamiut+MIU-U-LAAR=TAR<Participium<jeg+LI
Paamiormiuullutik	Paamiut+MIU-U<Ledsagemåde<de_selv
Paamiormiuullutilli	Paamiut+MIU-U<Ledsagemåde<de_selv+LI
Paamiormiuullutillu	Paamiut+MIU-U<Ledsagemåde<de_selv+LU
Paamiormiuuniarpugulli	Paamiut+MIU-U+NIAR<Indikativ<vi+LI
Paamiormiuuniarpit	Paamiut+MIU-U+NIAR<Interrogativ<du
Paamiormiuuniarnatillu	Paamiut+MIU-U+NIAR=NNGIT<Ledsagemåde<de_selv+LU
Paamiormiuunianngitsullu	Paamiut+MIU-U+NIAR=NNGIT<Participium<de+LU
Paamiormiuunernununa	Paamiut+MIU-U+NIQ<flertal<Terminalis+UNA
Paamiormiuunnginnera	Paamiut+MIU-U-NNGIT+NIQ<ental<hans<Absolut
Paamiormiuusorli	Paamiut+MIU-U<Participium<han+LI
Paamiormiuusunga	Paamiut+MIU-U<Participium<jeg
Paamiormiuusungalu	Paamiut+MIU-U<Participium<jeg+LU
Paamiormiuusimavit	Paamiut+MIU-U+SIMA<Interrogativ<du
Paamiormiuusimanerit	Paamiut+MIU-U+SIMA+NIQ<flertal<Absolut
Paamiormiuusimanerit	Paamiut+MIU-U+SIMA+NIQ<flertal<Relativ
Paamiormiuusimasorlu	Paamiut+MIU-U+SIMA<Participium<han+LU
Paamiormiuusimasarporlu	Paamiut+MIU-U+SIMA=TAR<Indikativ<han+LU
Paamiormiuusimasarpugut	Paamiut+MIU-U+SIMA=TAR<Indikativ<vi
Paamiormiuusinnaavit	Paamiut+MIU-U+SINNAA<Interrogativ<du
Paamiormiuussagaluarnerillu	Paamiut+MIU-U-SSA=GALUAR+NIQ<flertal<Absolut+LU
Paamiormiuussallutilli	Paamiut+MIU-U-SSA<Ledsagemåde<de_selv+LI
Paamiormiuussasulli	Paamiut+MIU-U-SSA<Participium<de+LI
Paamiormiuussasununa	Paamiut+MIU-U-SSA<Participium<de+UNA
Paamiormiuusaraluarpugullu	Paamiut+MIU-U+TAR=GALUAR<Indikativ<vi+LU
Paamiormiuusaraluarneralli	Paamiut+MIU-U+TAR=GALUAR+NIQ<ental<deres+LI
Paamiormiuusaraluartorlu	Paamiut+MIU-U+TAR=GALUAR<Participium<han+LU
piariilaarporuna	piareer-LAAR<Indikativ<han+UNA
piariilaarpit	piareer-LAAR<Interrogativ<du
piariilaarlutillu	piareer-LAAR<Ledsagemåde<de_selv+LU
piariilaarnerilli	piareer-LAAR+NIQ<flertal<Absolut+LI
piariilaartut	piareer-LAAR<Participium<de
piariilaartarporlu	piareer-LAAR=TAR<Indikativ<han+LU
piareerlutilli	piareer<Ledsagemåde<de_selv+LI
piareerniarpugullu	piareer+NIAR<Indikativ<vi+LU
piareerniarnatik	piareer+NIAR=NNGIT<Ledsagemåde<de_selv
piareernernununa	piareer+NIQ<flertal<Terminalis+UNA
piariinngilagununa	piareer-NNGIT<Indikativ<vi+UNA
piariinnginnerit	piareer-NNGIT+NIQ<flertal<Relativ
piariissagaluarneralli	piareer-SSA=GALUAR+NIQ<ental<deres+LI
piariissapput	piareer-SSA<Indikativ<de
piariissaangali	piareer-SSA<Indikativ<jeg+LI
piareertaraluarlutinguna	piareer+TAR=GALUAR<Ledsagemåde<de_selv+UNA
piareertaraluartunga	piareer+TAR=GALUAR<Participium<jeg
piareertarpunga	piareer+TAR<Indikativ<jeg
pigaluartigit	pi+GALUAR<Imperativ<ViDem
pigaluarpaat	pi+GALUAR<Indikativ<DeHam
pigaluarpakka	pi+GALUAR<Indikativ<JegDem
pigaluarpiuk	pi+GALUAR<Interrogativ<DuHam
pitigit	pi<Imperativ<ViDem
pitigilli	pi<Imperativ<ViDem+LI
pitigillu	pi<Imperativ<ViDem+LU
pivakka	pi<Indikativ<JegDem
pivakkalu	pi<Indikativ<JegDem+LU
pivassi	pi<Indikativ<JegJer
pivagut	pi<Indikativ<ViDem
piviuk	pi<Interrogativ<DuHam
pilaartigit	pi-LAAR<Imperativ<ViDem
pilaartigillu	pi-LAAR<Imperativ<ViDem+LU
pilaartiginuna	pi-LAAR<Imperativ<ViDem+UNA
pilaarpaat	pi-LAAR<Indikativ<DeHam
pilaarpaa	pi-LAAR<Indikativ<HanHam
pilaarpakkalu	pi-LAAR<Indikativ<JegDem+LU
pilaarpakkaana	pi-LAAR<Indikativ<JegDem+UNA
pilaarpassi	pi-LAAR<Indikativ<JegJer
pilaarpassiuna	pi-LAAR<Indikativ<JegJer+UNA
pilaarpiuk	pi-LAAR<Interrogativ<DuHam
pilaartartigit	pi-LAAR=TAR<Imperativ<ViDem
pilaartartigilli	pi-LAAR=TAR<Imperativ<ViDem+LI
pilaartartigillu	pi-LAAR=TAR<Imperativ<ViDem+LU
pilaartartiginuna	pi-LAAR=TAR<Imperativ<ViDem+UNA
pilaartarpaat	pi-LAAR=TAR<Indikativ<DeHam
pilaartarpaannga	pi-LAAR=TAR<Indikativ<DeMig
pilaartarpaanngali	pi-LAAR=TAR<Indikativ<DeMig+LI
pilaartarpaa	pi-LAAR=TAR<Indikativ<HanHam
pilaartarpakka	pi-LAAR=TAR<Indikativ<JegDem
pilaartarpiuk	pi-LAAR=TAR<Interrogativ<DuHam
pingasulileriniarnatik	pingasut-LIK-LIRI+NIAR=NNGIT<Ledsagemåde<de_selv
pingasulilerisimavit	pingasut-LIK-LIRI+SIMA<Interrogativ<du
pingasuleqarsimavit	pingasut-LIK-QAR+SIMA<Interrogativ<du
pingasuliunerlu	pingasut-LIK-U+NIQ<ental<Absolut+LU
pingasunngunngitsungaana	pingasut-NNGUR-NNGIT<Participium<jeg+UNA
pingasunngussallutilli	pingasut-NNGUR-SSA<Ledsagemåde<de_selv+LI
pingasunilli	pingasut<Talord<Instrumentalis+LI
piniartigit	pi+NIAR<Imperativ<ViDem
piniartigillu	pi+NIAR<Imperativ<ViDem+LU
piniarpaanuna	pi+NIAR<Indikativ<DeHam+UNA
piniarpiuk	pi+NIAR<Interrogativ<DuHam
pinianngilaat	pi+NIAR=NNGIT<Indikativ<DeHam
pinianngilaannga	pi+NIAR=NNGIT<Indikativ<DeMig
pinianngilaanngali	pi+NIAR=NNGIT<Indikativ<DeMig+LI
pinianngilaana	pi+NIAR=NNGIT<Indikativ<HanHam+UNA
pinianngilakka	pi+NIAR=NNGIT<Indikativ<JegDem
pinianngilassi	pi+NIAR=NNGIT<Indikativ<JegJer
pinianngilagulli	pi+NIAR=NNGIT<Indikativ<ViDem+LI
pinianngiliuk	pi+NIAR=NNGIT<Interrogativ<DuHam
pinngilaat	pi-NNGIT<Indikativ<DeHam
pinngilaalli	pi-NNGIT<Indikativ<DeHam+LI
pinngilakka	pi-NNGIT<Indikativ<JegDem
pinngilassi	pi-NNGIT<Indikativ<JegJer
pinngiliuk	pi-NNGIT<Interrogativ<DuHam
pisimatigit	pi+SIMA<Imperativ<ViDem
pisimatigillu	pi+SIMA<Imperativ<ViDem+LU
pisimavaannga	pi+SIMA<Indikativ<DeMig
pisimavaa	pi+SIMA<Indikativ<HanHam
pisimavaali	pi+SIMA<Indikativ<HanHam+LI
pisimavaana	pi+SIMA<Indikativ<HanHam+UNA
pisimavagut	pi+SIMA<Indikativ<ViDem
pisimavagununa	pi+SIMA<Indikativ<ViDem+UNA
pisimasartigit	pi+SIMA=TAR<Imperativ<ViDem
pisimasartiginuna	pi+SIMA=TAR<Imperativ<ViDem+UNA
pisimasarpaannga	pi+SIMA=TAR<Indikativ<DeMig
pisimasarpakkali	pi+SIMA=TAR<Indikativ<JegDem+LI
pisimasarpassi	pi+SIMA=TAR<Indikativ<JegJer
pisimasarpassili	pi+SIMA=TAR<Indikativ<JegJer+LI
pisimasarpagulli	pi+SIMA=TAR<Indikativ<ViDem+LI
pisimasarpiuk	pi+SIMA=TAR<Interrogativ<DuHam
pisinnaatigit	pi+SINNAA<Imperativ<ViDem
pisinnaatigilli	pi+SINNAA<Imperativ<ViDem+LI
pisinnaatigillu	pi+SINNAA<Imperativ<ViDem+LU
pisinnaatiginuna	pi+SINNAA<Imperativ<ViDem+UNA
pisinnaavakka	pi+SINNAA<Indikativ<JegDem
pissagaluartigit	pi-SSA=GALUAR<Imperativ<ViDem
pissagaluartigilli	pi-SSA=GALUAR<Imperativ<ViDem+LI
pissagaluartigillu	pi-SSA=GALUAR<Imperativ<ViDem+LU
pissagaluartiginuna	pi-SSA=GALUAR<Imperativ<ViDem+UNA
pissagaluarpaat	pi-SSA=GALUAR<Indikativ<DeHam
pissagaluarpaanuna	pi-SSA=GALUAR<Indikativ<DeHam+UNA
pissagaluarpakka	pi-SSA=GALUAR<Indikativ<JegDem
pissagaluarpiuk	pi-SSA=GALUAR<Interrogativ<DuHam
pissatigilli	pi-SSA<Imperativ<ViDem+LI
pissatiginuna	pi-SSA<Imperativ<ViDem+UNA
pissavakka	pi-SSA<Indikativ<JegDem
pisaraluartigit	pi+TAR=GALUAR<Imperativ<ViDem
pisaraluartigilli	pi+TAR=GALUAR<Imperativ<ViDem+LI
pisaraluartiginuna	pi+TAR=GALUAR<Imperativ<ViDem+UNA
pisaraluarpaannga	pi+TAR=GALUAR<Indikativ<DeMig
pisaraluarpaalu	pi+TAR=GALUAR<Indikativ<HanHam+LU
pisaraluarpakka	pi+TAR=GALUAR<Indikativ<JegDem
pisaraluarpassilu	pi+TAR=GALUAR<Indikativ<JegJer+LU
pisaraluarpiuk	pi+TAR=GALUAR<Interrogativ<DuHam
pisartigit	pi+TAR<Imperativ<ViDem
pisartigillu	pi+TAR<Imperativ<ViDem+LU
pisartiginuna	pi+TAR<Imperativ<ViDem+UNA
pisarpaannga	pi+TAR<Indikativ<DeMig
pisarpassi	pi+TAR<Indikativ<JegJer
pisarpassili	pi+TAR<Indikativ<JegJer+LI
pisarpiuk	pi+TAR<Interrogativ<DuHam
qallunaaq	qallunaaq<ental<Absolut
qallunaarli	qallunaaq<ental<Absolut+LI
qallunaarlu	qallunaaq<ental<Absolut+LU
qallunaaruna	qallunaaq<ental<Absolut+UNA
qallunaalli	qallunaaq<ental<deres<Absolut+LI
qallunaaminguna	qallunaaq<ental<Instrumentalis+UNA
qallunaami	qallunaaq<ental<Lokalis
qallunaamiilaartartunga	qallunaaq<ental<Lokalis+IP-LAAR=TAR<Participium<jeg
qallunaamiinniarnatilli	qallunaaq<ental<Lokalis+IP+NIAR=NNGIT<Ledsagemåde<de_selv+LI
qallunaanik	qallunaaq<flertal<Instrumentalis
qallunaanillu	qallunaaq<flertal<Instrumentalis+LU
qallunaani	qallunaaq<flertal<Lokalis
qallunaarigaluartiginuna	qallunaaq+GӘ+GALUAR<Imperativ<ViDem+UNA
qallunaariviuk	qallunaaq+GӘ<Interrogativ<DuHam
qallunaarilaartigilli	qallunaaq+GӘ-LAAR<Imperativ<ViDem+LI
qallunaarilaarpiuk	qallunaaq+GӘ-LAAR<Interrogativ<DuHam
qallunaarilaartartigit	qallunaaq+GӘ-LAAR=TAR<Imperativ<ViDem
qallunaariniartiginuna	qallunaaq+GӘ+NIAR<Imperativ<ViDem+UNA
qallunaarisimavassilu	qallunaaq+GӘ+SIMA<Indikativ<JegJer+LU
qallunaarisimaviuk	qallunaaq+GӘ+SIMA<Interrogativ<DuHam
qallunaarisimasartiginuna	qallunaaq+GӘ+SIMA=TAR<Imperativ<ViDem+UNA
qallunaarisaraluartigit	qallunaaq+GӘ+TAR=GALUAR<Imperativ<ViDem
qallunaannaq	qallunaaq-INNAQ<ental<Absolut
qallunaannaa	qallunaaq-INNAQ<flertal<hans<Absolut
qallunaannanngulaartarneri	qallunaaq-INNAQ-NNGUR-LAAR=TAR+NIQ<flertal<hans<Absolut
qallunaannaqassagaluarpit	qallunaaq-INNAQ-QAR-SSA=GALUAR<Interrogativ<du
qallunaalittullu	qallunaaq-LIK<ental<Aequalis+LU
qallunaaliat	qallunaaq-LIK<ental<deres
qallunaalinni	qallunaaq-LIK<flertal<Lokalis
qallunaallilli	qallunaaq-LIK<flertal<Relativ+LI
qallunaallinuna	qallunaaq-LIK<flertal<Relativ+UNA
qallunaanngulaarneruna	qallunaaq-NNGUR-LAAR+NIQ+UNA
qallunaanngulaartoq	qallunaaq-NNGUR-LAAR<Participium<han
qallunaanngulaartorlu	qallunaaq-NNGUR-LAAR<Participium<han+LU
qallunaanngorniarporuna	qallunaaq-NNGUR+NIAR<Indikativ<han+UNA
qallunaanngorniarneq	qallunaaq-NNGUR+NIAR+NIQ
qallunaanngorneq	qallunaaq-NNGUR+NIQ
qallunaanngunnginnernik	qallunaaq-NNGUR-NNGIT+NIQ<flertal<Instrumentalis
qallunaanngussagaluartoruna	qallunaaq-NNGUR-SSA=GALUAR<Participium<han+UNA
qallunaarpassuit	qallunaaq+PASSUAQ<flertal<Absolut
qallunaarpassuilli	qallunaaq+PASSUAQ<flertal<Absolut+LI
qallunaarpassuartut	qallunaaq+PASSUAQ<flertal<Aequalis
qallunaarpassui	qallunaaq+PASSUAQ<flertal<hans<Absolut
qallunaarpassuili	qallunaaq+PASSUAQ<flertal<hans<Absolut+LI
qallunaarpassuiuna	qallunaaq+PASSUAQ<flertal<hans<Absolut+UNA
qallunaarpassuarnik	qallunaaq+PASSUAQ<flertal<Instrumentalis
qallunaarpassuarni	qallunaaq+PASSUAQ<flertal<Lokalis
qallunaaqalaartarneq	qallunaaq-QAR-LAAR=TAR+NIQ
qallunaaqalaartartorli	qallunaaq-QAR-LAAR=TAR<Participium<han+LI
qallunaaqannginnera	qallunaaq-QAR-NNGIT+NIQ<ental<hans<Absolut
qallunaaqassagaluarneruna	qallunaaq-QAR-SSA=GALUAR+NIQ+UNA
qallunaaqassaaruna	qallunaaq-QAR-SSA<Indikativ<han+UNA
qallunaajuvungaana	qallunaaq-U<Indikativ<jeg+UNA
qallunaajuneriuna	qallunaaq-U+NIQ<flertal<hans<Absolut+UNA
qallunaajusimasartungali	qallunaaq-U+SIMA=TAR<Participium<jeg+LI
qallunaajusaraluarlutinguna	qallunaaq-U+TAR=GALUAR<Ledsagemåde<de_selv+UNA
qallunaajusaraluarneq	qallunaaq-U+TAR=GALUAR+NIQ<ental<Absolut
qallunaajusarpungaana	qallunaaq-U+TAR<Indikativ<jeg+UNA
Qaqortoq	Qaqortoq<Absolut
Qaqortorli	Qaqortoq<Absolut+LI
Qaqortorlu	Qaqortoq<Absolut+LU
Qaqortoruna	Qaqortoq<Absolut+UNA
Qaqortumik	Qaqortoq<Instrumentalis
Qaqortumillu	Qaqortoq<Instrumentalis+LU
Qaqortuminguna	Qaqortoq<Instrumentalis+UNA
Qaqortumi	Qaqortoq<Lokalis
Qaqortumili	Qaqortoq<Lokalis+LI
Qaqortumiuna	Qaqortoq<Lokalis+UNA
Qaqortormiu	Qaqortoq+MIU<ental<Absolut
Qaqortormiumullu	Qaqortoq+MIU<ental<Terminalis+LU
Qaqortormiuni	Qaqortoq+MIU<flertal<Lokalis
Qaqortormiulerilaartarnerilli	Qaqortoq+MIU-LIRI-LAAR=TAR+NIQ<flertal<Relativ+LI
Qaqortormiulerineralu	Qaqortoq+MIU-LIRI+NIQ<ental<hans<Absolut+LU
Qaqortormiunngulaartarnerillu	Qaqortoq+MIU-NNGUR-LAAR=TAR+NIQ<flertal<Relativ+LU
Qaqortormiunngortunga	Qaqortoq+MIU-NNGUR<Participium<jeg
Qaqortormioqarpoq	Qaqortoq+MIU-QAR<Indikativ<han
Qaqortormioqarporlu	Qaqortoq+MIU-QAR<Indikativ<han+LU
Qaqortormioqarporuna	Qaqortoq+MIU-QAR<Indikativ<han+UNA
Qaqortormioqarnerli	Qaqortoq+MIU-QAR+NIQ+LI
Qaqortormioqartoq	Qaqortoq+MIU-QAR<Participium<han
Qaqortormioqartoruna	Qaqortoq+MIU-QAR<Participium<han+UNA
Qaqortormiuugaluarlutinguna	Qaqortoq+MIU-U+GALUAR<Ledsagemåde<de_selv+UNA
Qaqortormiuulaarlutik	Qaqortoq+MIU-U-LAAR<Ledsagemåde<de_selv
Qaqortormiuunatik	Qaqortoq+MIU-U-NNGIT<Ledsagemåde<de_selv
Qaqortormiuusinnaasungaana	Qaqortoq+MIU-U+SINNAA<Participium<jeg+UNA
Qaqortormiuusaraluarpit	Qaqortoq+MIU-U+TAR=GALUAR<Interrogativ<du
Qaqortumut	Qaqortoq<Terminalis
Qaqortumulli	Qaqortoq<Terminalis+LI
Qaqortumununa	Qaqortoq<Terminalis+UNA
qarasaasiaq	qarasaasiaq<ental<Absolut
qarasaasiaruna	qarasaasiaq<ental<Absolut+UNA
qarasaasiatut	qarasaasiaq<ental<Aequalis
qarasaasiatununa	qarasaasiaq<ental<Aequalis+UNA
qarasaasiaa	qarasaasiaq<ental<hans<Absolut
qarasaasiaali	qarasaasiaq<ental<hans<Absolut+LI
qarasaasiamik	qarasaasiaq<ental<Instrumentalis
qarasaasiamilli	qarasaasiaq<ental<Instrumentalis+LI
qarasaasiami	qarasaasiaq<enta<Lokalisl
qarasaasiamiinngilatit	qarasaasiaq<enta<Lokalisl+IP-NNGIT<Interrogativ<du
qarasaasiamiittaraluarneri	qarasaasiaq<enta<Lokalisl+IP+TAR=GALUAR+NIQ<flertal<hans<Absolut
qarasaasiamilu	qarasaasiaq<enta<Lokalisl+LU
qarasaasiamulli	qarasaasiaq<ental<Terminalis+LI
qarasaasiamullu	qarasaasiaq<ental<Terminalis+LU
qarasaasiaa	qarasaasiaq<flertal<hans<Absolut
qarasaasianik	qarasaasiaq<flertal<Instrumentalis
qarasaasiarigaluarpassi	qarasaasiaq+GӘ+GALUAR<Indikativ<JegJer
qarasaasiariviuk	qarasaasiaq+GӘ<Interrogativ<DuHam
qarasaasiarilaarpakka	qarasaasiaq+GӘ-LAAR<Indikativ<JegDem
qarasaasiariniartiginuna	qarasaasiaq+GӘ+NIAR<Imperativ<ViDem+UNA
qarasaasiarinngilagut	qarasaasiaq+GӘ-NNGIT<Indikativ<ViDem
qarasaasiarisimasarpiuk	qarasaasiaq+GӘ+SIMA=TAR<Interrogativ<DuHam
qarasaasiarisaraluartigillu	qarasaasiaq+GӘ+TAR=GALUAR<Imperativ<ViDem+LU
qarasaasiarisartigit	qarasaasiaq+GӘ+TAR<Imperativ<ViDem
qarasaasiarisarpaat	qarasaasiaq+GӘ+TAR<Indikativ<DeHam
qarasaasiaannaa	qarasaasiaq-INNAQ<flertal<hans<Absolut
qarasaasiaannalerisungaana	qarasaasiaq-INNAQ-LIRI<Participium<jeg+UNA
qarasaasiaannanngorpugut	qarasaasiaq-INNAQ-NNGUR<Indikativ<vi
qarasaasialilli	qarasaasiaq-LIK<ental<Absolut+LI
qarasaasialiaana	qarasaasiaq-LIK<ental<hans<Absolut+UNA
qarasaasialimmut	qarasaasiaq-LIK<ental<Terminalis
qarasaasialii	qarasaasiaq-LIK<flertal<hans<Absolut
qarasaasiallit	qarasaasiaq-LIK<flertal<Relativ
qarasaasialerigaluarlutilli	qarasaasiaq-LIRI+GALUAR<Ledsagemåde<de_selv+LI
qarasaasialerilaarlutik	qarasaasiaq-LIRI-LAAR<Ledsagemåde<de_selv
qarasaasialeriniarpit	qarasaasiaq-LIRI+NIAR<Interrogativ<du
qarasaasialerinatik	qarasaasiaq-LIRI-NNGIT<Ledsagemåde<de_selv
qarasaasialerissagaluarpulli	qarasaasiaq-LIRI-SSA=GALUAR<Indikativ<de+LI
qarasaasiarmiumiuna	qarasaasiaq+MIU<ental<Lokalis+UNA
qarasaasiarmiulerillutillu	qarasaasiaq+MIU-LIRI<Ledsagemåde<de_selv+LU
qarasaasiarmiulerisaraluarpulli	qarasaasiaq+MIU-LIRI+TAR=GALUAR<Indikativ<de+LI
qarasaasiarmiulerisaraluarpugut	qarasaasiaq+MIU-LIRI+TAR=GALUAR<Indikativ<vi
qarasaasiarmiunngulaartarlutilli	qarasaasiaq+MIU-NNGUR-LAAR=TAR<Ledsagemåde<de_selv+LI
qarasaasiarmiunngornera	qarasaasiaq+MIU-NNGUR+NIQ<ental<hans<Absolut
qarasaasiarmiunngunngitsungaana	qarasaasiaq+MIU-NNGUR-NNGIT<Participium<jeg+UNA
qarasaasiarmioqarpoq	qarasaasiaq+MIU-QAR<Indikativ<han
qarasaasiarmioqarnerli	qarasaasiaq+MIU-QAR+NIQ+LI
qarasaasiarmioqarnerlu	qarasaasiaq+MIU-QAR+NIQ+LU
qarasaasiarmioqarneruna	qarasaasiaq+MIU-QAR+NIQ+UNA
qarasaasiarmioqartorlu	qarasaasiaq+MIU-QAR<Participium<han+LU
qarasaasiarmiuuvugulli	qarasaasiaq+MIU-U<Indikativ<vi+LI
qarasaasiarmiuuit	qarasaasiaq+MIU-U<Interrogativ<du
qarasaasiarmiuullutik	qarasaasiaq+MIU-U<Ledsagemåde<de_selv
qarasaasiarmiuuniarnerit	qarasaasiaq+MIU-U+NIAR+NIQ<flertal<Relativ
qarasaasiarmiuunianngilatit	qarasaasiaq+MIU-U+NIAR=NNGIT<Interrogativ<du
qarasaasiarmiuuniarnatilli	qarasaasiaq+MIU-U+NIAR=NNGIT<Ledsagemåde<de_selv+LI
qarasaasiarmiuuniarnatillu	qarasaasiaq+MIU-U+NIAR=NNGIT<Ledsagemåde<de_selv+LU
qarasaasiarmiuuniannginneq	qarasaasiaq+MIU-U+NIAR=NNGIT+NIQ<ental<Absolut
qarasaasiarmiuusununa	qarasaasiaq+MIU-U<Participium<de+UNA
qarasaasiarmiuusimavit	qarasaasiaq+MIU-U+SIMA<Interrogativ<du
qarasaasiarmiuusinnaallutillu	qarasaasiaq+MIU-U+SINNAA<Ledsagemåde<de_selv+LU
qarasaasiarmiuusinnaasunga	qarasaasiaq+MIU-U+SINNAA<Participium<jeg
qarasaasiarmiuussagaluarneq	qarasaasiaq+MIU-U-SSA=GALUAR+NIQ<ental<Absolut
qarasaasianngoraluarpit	qarasaasiaq-NNGUR+GALUAR<Interrogativ<du
qarasaasianngulaarpoq	qarasaasiaq-NNGUR-LAAR<Indikativ<han
qarasaasianngussaanga	qarasaasiaq-NNGUR-SSA<Indikativ<jeg
qarasaasiarpassuartununa	qarasaasiaq+PASSUAQ<flertal<Aequalis+UNA
qarasaasiarpassuili	qarasaasiaq+PASSUAQ<flertal<hans<Absolut+LI
qarasaasiarpassuarnilli	qarasaasiaq+PASSUAQ<flertal<Instrumentalis+LI
qarasaasiaqalaartut	qarasaasiaq-QAR-LAAR<Participium<de
qarasaasiaqanngilatit	qarasaasiaq-QAR-NNGIT<Interrogativ<du
qarasaasiaqannginnerit	qarasaasiaq-QAR-NNGIT+NIQ<flertal<Relativ
qarasaasiaqassagaluarlutilli	qarasaasiaq-QAR-SSA=GALUAR<Ledsagemåde<de_selv+LI
qarasaasiaalaartarpit	qarasaasiaq-U-LAAR=TAR<Interrogativ<du
qarasaasiaalaartarnerallu	qarasaasiaq-U-LAAR=TAR+NIQ<ental<deres+LU
Qasigiannguit	Qasigiannguit<Absolut
Qasigiannguilli	Qasigiannguit<Absolut+LI
Qasigiannguillu	Qasigiannguit<Absolut+LU
Qasigiannguinuna	Qasigiannguit<Absolut+UNA
Qasigiannguanik	Qasigiannguit<Instrumentalis
Qasigiannguanillu	Qasigiannguit<Instrumentalis+LU
Qasigiannguaninguna	Qasigiannguit<Instrumentalis+UNA
Qasigiannguani	Qasigiannguit<Lokalis
Qasigiannguanilu	Qasigiannguit<Lokalis+LU
Qasigiannguaniuna	Qasigiannguit<Lokalis+UNA
Qasigiannguarmiumik	Qasigiannguit+MIU<ental<Instrumentalis
Qasigiannguarmiulerillutinguna	Qasigiannguit+MIU-LIRI<Ledsagemåde<de_selv+UNA
Qasigiannguarmiulerisinnaallutik	Qasigiannguit+MIU-LIRI+SINNAA<Ledsagemåde<de_selv
Qasigiannguarmiunngulaarporli	Qasigiannguit+MIU-NNGUR-LAAR<Indikativ<han+LI
Qasigiannguarmiunngorsimasarpungali	Qasigiannguit+MIU-NNGUR+SIMA=TAR<Indikativ<jeg+LI
Qasigiannguarmioqarporuna	Qasigiannguit+MIU-QAR<Indikativ<han+UNA
Qasigiannguarmioqarneq	Qasigiannguit+MIU-QAR+NIQ
Qasigiannguarmioqarnerli	Qasigiannguit+MIU-QAR+NIQ+LI
Qasigiannguarmioqartoq	Qasigiannguit+MIU-QAR<Participium<han
Qasigiannguarmiuunatik	Qasigiannguit+MIU-U-NNGIT<Ledsagemåde<de_selv
Qasigiannguarmiuussagaluarneranuna	Qasigiannguit+MIU-U-SSA=GALUAR+NIQ<ental<deres+UNA
Qeqertarsuaq	Qeqertarsuaq<Absolut
Qeqertarsuarli	Qeqertarsuaq<Absolut+LI
Qeqertarsuarlu	Qeqertarsuaq<Absolut+LU
Qeqertarsuaruna	Qeqertarsuaq<Absolut+UNA
Qeqertarsuarmik	Qeqertarsuaq<Instrumentalis
Qeqertarsuarmilli	Qeqertarsuaq<Instrumentalis+LI
Qeqertarsuarmillu	Qeqertarsuaq<Instrumentalis+LU
Qeqertarsuarminguna	Qeqertarsuaq<Instrumentalis+UNA
Qeqertarsuarmi	Qeqertarsuaq<Lokalis
Qeqertarsuarmili	Qeqertarsuaq<Lokalis+LI
Qeqertarsuarmiu	Qeqertarsuaq+MIU<ental<Absolut
Qeqertarsuarmiuninguna	Qeqertarsuaq+MIU<flertal<Instrumentalis+UNA
Qeqertarsuarmiuni	Qeqertarsuaq+MIU<flertal<Lokalis
Qeqertarsuarmiuniuna	Qeqertarsuaq+MIU<flertal<Lokalis+UNA
Qeqertarsuarmiulerigaluarnernut	Qeqertarsuaq+MIU-LIRI+GALUAR+NIQ<flertal<Terminalis
Qeqertarsuarmiulerippullu	Qeqertarsuaq+MIU-LIRI<Indikativ<de+LU
Qeqertarsuarmiulerivit	Qeqertarsuaq+MIU-LIRI<Interrogativ<du
Qeqertarsuarmiulerilaarlutik	Qeqertarsuaq+MIU-LIRI-LAAR<Ledsagemåde<de_selv
Qeqertarsuarmiulerilaarnertut	Qeqertarsuaq+MIU-LIRI-LAAR+NIQ<ental<Aequalis
Qeqertarsuarmiulerissagaluarput	Qeqertarsuaq+MIU-LIRI-SSA=GALUAR<Indikativ<de
Qeqertarsuarmiunngorpugullu	Qeqertarsuaq+MIU-NNGUR<Indikativ<vi+LU
Qeqertarsuarmiunngulaarnertut	Qeqertarsuaq+MIU-NNGUR-LAAR+NIQ<ental<Aequalis
Qeqertarsuarmiunngulaartarpungalu	Qeqertarsuaq+MIU-NNGUR-LAAR=TAR<Indikativ<jeg+LU
Qeqertarsuarmiunngulaartartorli	Qeqertarsuaq+MIU-NNGUR-LAAR=TAR<Participium<han+LI
Qeqertarsuarmiunngortaraluarlutik	Qeqertarsuaq+MIU-NNGUR+TAR=GALUAR<Ledsagemåde<de_selv
Qeqertarsuarmioqarpoq	Qeqertarsuaq+MIU-QAR<Indikativ<han
Qeqertarsuarmioqarporuna	Qeqertarsuaq+MIU-QAR<Indikativ<han+UNA
Qeqertarsuarmioqarnerli	Qeqertarsuaq+MIU-QAR+NIQ+LI
Qeqertarsuarmioqarneruna	Qeqertarsuaq+MIU-QAR+NIQ+UNA
Qeqertarsuarmioqartoq	Qeqertarsuaq+MIU-QAR<Participium<han
Qeqertarsuarmioqartorli	Qeqertarsuaq+MIU-QAR<Participium<han+LI
Qeqertarsuarmiuugaluarpit	Qeqertarsuaq+MIU-U+GALUAR<Interrogativ<du
Qeqertarsuarmiuugaluarneranuna	Qeqertarsuaq+MIU-U+GALUAR+NIQ<ental<deres+UNA
Qeqertarsuarmiuugaluarnerinuna	Qeqertarsuaq+MIU-U+GALUAR+NIQ<flertal<Absolut+UNA
Qeqertarsuarmiuulaartulli	Qeqertarsuaq+MIU-U-LAAR<Participium<de+LI
Qeqertarsuarmiuullutinguna	Qeqertarsuaq+MIU-U<Ledsagemåde<de_selv+UNA
Qeqertarsuarmiuunianngilarli	Qeqertarsuaq+MIU-U+NIAR=NNGIT<Indikativ<han+LI
Qeqertarsuarmiuuneq	Qeqertarsuaq+MIU-U+NIQ<ental<Absolut
Qeqertarsuarmiuusorlu	Qeqertarsuaq+MIU-U<Participium<han+LU
Qeqertarsuarmiuusimasunga	Qeqertarsuaq+MIU-U+SIMA<Participium<jeg
Qeqertarsuarmiuussagaluarpugununa	Qeqertarsuaq+MIU-U-SSA=GALUAR<Indikativ<vi+UNA
Qeqertarsuarmiuussaanga	Qeqertarsuaq+MIU-U-SSA<Indikativ<jeg
Qeqertarsuarmiuusaraluarpunga	Qeqertarsuaq+MIU-U+TAR=GALUAR<Indikativ<jeg
Qeqertarsuarmiuusarnerit	Qeqertarsuaq+MIU-U+TAR+NIQ<flertal<Relativ
Qeqertarsuarmut	Qeqertarsuaq<Terminalis
Qeqertarsuarmulli	Qeqertarsuaq<Terminalis+LI
Qeqertarsuarmununa	Qeqertarsuaq<Terminalis+UNA
sammisarigaluartigilli	sammisari+GALUAR<Imperativ<ViDem+LI
sammisarigaluarpaali	sammisari+GALUAR<Indikativ<HanHam+LI
sammisaritigit	sammisari<Imperativ<ViDem
sammisaritigilli	sammisari<Imperativ<ViDem+LI
sammisaritigillu	sammisari<Imperativ<ViDem+LU
sammisarivaat	sammisari<Indikativ<DeHam
sammisarivassili	sammisari<Indikativ<JegJer+LI
sammisarilaartigit	sammisari-LAAR<Imperativ<ViDem
sammisarilaartigillu	sammisari-LAAR<Imperativ<ViDem+LU
sammisarilaarpagut	sammisari-LAAR<Indikativ<ViDem
sammisarilaarpiuk	sammisari-LAAR<Interrogativ<DuHam
sammisarilaartarpaa	sammisari-LAAR=TAR<Indikativ<HanHam
sammisarilaartarpaana	sammisari-LAAR=TAR<Indikativ<HanHam+UNA
sammisarilaartarpassi	sammisari-LAAR=TAR<Indikativ<JegJer
sammisariniartigit	sammisari+NIAR<Imperativ<ViDem
sammisariniartigillu	sammisari+NIAR<Imperativ<ViDem+LU
sammisarinianngilaanuna	sammisari+NIAR=NNGIT<Indikativ<DeHam+UNA
sammisarinianngilaa	sammisari+NIAR=NNGIT<Indikativ<HanHam
sammisarinianngilaana	sammisari+NIAR=NNGIT<Indikativ<HanHam+UNA
sammisarinianngilassi	sammisari+NIAR=NNGIT<Indikativ<JegJer
sammisarinianngiliuk	sammisari+NIAR=NNGIT<Interrogativ<DuHam
sammisarinngilassiuna	sammisari-NNGIT<Indikativ<JegJer+UNA
sammisarinngilagununa	sammisari-NNGIT<Indikativ<ViDem+UNA
sammisarinngiliuk	sammisari-NNGIT<Interrogativ<DuHam
sammisarisimatiginuna	sammisari+SIMA<Imperativ<ViDem+UNA
sammisarisimavassi	sammisari+SIMA<Indikativ<JegJer
sammisarisimasarpaa	sammisari+SIMA=TAR<Indikativ<HanHam
sammisarisinnaatigit	sammisari+SINNAA<Imperativ<ViDem
sammisarisinnaatigilli	sammisari+SINNAA<Imperativ<ViDem+LI
sammisarisinnaavassi	sammisari+SINNAA<Indikativ<JegJer
sammisarissagaluartigillu	sammisari-SSA=GALUAR<Imperativ<ViDem+LU
sammisarissagaluarpaat	sammisari-SSA=GALUAR<Indikativ<DeHam
sammisarissagaluarpaa	sammisari-SSA=GALUAR<Indikativ<HanHam
sammisarissatigit	sammisari-SSA<Imperativ<ViDem
sammisarissatigillu	sammisari-SSA<Imperativ<ViDem+LU
sammisarissatiginuna	sammisari-SSA<Imperativ<ViDem+UNA
sammisarissavakkali	sammisari-SSA<Indikativ<JegDem+LI
sammisarissaviuk	sammisari-SSA<Interrogativ<DuHam
sammisarisaraluartigilli	sammisari+TAR=GALUAR<Imperativ<ViDem+LI
sammisarisaraluartigillu	sammisari+TAR=GALUAR<Imperativ<ViDem+LU
sammisarisartigilli	sammisari+TAR<Imperativ<ViDem+LI
sammisarisarpaa	sammisari+TAR<Indikativ<HanHam
sammisarisarpiuk	sammisari+TAR<Interrogativ<DuHam
sisamaannaat	sisamat-INNAQ<flertal<Absolut
sisamaannaa	sisamat-INNAQ<flertal<hans<Absolut
sisamaannarninguna	sisamat-INNAQ<flertal<Instrumentalis+UNA
sisamaannarnili	sisamat-INNAQ<flertal<Lokalis+LI
sisamaannaalli	sisamat-INNAQ<flertal<Relativ+LI
sisamaannarnullu	sisamat-INNAQ<flertal<Terminalis+LU
sisamaannalerivit	sisamat-INNAQ-LIRI<Interrogativ<du
sisamaannalerilaartarporli	sisamat-INNAQ-LIRI-LAAR=TAR<Indikativ<han+LI
sisamaannalerillutik	sisamat-INNAQ-LIRI<Ledsagemåde<de_selv
sisamaannalerinatik	sisamat-INNAQ-LIRI-NNGIT<Ledsagemåde<de_selv
sisamaannalerinngitsut	sisamat-INNAQ-LIRI-NNGIT<Participium<de
sisamaannalerisaraluarlutinguna	sisamat-INNAQ-LIRI+TAR=GALUAR<Ledsagemåde<de_selv+UNA
sisamaannanngulaarpit	sisamat-INNAQ-NNGUR-LAAR<Interrogativ<du
sisamaannanngulaartoruna	sisamat-INNAQ-NNGUR-LAAR<Participium<han+UNA
sisamaannanngulaartartut	sisamat-INNAQ-NNGUR-LAAR=TAR<Participium<de
sisamaannanngortarlutinguna	sisamat-INNAQ-NNGUR+TAR<Ledsagemåde<de_selv+UNA
sisamalittut	sisamat-LIK<ental<Aequalis
sisamalialu	sisamat-LIK<ental<hans<Absolut+LU
sisamalimmiikkaluarlutik	sisamat-LIK<ental<Lokalis+IP+GALUAR<Ledsagemåde<de_selv
sisamalinngorniarnatinguna	sisamat-LIK-NNGUR+NIAR=NNGIT<Ledsagemåde<de_selv+UNA
sisamalinngorsimasarlutik	sisamat-LIK-NNGUR+SIMA=TAR<Ledsagemåde<de_selv
sisamaleqalaartarpunga	sisamat-LIK-QAR-LAAR=TAR<Indikativ<jeg
sisamaleqalaartarpit	sisamat-LIK-QAR-LAAR=TAR<Interrogativ<du
sisamaleqalaartarlutilli	sisamat-LIK-QAR-LAAR=TAR<Ledsagemåde<de_selv+LI
sisamaleqalaartarnerit	sisamat-LIK-QAR-LAAR=TAR+NIQ<flertal<Relativ
sisamaleqarsimasarpunga	sisamat-LIK-QAR+SIMA=TAR<Indikativ<jeg
sisamaleqassagaluarlutillu	sisamat-LIK-QAR-SSA=GALUAR<Ledsagemåde<de_selv+LU
sisamaleqassagaluartorli	sisamat-LIK-QAR-SSA=GALUAR<Participium<han+LI
sisamaleqassaaruna	sisamat-LIK-QAR-SSA<Indikativ<han+UNA
sisamaleqassavit	sisamat-LIK-QAR-SSA<Interrogativ<du
sisamaleqartartungaana	sisamat-LIK-QAR+TAR<Participium<jeg+UNA
sisamanngorpungaana	sisamat-NNGUR<Indikativ<jeg+UNA
sisamanngorpit	sisamat-NNGUR<Interrogativ<du
sisamanngulaartarnernik	sisamat-NNGUR-LAAR=TAR+NIQ<flertal<Instrumentalis
sisamanngorlutik	sisamat-NNGUR<Ledsagemåde<de_selv
sisamanngorlutinguna	sisamat-NNGUR<Ledsagemåde<de_selv+UNA
sisamanngorniarpugununa	sisamat-NNGUR+NIAR<Indikativ<vi+UNA
sisamanngorsimavugut	sisamat-NNGUR+SIMA<Indikativ<vi
sisamanngussaanga	sisamat-NNGUR-SSA<Indikativ<jeg
sisamanngussaangaana	sisamat-NNGUR-SSA<Indikativ<jeg+UNA
sisamanngussaagununa	sisamat-NNGUR-SSA<Indikativ<vi+UNA
sisamanngortaraluarlutilli	sisamat-NNGUR+TAR=GALUAR<Ledsagemåde<de_selv+LI
sisamanngortaraluarneq	sisamat-NNGUR+TAR=GALUAR+NIQ<ental<Absolut
sisamatut	sisamat<Talord<Aequalis
sisamatulli	sisamat<Talord<Aequalis+LI
sisamatununa	sisamat<Talord<Aequalis+UNA
sisamaat	sisamat<Talord<ental<deres
sisamat	sisamat<Talord<flertal<Absolut
sisamanik	sisamat<Talord<Instrumentalis
sisamanilli	sisamat<Talord<Instrumentalis+LI
sisamanillu	sisamat<Talord<Instrumentalis+LU
sisamani	sisamat<Talord<Lokalis
sisamaniittunga	sisamat<Talord<Lokalis+IP<Participium<jeg
Sisimiut	Sisimiut<Absolut
Sisimiulli	Sisimiut<Absolut+LI
Sisimiullu	Sisimiut<Absolut+LU
Sisimiununa	Sisimiut<Absolut+UNA
Sisimiunik	Sisimiut<Instrumentalis
Sisimiunilli	Sisimiut<Instrumentalis+LI
Sisimiunillu	Sisimiut<Instrumentalis+LU
Sisimiuninguna	Sisimiut<Instrumentalis+UNA
Sisimiuni	Sisimiut<Lokalis
Sisimiunili	Sisimiut<Lokalis+LI
Sisimiunilu	Sisimiut<Lokalis+LU
Sisimiuniuna	Sisimiut<Lokalis+UNA
Sisimiormiuli	Sisimiut+MIU<ental<Absolut+LI
Sisimiormiumillu	Sisimiut+MIU<ental<Instrumentalis+LU
Sisimiormiumi	Sisimiut+MIU<ental<Lokalis
Sisimiormiuni	Sisimiut+MIU<flertal<Lokalis
Sisimiormiuniuna	Sisimiut+MIU<flertal<Lokalis+UNA
Sisimiormiulerivit	Sisimiut+MIU-LIRI<Interrogativ<du
Sisimiormiulerillutinguna	Sisimiut+MIU-LIRI<Ledsagemåde<de_selv+UNA
Sisimiormiulerinngitsunga	Sisimiut+MIU-LIRI-NNGIT<Participium<jeg
Sisimiormiulerisunga	Sisimiut+MIU-LIRI<Participium<jeg
Sisimiormiulerisinnaavit	Sisimiut+MIU-LIRI+SINNAA<Interrogativ<du
Sisimiormiulerissagaluartut	Sisimiut+MIU-LIRI-SSA=GALUAR<Participium<de
Sisimiormiunngulaartarneri	Sisimiut+MIU-NNGUR-LAAR=TAR+NIQ<flertal<hans<Absolut
Sisimiormiunngortungali	Sisimiut+MIU-NNGUR<Participium<jeg+LI
Sisimiormiunngorsinnaavoq	Sisimiut+MIU-NNGUR+SINNAA<Indikativ<han
Sisimiormiunngorsinnaasunga	Sisimiut+MIU-NNGUR+SINNAA<Participium<jeg
Sisimiormiunngussagaluarnerallu	Sisimiut+MIU-NNGUR-SSA=GALUAR+NIQ<ental<deres+LU
Sisimiormiunngortaraluarnerat	Sisimiut+MIU-NNGUR+TAR=GALUAR+NIQ<ental<deres
Sisimiormiunngortarnerili	Sisimiut+MIU-NNGUR+TAR+NIQ<flertal<hans<Absolut+LI
Sisimiormioqarneq	Sisimiut+MIU-QAR+NIQ
Sisimiormioqarnerli	Sisimiut+MIU-QAR+NIQ+LI
Sisimiormioqarnerlu	Sisimiut+MIU-QAR+NIQ+LU
Sisimiormioqarneruna	Sisimiut+MIU-QAR+NIQ+UNA
Sisimiormioqartoq	Sisimiut+MIU-QAR<Participium<han
Sisimiormioqartorli	Sisimiut+MIU-QAR<Participium<han+LI
Sisimiormiuugaluarpunga	Sisimiut+MIU-U+GALUAR<Indikativ<jeg
Sisimiormiuuit	Sisimiut+MIU-U<Interrogativ<du
Sisimiormiuuniarlutik	Sisimiut+MIU-U+NIAR<Ledsagemåde<de_selv
Sisimiormiuunerillu	Sisimiut+MIU-U+NIQ<flertal<Absolut+LU
Sisimiormiuusut	Sisimiut+MIU-U<Participium<de
Sisimiormiuusimaneq	Sisimiut+MIU-U+SIMA+NIQ<ental<Absolut
Sisimiormiuusimasarlutik	Sisimiut+MIU-U+SIMA=TAR<Ledsagemåde<de_selv
Sisimiormiuusimasarnerit	Sisimiut+MIU-U+SIMA=TAR+NIQ<flertal<Absolut
Sisimiormiuusimasarnerilu	Sisimiut+MIU-U+SIMA=TAR+NIQ<flertal<hans<Absolut+LU
Sisimiormiuusinnaavit	Sisimiut+MIU-U+SINNAA<Interrogativ<du
Sisimiormiuussagaluarpit	Sisimiut+MIU-U-SSA=GALUAR<Interrogativ<du
Sisimiormiuusarpugut	Sisimiut+MIU-U+TAR<Indikativ<vi
suligaluarpullu	suli+GALUAR<Indikativ<de+LU
suligaluarpununa	suli+GALUAR<Indikativ<de+UNA
suligaluarporli	suli+GALUAR<Indikativ<han+LI
suligaluarlutik	suli+GALUAR<Ledsagemåde<de_selv
suligaluarnertut	suli+GALUAR+NIQ<ental<Aequalis
suligaluartoq	suli+GALUAR<Participium<han
sulivorli	suli<Indikativ<han+LI
sulivoruna	suli<Indikativ<han+UNA
sulivugut	suli<Indikativ<vi
sulilaarpulli	suli-LAAR<Indikativ<de+LI
sulilaarlutinguna	suli-LAAR<Ledsagemåde<de_selv+UNA
sulilaarnernut	suli-LAAR+NIQ<flertal<Terminalis
sulilaartoruna	suli-LAAR<Participium<han+UNA
sulilaartarpit	suli-LAAR=TAR<Interrogativ<du
sulilaartarlutillu	suli-LAAR=TAR<Ledsagemåde<de_selv+LU
sulilaartarnermut	suli-LAAR=TAR+NIQ<ental<Terminalis
sulilaartartut	suli-LAAR=TAR<Participium<de
sulillutik	suli<Ledsagemåde<de_selv
sulillutilli	suli<Ledsagemåde<de_selv+LI
sulillutillu	suli<Ledsagemåde<de_selv+LU
suliniarput	suli+NIAR<Indikativ<de
suliniarlutik	suli+NIAR<Ledsagemåde<de_selv
suliniarneruna	suli+NIAR+NIQ<ental<Absolut+UNA
suliniarnatik	suli+NIAR=NNGIT<Ledsagemåde<de_selv
suliniarnatillu	suli+NIAR=NNGIT<Ledsagemåde<de_selv+LU
suliniannginnerniikkaluarlutik	suli+NIAR=NNGIT+NIQ<flertal<Lokalis+IP+GALUAR<Ledsagemåde<de_selv
sulineq	suli+NIQ<ental<Absolut
sulinernik	suli+NIQ<flertal<Instrumentalis
sulinngillallu	suli-NNGIT<Indikativ<de+LU
sulinngilanga	suli-NNGIT<Indikativ<jeg
sulinngilangaana	suli-NNGIT<Indikativ<jeg+UNA
sulinatinguna	suli-NNGIT<Ledsagemåde<de_selv+UNA
sulinnginnermut	suli-NNGIT+NIQ<ental<Terminalis
sulisullu	suli<Participium<de+LU
sulisoq	suli<Participium<han
sulisoruna	suli<Participium<han+UNA
sulisungaana	suli<Participium<jeg+UNA
SULI	SULI<Partikel
SULIli	SULI<Partikel+LI
SULIlu	SULI<Partikel+LU
SULIuna	SULI<Partikel+UNA
sulisimavorlu	suli+SIMA<Indikativ<han+LU
sulisimavit	suli+SIMA<Interrogativ<du
sulisimaneralli	suli+SIMA+NIQ<ental<deres+LI
sulisimaneriuna	suli+SIMA+NIQ<flertal<hans<Absolut+UNA
sulisimasungalu	suli+SIMA<Participium<jeg+LU
sulisimasarporli	suli+SIMA=TAR<Indikativ<han+LI
sulisimasarpit	suli+SIMA=TAR<Interrogativ<du
sulisimasarnerat	suli+SIMA=TAR+NIQ<ental<deres
sulisimasarnermulli	suli+SIMA=TAR+NIQ<ental<Terminalis+LI
sulisimasartungalu	suli+SIMA=TAR<Participium<jeg+LU
sulisinnaavit	suli+SINNAA<Interrogativ<du
sulisinnaasunga	suli+SINNAA<Participium<jeg
sulissagaluarpoq	suli-SSA=GALUAR<Indikativ<han
sulissagaluarpit	suli-SSA=GALUAR<Interrogativ<du
sulissapput	suli-SSA<Indikativ<de
sulissaarlu	suli-SSA<Indikativ<han+LU
sulissallutinguna	suli-SSA<Ledsagemåde<de_selv+UNA
sulissasut	suli-SSA<Participium<de
sulissasoq	suli-SSA<Participium<han
sulissasunga	suli-SSA<Participium<jeg
sulissasungali	suli-SSA<Participium<jeg+LI
sulisaraluarpunga	suli+TAR=GALUAR<Indikativ<jeg
sulisaraluarpungali	suli+TAR=GALUAR<Indikativ<jeg+LI
sulisaraluarpit	suli+TAR=GALUAR<Interrogativ<du
sulisarnerlu	suli+TAR+NIQ<ental<Absolut+LU
sulisartununa	suli+TAR<Participium<de+UNA
taagaluartigit	taa+GALUAR<Imperativ<ViDem
taagaluartigilli	taa+GALUAR<Imperativ<ViDem+LI
taaguullu	taaguut<ental<Absolut+LU
taaguutaa	taaguut<ental<hans<Absolut
taaguummut	taaguut<ental<Terminalis
taaguummulli	taaguut<ental<Terminalis+LI
taatigilli	taa<Imperativ<ViDem+LI
taatigillu	taa<Imperativ<ViDem+LU
taatiginuna	taa<Imperativ<ViDem+UNA
taavakkaana	taa<Indikativ<JegDem+UNA
taaviuk	taa<Interrogativ<DuHam
taalaartigit	taa-LAAR<Imperativ<ViDem
taalaarpassi	taa-LAAR<Indikativ<JegJer
taalaarpiuk	taa-LAAR<Interrogativ<DuHam
taamanilu	taamani<Partikel+LU
taaniarpiuk	taa+NIAR<Interrogativ<DuHam
taanianngilaana	taa+NIAR=NNGIT<Indikativ<HanHam+UNA
taanianngilassi	taa+NIAR=NNGIT<Indikativ<JegJer
taanna	taanna<Pronomen<ental
taanngiliuk	taa-NNGIT<Interrogativ<DuHam
taasimasarpiuk	taa+SIMA=TAR<Interrogativ<DuHam
taasinnaatigit	taa+SINNAA<Imperativ<ViDem
taasinnaaviuk	taa+SINNAA<Interrogativ<DuHam
taassagaluarpaa	taa-SSA=GALUAR<Indikativ<HanHam
taassatiginuna	taa-SSA<Imperativ<ViDem+UNA
taasartigit	taa+TAR<Imperativ<ViDem
taasartigilli	taa+TAR<Imperativ<ViDem+LI
tallimaannaauna	tallimat-INNAQ<flertal<hans<Absolut+UNA
tallimaannarni	tallimat-INNAQ<flertal<Lokalis
tallimaannarnulli	tallimat-INNAQ<flertal<Terminalis+LI
tallimaannalerilaartarpit	tallimat-INNAQ-LIRI-LAAR=TAR<Interrogativ<du
tallimaannanngorpit	tallimat-INNAQ-NNGUR<Interrogativ<du
tallimaannanngornerat	tallimat-INNAQ-NNGUR+NIQ<ental<deres
tallimaannanngortut	tallimat-INNAQ-NNGUR<Participium<de
tallimaannanngortullu	tallimat-INNAQ-NNGUR<Participium<de+LU
tallimalittullu	tallimat-LIK<ental<Aequalis+LU
tallimaleqalaartarpungali	tallimat-LIK-QAR-LAAR=TAR<Indikativ<jeg+LI
tallimaleqarsinnaallutik	tallimat-LIK-QAR+SINNAA<Ledsagemåde<de_selv
tallimaleqassavit	tallimat-LIK-QAR-SSA<Interrogativ<du
tallimaleqassallutilli	tallimat-LIK-QAR-SSA<Ledsagemåde<de_selv+LI
tallimaliulaarpungaana	tallimat-LIK-U-LAAR<Indikativ<jeg+UNA
tallimanngoraluarpunga	tallimat-NNGUR+GALUAR<Indikativ<jeg
tallimanngorpungali	tallimat-NNGUR<Indikativ<jeg+LI
tallimanngorsimasarpungaana	tallimat-NNGUR+SIMA=TAR<Indikativ<jeg+UNA
tallimanngorsimasarlutik	tallimat-NNGUR+SIMA=TAR<Ledsagemåde<de_selv
tallimanngussagaluarpit	tallimat-NNGUR-SSA=GALUAR<Interrogativ<du
tallimanngussagaluarnerat	tallimat-NNGUR-SSA=GALUAR+NIQ<ental<deres
tallimanngussasulli	tallimat-NNGUR-SSA<Participium<de+LI
tallimatut	tallimat<Talord<Aequalis
tallimatullu	tallimat<Talord<Aequalis+LU
tallimaat	tallimat<Talord<ental<deres
tallimaalli	tallimat<Talord<ental<deres+LI
tallimaninguna	tallimat<Talord<Instrumentalis+UNA
tamarmik	tamarmik<Adjektiv
tamarmilli	tamarmik<Adjektiv+LI
tamarmillu	tamarmik<Adjektiv+LU
tamarminguna	tamarmik<Adjektiv+UNA
Tasiilaq	Tasiilaq<Absolut
Tasiilarli	Tasiilaq<Absolut+LI
Tasiilarlu	Tasiilaq<Absolut+LU
Tasiilaruna	Tasiilaq<Absolut+UNA
Tasiilamik	Tasiilaq<Instrumentalis
Tasiilamilli	Tasiilaq<Instrumentalis+LI
Tasiilamillu	Tasiilaq<Instrumentalis+LU
Tasiilaminguna	Tasiilaq<Instrumentalis+UNA
Tasiilami	Tasiilaq<Lokalis
Tasiilamili	Tasiilaq<Lokalis+LI
Tasiilamilu	Tasiilaq<Lokalis+LU
Tasiilamiuna	Tasiilaq<Lokalis+UNA
Tasiilarmiumulli	Tasiilaq+MIU<ental<Terminalis+LI
Tasiilarmiumununa	Tasiilaq+MIU<ental<Terminalis+UNA
Tasiilarmiunik	Tasiilaq+MIU<flertal<Instrumentalis
Tasiilarmiunillu	Tasiilaq+MIU<flertal<Instrumentalis+LU
Tasiilarmiuni	Tasiilaq+MIU<flertal<Lokalis
Tasiilarmiulerilaarpulli	Tasiilaq+MIU-LIRI-LAAR<Indikativ<de+LI
Tasiilarmiulerillutinguna	Tasiilaq+MIU-LIRI<Ledsagemåde<de_selv+UNA
Tasiilarmiuleriniarnerninguna	Tasiilaq+MIU-LIRI+NIAR+NIQ<flertal<Instrumentalis+UNA
Tasiilarmiuleriniannginnerinuna	Tasiilaq+MIU-LIRI+NIAR=NNGIT+NIQ<flertal<Relativ+UNA
Tasiilarmiulerisaraluartoruna	Tasiilaq+MIU-LIRI+TAR=GALUAR<Participium<han+UNA
Tasiilarmiunngorput	Tasiilaq+MIU-NNGUR<Indikativ<de
Tasiilarmiunngorpit	Tasiilaq+MIU-NNGUR<Interrogativ<du
Tasiilarmiunngulaarporuna	Tasiilaq+MIU-NNGUR-LAAR<Indikativ<han+UNA
Tasiilarmiunngulaarnerat	Tasiilaq+MIU-NNGUR-LAAR+NIQ<ental<deres
Tasiilarmiunngortulli	Tasiilaq+MIU-NNGUR<Participium<de+LI
Tasiilarmiunngussagaluarporli	Tasiilaq+MIU-NNGUR-SSA=GALUAR<Indikativ<han+LI
Tasiilarmiunngussallutik	Tasiilaq+MIU-NNGUR-SSA<Ledsagemåde<de_selv
Tasiilarmioqarpoq	Tasiilaq+MIU-QAR<Indikativ<han
Tasiilarmioqarporli	Tasiilaq+MIU-QAR<Indikativ<han+LI
Tasiilarmioqarporlu	Tasiilaq+MIU-QAR<Indikativ<han+LU
Tasiilarmioqarporuna	Tasiilaq+MIU-QAR<Indikativ<han+UNA
Tasiilarmioqarneq	Tasiilaq+MIU-QAR+NIQ
Tasiilarmioqarnerlu	Tasiilaq+MIU-QAR+NIQ+LU
Tasiilarmioqarneruna	Tasiilaq+MIU-QAR+NIQ+UNA
Tasiilarmioqartoq	Tasiilaq+MIU-QAR<Participium<han
Tasiilarmioqartorlu	Tasiilaq+MIU-QAR<Participium<han+LU
Tasiilarmioqartoruna	Tasiilaq+MIU-QAR<Participium<han+UNA
Tasiilarmiuugaluarporuna	Tasiilaq+MIU-U+GALUAR<Indikativ<han+UNA
Tasiilarmiuugaluarlutik	Tasiilaq+MIU-U+GALUAR<Ledsagemåde<de_selv
Tasiilarmiuulaartulli	Tasiilaq+MIU-U-LAAR<Participium<de+LI
Tasiilarmiuullutillu	Tasiilaq+MIU-U<Ledsagemåde<de_selv+LU
Tasiilarmiuuniannginnera	Tasiilaq+MIU-U+NIAR=NNGIT+NIQ<ental<hans<Absolut
Tasiilarmiuuneq	Tasiilaq+MIU-U+NIQ<ental<Absolut
Tasiilarmiuunerilli	Tasiilaq+MIU-U+NIQ<flertal<Relativ+LI
Tasiilarmiuunerinuna	Tasiilaq+MIU-U+NIQ<flertal<Relativ+UNA
Tasiilarmiuusunga	Tasiilaq+MIU-U<Participium<jeg
Tasiilarmiuusimasarpullu	Tasiilaq+MIU-U+SIMA=TAR<Indikativ<de+LU
Tasiilarmiuusimasarpit	Tasiilaq+MIU-U+SIMA=TAR<Interrogativ<du
Tasiilarmiuussagaluarlutik	Tasiilaq+MIU-U-SSA=GALUAR<Ledsagemåde<de_selv
Tasiilamut	Tasiilaq<Terminalis
Tasiilamulli	Tasiilaq<Terminalis+LI
Tasiilamullu	Tasiilaq<Terminalis+LU
Tasiilamununa	Tasiilaq<Terminalis+UNA
tassa	tassa<Partikel
tassali	tassa<Partikel+LI
tassalu	tassa<Partikel+LU
tassaana	tassa<Partikel+UNA
tutsiuteqqikkaluarput	tutsiuteqqip+GALUAR<Indikativ<de
tutsiuteqqikkaluarporuna	tutsiuteqqip+GALUAR<Indikativ<han+UNA
tutsiuteqqikkaluarpungalu	tutsiuteqqip+GALUAR<Indikativ<jeg+LU
tutsiuteqqikkaluarlutik	tutsiuteqqip+GALUAR<Ledsagemåde<de_selv
tutsiuteqqikkaluarlutilli	tutsiuteqqip+GALUAR<Ledsagemåde<de_selv+LI
tutsiuteqqikkaluarlutillu	tutsiuteqqip+GALUAR<Ledsagemåde<de_selv+LU
tutsiuteqqikkaluarlutinguna	tutsiuteqqip+GALUAR<Ledsagemåde<de_selv+UNA
tutsiuteqqikkaluarneq	tutsiuteqqip+GALUAR+NIQ<ental<Absolut
tutsiuteqqikkaluarnertullu	tutsiuteqqip+GALUAR+NIQ<ental<Aequalis+LU
tutsiuteqqikkaluarnerallu	tutsiuteqqip+GALUAR+NIQ<ental<deres+LU
tutsiuteqqikkaluarnerillu	tutsiuteqqip+GALUAR+NIQ<flertal<Absolut+LU
tutsiuteqqikkaluarnerinuna	tutsiuteqqip+GALUAR+NIQ<flertal<Absolut+UNA
tutsiuteqqikkaluartullu	tutsiuteqqip+GALUAR<Participium<de+LU
tutsiuteqqikkaluartunga	tutsiuteqqip+GALUAR<Participium<jeg
tutsiuteqqikkaluartungalu	tutsiuteqqip+GALUAR<Participium<jeg+LU
tutsiuteqqippulli	tutsiuteqqip<Indikativ<de+LI
tutsiuteqqippullu	tutsiuteqqip<Indikativ<de+LU
tutsiuteqqipporlu	tutsiuteqqip<Indikativ<han+LU
tutsiuteqqippunga	tutsiuteqqip<Indikativ<jeg
tutsiuteqqippungaana	tutsiuteqqip<Indikativ<jeg+UNA
tutsiuteqqippugullu	tutsiuteqqip<Indikativ<vi+LU
tutsiuteqqippit	tutsiuteqqip<Interrogativ<du
tutsiuteqqilaarpullu	tutsiuteqqip-LAAR<Indikativ<de+LU
tutsiuteqqilaarpit	tutsiuteqqip-LAAR<Interrogativ<du
tutsiuteqqilaarlutilli	tutsiuteqqip-LAAR<Ledsagemåde<de_selv+LI
tutsiuteqqilaartoq	tutsiuteqqip-LAAR<Participium<han
tutsiuteqqilaartunga	tutsiuteqqip-LAAR<Participium<jeg
tutsiuteqqilaartungalu	tutsiuteqqip-LAAR<Participium<jeg+LU
tutsiuteqqilaartarpungali	tutsiuteqqip-LAAR=TAR<Indikativ<jeg+LI
tutsiuteqqilaartarlutik	tutsiuteqqip-LAAR=TAR<Ledsagemåde<de_selv
tutsiuteqqillutik	tutsiuteqqip<Ledsagemåde<de_selv
tutsiuteqqillutillu	tutsiuteqqip<Ledsagemåde<de_selv+LU
tutsiuteqqillutinguna	tutsiuteqqip<Ledsagemåde<de_selv+UNA
tutsiuteqqinniarput	tutsiuteqqip+NIAR<Indikativ<de
tutsiuteqqinniarpunga	tutsiuteqqip+NIAR<Indikativ<jeg
tutsiuteqqinniarpit	tutsiuteqqip+NIAR<Interrogativ<du
tutsiuteqqinniarlutik	tutsiuteqqip+NIAR<Ledsagemåde<de_selv
tutsiuteqqinniarnerninguna	tutsiuteqqip+NIAR+NIQ<flertal<Instrumentalis+UNA
tutsiuteqqinnianngilatit	tutsiuteqqip+NIAR=NNGIT<Interrogativ<du
tutsiuteqqinniarnatik	tutsiuteqqip+NIAR=NNGIT<Ledsagemåde<de_selv
tutsiuteqqinniartorlu	tutsiuteqqip+NIAR<Participium<han+LU
tutsiuteqqinnertut	tutsiuteqqip+NIQ<ental<Aequalis
tutsiuteqqinneranuna	tutsiuteqqip+NIQ<ental<deres+UNA
tutsiuteqqinnernik	tutsiuteqqip+NIQ<flertal<Instrumentalis
tutsiuteqqinnerni	tutsiuteqqip+NIQ<flertal<Lokalis
tutsiuteqqinngillat	tutsiuteqqip-NNGIT<Indikativ<de
tutsiuteqqinngilanga	tutsiuteqqip-NNGIT<Indikativ<jeg
tutsiuteqqinngilatit	tutsiuteqqip-NNGIT<Interrogativ<du
tutsiuteqqinnatilli	tutsiuteqqip-NNGIT<Ledsagemåde<de_selv+LI
tutsiuteqqinnatillu	tutsiuteqqip-NNGIT<Ledsagemåde<de_selv+LU
tutsiuteqqinnginnernilli	tutsiuteqqip-NNGIT+NIQ<flertal<Instrumentalis+LI
tutsiuteqqinngitsut	tutsiuteqqip-NNGIT<Participium<de
tutsiuteqqittut	tutsiuteqqip<Participium<de
tutsiuteqqittullu	tutsiuteqqip<Participium<de+LU
tutsiuteqqittorli	tutsiuteqqip<Participium<han+LI
tutsiuteqqittorlu	tutsiuteqqip<Participium<han+LU
tutsiuteqqittunga	tutsiuteqqip<Participium<jeg
tutsiuteqqittungalu	tutsiuteqqip<Participium<jeg+LU
tutsiuteqqissimavoruna	tutsiuteqqip+SIMA<Indikativ<han+UNA
tutsiuteqqissimanertullu	tutsiuteqqip+SIMA+NIQ<ental<Aequalis+LU
tutsiuteqqissimasoruna	tutsiuteqqip+SIMA<Participium<han+UNA
tutsiuteqqissimasarput	tutsiuteqqip+SIMA=TAR<Indikativ<de
tutsiuteqqissimasarpit	tutsiuteqqip+SIMA=TAR<Interrogativ<du
tutsiuteqqissimasartungalu	tutsiuteqqip+SIMA=TAR<Participium<jeg+LU
tutsiuteqqissinnaallutilli	tutsiuteqqip+SINNAA<Ledsagemåde<de_selv+LI
tutsiuteqqissinnaaneralu	tutsiuteqqip+SINNAA+NIQ<ental<hans<Absolut+LU
tutsiuteqqissinnaasunga	tutsiuteqqip+SINNAA<Participium<jeg
tutsiuteqqissinnaasungaana	tutsiuteqqip+SINNAA<Participium<jeg+UNA
tutsiuteqqissagaluartungaana	tutsiuteqqip-SSA=GALUAR<Participium<jeg+UNA
tutsiuteqqittaraluarporli	tutsiuteqqip+TAR=GALUAR<Indikativ<han+LI
tutsiuteqqittaraluarporuna	tutsiuteqqip+TAR=GALUAR<Indikativ<han+UNA
tutsiuteqqittaraluarnerni	tutsiuteqqip+TAR=GALUAR+NIQ<flertal<Lokalis
tutsiuteqqittaraluartunga	tutsiuteqqip+TAR=GALUAR<Participium<jeg
tutsiuteqqittarpugut	tutsiuteqqip+TAR<Indikativ<vi
tutsiuteqqittarpit	tutsiuteqqip+TAR<Interrogativ<du
tutsiuteqqittarnerli	tutsiuteqqip+TAR+NIQ<ental<Absolut+LI
tutsiuteqqittarneri	tutsiuteqqip+TAR+NIQ<flertal<hans<Absolut
tutsiuteqqittartunga	tutsiuteqqip+TAR<Participium<jeg
uagut	uagut<Pronomen<flertal
uagulli	uagut<Pronomen<flertal+LI
uagullu	uagut<Pronomen<flertal+LU
uagununa	uagut<Pronomen<flertal+UNA
uanga	uanga<Pronomen<ental
uangali	uanga<Pronomen<ental+LI
uangalu	uanga<Pronomen<ental+LU
uangaana	uanga<Pronomen<ental+UNA
ukioq	ukioq<ental<Absolut
ukiorli	ukioq<ental<Absolut+LI
ukiorlu	ukioq<ental<Absolut+LU
ukioruna	ukioq<ental<Absolut+UNA
ukiuat	ukioq<ental<deres<Absolut
ukiualli	ukioq<ental<deres<Absolut+LI
ukiuanuna	ukioq<ental<deres<Absolut+UNA
ukiuali	ukioq<ental<hans<Absolut+LI
ukiuminguna	ukioq<ental<Instrumentalis+UNA
ukiumiippunga	ukioq<ental<Lokalis+IP<Indikativ<jeg
ukiui	ukioq<flertal<hans<Absolut
ukiuili	ukioq<flertal<hans<Absolut+LI
ukiunut	ukioq<flertal<Terminalis
ukiunullu	ukioq<flertal<Terminalis+LU
ukiorilaartartigit	ukioq+GӘ-LAAR=TAR<Imperativ<ViDem
ukiorinianngilagulli	ukioq+GӘ+NIAR=NNGIT<Indikativ<ViDem+LI
ukiorisimasartiginuna	ukioq+GӘ+SIMA=TAR<Imperativ<ViDem+UNA
ukiorisinnaavaannga	ukioq+GӘ+SINNAA<Indikativ<DeMig
ukiorissagaluarpiuk	ukioq+GӘ-SSA=GALUAR<Interrogativ<DuHam
ukiorissatigillu	ukioq+GӘ-SSA<Imperativ<ViDem+LU
ukiorissavaa	ukioq+GӘ-SSA<Indikativ<HanHam
ukiorisaraluarpassi	ukioq+GӘ+TAR=GALUAR<Indikativ<JegJer
ukiuinnaalli	ukioq-INNAQ<ental<deres<Absolut+LI
ukiuinnaalli	ukioq-INNAQ<flertal<Absolut+LI
ukiuinnaallu	ukioq-INNAQ<flertal<Absolut+LU
ukiuinnalerisaraluarpunga	ukioq-INNAQ-LIRI+TAR=GALUAR<Indikativ<jeg
ukiuinnalerisaraluartungali	ukioq-INNAQ-LIRI+TAR=GALUAR<Participium<jeg+LI
ukiuinnanngussagaluarpugut	ukioq-INNAQ-NNGUR-SSA=GALUAR<Indikativ<vi
ukiuinnaalaartartullu	ukioq-INNAQ-U-LAAR=TAR<Participium<de+LU
ukiulia	ukioq-LIK<ental<hans<Absolut
ukiullit	ukioq-LIK<flertal<Absolut
ukiullilli	ukioq-LIK<flertal<Absolut+LI
ukiulinnilu	ukioq-LIK<flertal<Lokalis+LU
ukiullit	ukioq-LIK<flertal<Relativ
ukiunngorporlu	ukioq-NNGUR<Indikativ<han+LU
ukiunngulaarneruna	ukioq-NNGUR-LAAR+NIQ+UNA
ukiunngorniarporuna	ukioq-NNGUR+NIAR<Indikativ<han+UNA
ukiunngorneruna	ukioq-NNGUR+NIQ+UNA
ukiunngunnginnernilu	ukioq-NNGUR-NNGIT+NIQ<flertal<Lokalis+LU
ukiunngussagaluarneq	ukioq-NNGUR-SSA=GALUAR+NIQ
ukiunngortaraluarporli	ukioq-NNGUR+TAR=GALUAR<Indikativ<han+LI
ukiorpassuinuna	ukioq+PASSUAQ<flertal<Absolut+UNA
ukiorpassuartulli	ukioq+PASSUAQ<flertal<Aequalis+LI
ukiorpassuartullu	ukioq+PASSUAQ<flertal<Aequalis+LU
ukiorpassui	ukioq+PASSUAQ<flertal<hans<Absolut
ukiorpassuarni	ukioq+PASSUAQ<flertal<Lokalis
ukiorpassuarnut	ukioq+PASSUAQ<flertal<Terminalis
ukioqarporlu	ukioq-QAR<Indikativ<han+LU
ukioqalaarpoq	ukioq-QAR-LAAR<Indikativ<han
ukioqalaarporuna	ukioq-QAR-LAAR<Indikativ<han+UNA
ukioqalaarnerli	ukioq-QAR-LAAR+NIQ+LI
ukioqalaartarporuna	ukioq-QAR-LAAR=TAR<Indikativ<han+UNA
ukioqalaartartoruna	ukioq-QAR-LAAR=TAR<Participium<han+UNA
ukioqanngilaruna	ukioq-QAR-NNGIT<Indikativ<han+UNA
ukioqassagaluarnerlu	ukioq-QAR-SSA=GALUAR+NIQ+LU
ukioqassagaluartoruna	ukioq-QAR-SSA=GALUAR<Participium<han+UNA
ukioqassasoq	ukioq-QAR-SSA<Participium<han
ukioqassasorlu	ukioq-QAR-SSA<Participium<han+LU
ukiuuvunga	ukioq-U<Indikativ<jeg
ukiuulaarneq	ukioq-U-LAAR+NIQ<ental<Absolut
ukiuuniarlutillu	ukioq-U+NIAR<Ledsagemåde<de_selv+LU
ukiuuneq	ukioq-U+NIQ<ental<Absolut
ukiuunerinuna	ukioq-U+NIQ<flertal<Absolut+UNA
ukiuunernut	ukioq-U+NIQ<flertal<Terminalis
ukiuussagaluarpit	ukioq-U-SSA=GALUAR<Interrogativ<du
ulloq	ulloq<ental<Absolut
ullorlu	ulloq<ental<Absolut+LU
ulloruna	ulloq<ental<Absolut+UNA
ullutulli	ulloq<ental<Aequalis+LI
ullua	ulloq<ental<hans<Absolut
ullumillu	ulloq<ental<Instrumentalis+LU
ulluminguna	ulloq<ental<Instrumentalis+UNA
ullora	ulloq<ental<min<Absolut
ulloralu	ulloq<ental<min<Absolut+LU
ullumi	ulloq<enta<Lokalisl
ullumiilaarpit	ulloq<enta<Lokalisl+IP-LAAR<Interrogativ<du
ullumiillutilli	ulloq<enta<Lokalisl+IP<Ledsagemåde<de_selv+LI
ulluniillutillu	ulloq<flertal<Lokalis+IP<Ledsagemåde<de_selv+LU
ulluniuna	ulloq<flertal<Lokalis+UNA
ullorisimasarpakkali	ulloq+GӘ+SIMA=TAR<Indikativ<JegDem+LI
ulluinnaat	ulloq-INNAQ<ental<deres<Absolut
ulluinnaanuna	ulloq-INNAQ<ental<deres<Absolut+UNA
ulluinnanngulaarlutinguna	ulloq-INNAQ-NNGUR-LAAR<Ledsagemåde<de_selv+UNA
ulluinnanngorsimavit	ulloq-INNAQ-NNGUR+SIMA<Interrogativ<du
ulluinnaqassaaq	ulloq-INNAQ-QAR-SSA<Indikativ<han
ullullit	ulloq-LIK<flertal<Absolut
ullullilli	ulloq-LIK<flertal<Absolut+LI
ullulinngulaartarneriuna	ulloq-LIK-NNGUR-LAAR=TAR+NIQ<flertal<hans<Absolut+UNA
ullulerilaartunga	ulloq-LIRI-LAAR<Participium<jeg
ullulerillutik	ulloq-LIRI<Ledsagemåde<de_selv
ullulerillutillu	ulloq-LIRI<Ledsagemåde<de_selv+LU
ulluleriniannginnerli	ulloq-LIRI+NIAR=NNGIT+NIQ<ental<Absolut+LI
ullormiumi	ulloq+MIU<ental<Lokalis
ullormiulerineralu	ulloq+MIU-LIRI+NIQ<ental<hans<Absolut+LU
ullormioqarpoq	ulloq+MIU-QAR<Indikativ<han
ullormioqarporlu	ulloq+MIU-QAR<Indikativ<han+LU
ullormioqartoq	ulloq+MIU-QAR<Participium<han
ullunngulaartarlutilli	ulloq-NNGUR-LAAR=TAR<Ledsagemåde<de_selv+LI
ullunngulaartartungaana	ulloq-NNGUR-LAAR=TAR<Participium<jeg+UNA
ullunngussappununa	ulloq-NNGUR-SSA<Indikativ<de+UNA
ullorpassuartut	ulloq+PASSUAQ<flertal<Aequalis
ulloqarpit	ulloq-QAR<Interrogativ<du
ulloqalaarpit	ulloq-QAR-LAAR<Interrogativ<du
ulloqalaartarpit	ulloq-QAR-LAAR=TAR<Interrogativ<du
ulloqalaartarlutik	ulloq-QAR-LAAR=TAR<Ledsagemåde<de_selv
ulloqanngilanga	ulloq-QAR-NNGIT<Indikativ<jeg
ulloqanngilatit	ulloq-QAR-NNGIT<Interrogativ<du
ulloqannginneriuna	ulloq-QAR-NNGIT+NIQ<flertal<hans<Absolut+UNA
ulloqarsimallutilli	ulloq-QAR+SIMA<Ledsagemåde<de_selv+LI
ulloqassaanga	ulloq-QAR-SSA<Indikativ<jeg
ulloqassallutinguna	ulloq-QAR-SSA<Ledsagemåde<de_selv+UNA
ulloqassasoruna	ulloq-QAR-SSA<Participium<han+UNA
ulloqartarpungaana	ulloq-QAR+TAR<Indikativ<jeg+UNA
ulluulaarnertullu	ulloq-U-LAAR+NIQ<ental<Aequalis+LU
ulluullutilli	ulloq-U<Ledsagemåde<de_selv+LI
ulluuniarpugununa	ulloq-U+NIAR<Indikativ<vi+UNA
ulluusaraluartulli	ulloq-U+TAR=GALUAR<Participium<de+LI
ullumi	ullumi<Partikel
ullumili	ullumi<Partikel+LI
ullumilu	ullumi<Partikel+LU
ullumiuna	ullumi<Partikel+UNA
Upernavik	Upernavik<Absolut
Upernavilli	Upernavik<Absolut+LI
Upernavillu	Upernavik<Absolut+LU
Upernavinguna	Upernavik<Absolut+UNA
Upernavimmik	Upernavik<Instrumentalis
Upernavimminguna	Upernavik<Instrumentalis+UNA
Upernavimmi	Upernavik<Lokalis
Upernavimmilu	Upernavik<Lokalis+LU
Upernavimmiuna	Upernavik<Lokalis+UNA
Upernavimmiuli	Upernavik+MIU<ental<Absolut+LI
Upernavimmiunilli	Upernavik+MIU<flertal<Instrumentalis+LI
Upernavimmiuleriniarnatik	Upernavik+MIU-LIRI+NIAR=NNGIT<Ledsagemåde<de_selv
Upernavimmiunngussagaluarlutilli	Upernavik+MIU-NNGUR-SSA=GALUAR<Ledsagemåde<de_selv+LI
Upernavimmioqarporli	Upernavik+MIU-QAR<Indikativ<han+LI
Upernavimmioqarneq	Upernavik+MIU-QAR+NIQ
Upernavimmioqarnerlu	Upernavik+MIU-QAR+NIQ+LU
Upernavimmioqarneruna	Upernavik+MIU-QAR+NIQ+UNA
Upernavimmioqartoq	Upernavik+MIU-QAR<Participium<han
Upernavimmioqartorli	Upernavik+MIU-QAR<Participium<han+LI
Upernavimmiuugaluarpit	Upernavik+MIU-U+GALUAR<Interrogativ<du
Upernavimmiuugaluarlutik	Upernavik+MIU-U+GALUAR<Ledsagemåde<de_selv
Upernavimmiuugaluartut	Upernavik+MIU-U+GALUAR<Participium<de
Upernavimmiuullutik	Upernavik+MIU-U<Ledsagemåde<de_selv
Upernavimmiuuniannginnerit	Upernavik+MIU-U+NIAR=NNGIT+NIQ<flertal<Absolut
Upernavimmiuuneq	Upernavik+MIU-U+NIQ<ental<Absolut
Upernavimmiuusinnaavit	Upernavik+MIU-U+SINNAA<Interrogativ<du
Upernavimmiuusinnaallutinguna	Upernavik+MIU-U+SINNAA<Ledsagemåde<de_selv+UNA
Upernavimmiuusaraluarpugut	Upernavik+MIU-U+TAR=GALUAR<Indikativ<vi
Upernavimmut	Upernavik<Terminalis
Upernavimmulli	Upernavik<Terminalis+LI
Upernavimmullu	Upernavik<Terminalis+LU
Uummannaq	Uummannaq<Absolut
Uummannarli	Uummannaq<Absolut+LI
Uummannarlu	Uummannaq<Absolut+LU
Uummannaruna	Uummannaq<Absolut+UNA
Uummannamik	Uummannaq<Instrumentalis
Uummannamilli	Uummannaq<Instrumentalis+LI
Uummannamillu	Uummannaq<Instrumentalis+LU
Uummannaminguna	Uummannaq<Instrumentalis+UNA
Uummannami	Uummannaq<Lokalis
Uummannamili	Uummannaq<Lokalis+LI
Uummannamilu	Uummannaq<Lokalis+LU
Uummannamiuna	Uummannaq<Lokalis+UNA
Uummannarmiu	Uummannaq+MIU<ental<Absolut
Uummannarmiuni	Uummannaq+MIU<flertal<Lokalis
Uummannarmiuniuna	Uummannaq+MIU<flertal<Lokalis+UNA
Uummannarmiunngussagaluarpununa	Uummannaq+MIU-NNGUR-SSA=GALUAR<Indikativ<de+UNA
Uummannarmiunngortarpunga	Uummannaq+MIU-NNGUR+TAR<Indikativ<jeg
Uummannarmioqarpoq	Uummannaq+MIU-QAR<Indikativ<han
Uummannarmioqarporli	Uummannaq+MIU-QAR<Indikativ<han+LI
Uummannarmioqarporlu	Uummannaq+MIU-QAR<Indikativ<han+LU
Uummannarmioqarporuna	Uummannaq+MIU-QAR<Indikativ<han+UNA
Uummannarmioqarneq	Uummannaq+MIU-QAR+NIQ
Uummannarmioqarnerlu	Uummannaq+MIU-QAR+NIQ+LU
Uummannarmioqarneruna	Uummannaq+MIU-QAR+NIQ+UNA
Uummannarmiuugaluartut	Uummannaq+MIU-U+GALUAR<Participium<de
Uummannarmiuuppulli	Uummannaq+MIU-U<Indikativ<de+LI
Uummannarmiuuit	Uummannaq+MIU-U<Interrogativ<du
Uummannarmiuulaartunga	Uummannaq+MIU-U-LAAR<Participium<jeg
Uummannarmiuulaartarneralli	Uummannaq+MIU-U-LAAR=TAR+NIQ<ental<deres+LI
Uummannarmiuullutik	Uummannaq+MIU-U<Ledsagemåde<de_selv
Uummannarmiuuniarnatik	Uummannaq+MIU-U+NIAR=NNGIT<Ledsagemåde<de_selv
Uummannarmiuuniartut	Uummannaq+MIU-U+NIAR<Participium<de
Uummannarmiuuneq	Uummannaq+MIU-U+NIQ<ental<Absolut
Uummannarmiuuneri	Uummannaq+MIU-U+NIQ<flertal<hans<Absolut
Uummannarmiuunerillu	Uummannaq+MIU-U+NIQ<flertal<Relativ+LU
Uummannarmiuusimasarpungali	Uummannaq+MIU-U+SIMA=TAR<Indikativ<jeg+LI
Uummannarmiuusimasartoq	Uummannaq+MIU-U+SIMA=TAR<Participium<han
Uummannamut	Uummannaq<Terminalis
Uummannamulli	Uummannaq<Terminalis+LI
Uummannamullu	Uummannaq<Terminalis+LU
Uummannamununa	Uummannaq<Terminalis+UNA
