aallariartorpoq	aallar+GIARTUR<Indikativ<han
aallariartorpisi	aallar+GIARTUR<Interrogativ<I
aallariartortoq	aallar+GIARTUR+TUQ<ental<Absolut
aallariartortumukarpoq	aallar+GIARTUR+TUQ<ental<Terminalis-KAR<Indikativ<han
aallariartortumukalerpoq	aallar+GIARTUR+TUQ<ental<Terminalis-KAR-LIR<Indikativ<han
aallariartortukka	aallar+GIARTUR+TUQ<flertal<min<Absolut
aallariartortunnguaq	aallar+GIARTUR+TUQ-NNGUAQ<ental<Absolut
aallariartortunnguamukalertoq	aallar+GIARTUR+TUQ-NNGUAQ<ental<Terminalis-KAR-LIR+TUQ<ental<Absolut
aallariartortunnguamukartoq	aallar+GIARTUR+TUQ-NNGUAQ<ental<Terminalis-KAR+TUQ<ental<Absolut
aallariartortunnguakka	aallar+GIARTUR+TUQ-NNGUAQ<flertal<min<Absolut
aallarpoq	aallar<Indikativ<han
aallarpisi	aallar<Interrogativ<I
aallalerpoq	aallar-LIR<Indikativ<han
aallalerpisi	aallar-LIR<Interrogativ<I
aallalertoq	aallar-LIR+TUQ<ental<Absolut
aallalertumut	aallar-LIR+TUQ<ental<Terminalis
aallalertumukariartorpisi	aallar-LIR+TUQ<ental<Terminalis-KAR+GIARTUR<Interrogativ<I
aallalertumukarpoq	aallar-LIR+TUQ<ental<Terminalis-KAR<Indikativ<han
aallalertumukalerpoq	aallar-LIR+TUQ<ental<Terminalis-KAR-LIR<Indikativ<han
aallalertumukalerpisi	aallar-LIR+TUQ<ental<Terminalis-KAR-LIR<Interrogativ<I
aallalertumukalertoq	aallar-LIR+TUQ<ental<Terminalis-KAR-LIR+TUQ<ental<Absolut
aallalertumukartoq	aallar-LIR+TUQ<ental<Terminalis-KAR+TUQ<ental<Absolut
aallalertukka	aallar-LIR+TUQ<flertal<min<Absolut
aallalertunnguaq	aallar-LIR+TUQ-NNGUAQ<ental<Absolut
aallalertunnguamut	aallar-LIR+TUQ-NNGUAQ<ental<Terminalis
aallalertunnguamukariartorpoq	aallar-LIR+TUQ-NNGUAQ<ental<Terminalis-KAR+GIARTUR<Indikativ<han
aallalertunnguamukarpisi	aallar-LIR+TUQ-NNGUAQ<ental<Terminalis-KAR<Interrogativ<I
aallalertunnguamukalerpoq	aallar-LIR+TUQ-NNGUAQ<ental<Terminalis-KAR-LIR<Indikativ<han
aallalertunnguamukalerpisi	aallar-LIR+TUQ-NNGUAQ<ental<Terminalis-KAR-LIR<Interrogativ<I
aallalertunnguamukalertoq	aallar-LIR+TUQ-NNGUAQ<ental<Terminalis-KAR-LIR+TUQ<ental<Absolut
aallalertunnguamukartoq	aallar-LIR+TUQ-NNGUAQ<ental<Terminalis-KAR+TUQ<ental<Absolut
aallalertunnguakka	aallar-LIR+TUQ-NNGUAQ<flertal<min<Absolut
aallartoq	aallar+TUQ<ental<Absolut
aallartumut	aallar+TUQ<ental<Terminalis
aallartumukariartorpoq	aallar+TUQ<ental<Terminalis-KAR+GIARTUR<Indikativ<han
aallartumukariartortoq	aallar+TUQ<ental<Terminalis-KAR+GIARTUR+TUQ<ental<Absolut
aallartumukalertoq	aallar+TUQ<ental<Terminalis-KAR-LIR+TUQ<ental<Absolut
aallartumukartoq	aallar+TUQ<ental<Terminalis-KAR+TUQ<ental<Absolut
aallartukka	aallar+TUQ<flertal<min<Absolut
aallartunnguaq	aallar+TUQ-NNGUAQ<ental<Absolut
aallartunnguamut	aallar+TUQ-NNGUAQ<ental<Terminalis
aallartunnguamukarpoq	aallar+TUQ-NNGUAQ<ental<Terminalis-KAR<Indikativ<han
aallartunnguamukalerpoq	aallar+TUQ-NNGUAQ<ental<Terminalis-KAR-LIR<Indikativ<han
aallartunnguamukalerpisi	aallar+TUQ-NNGUAQ<ental<Terminalis-KAR-LIR<Interrogativ<I
aallartunnguamukalertoq	aallar+TUQ-NNGUAQ<ental<Terminalis-KAR-LIR+TUQ<ental<Absolut
aallartunnguamukartoq	aallar+TUQ-NNGUAQ<ental<Terminalis-KAR+TUQ<ental<Absolut
aallartunnguakka	aallar+TUQ-NNGUAQ<flertal<min<Absolut
atuakkialerineq	atuakkialerineq<ental<Absolut
atuakkialerinermut	atuakkialerineq<ental<Terminalis
atuakkialerinermukarpisi	atuakkialerineq<ental<Terminalis-KAR<Interrogativ<I
atuakkialerinermukalerpisi	atuakkialerineq<ental<Terminalis-KAR-LIR<Interrogativ<I
atuakkialerinermukalertoq	atuakkialerineq<ental<Terminalis-KAR-LIR+TUQ<ental<Absolut
atuakkialerinikka	atuakkialerineq<flertal<min<Absolut
atuakkialerininnguaq	atuakkialerineq-NNGUAQ<ental<Absolut
atuakkialerininnguamut	atuakkialerineq-NNGUAQ<ental<Terminalis
atuakkialerininnguamukariartorpisi	atuakkialerineq-NNGUAQ<ental<Terminalis-KAR+GIARTUR<Interrogativ<I
atuakkialerininnguamukariartortoq	atuakkialerineq-NNGUAQ<ental<Terminalis-KAR+GIARTUR+TUQ<ental<Absolut
atuakkialerininnguamukalerpoq	atuakkialerineq-NNGUAQ<ental<Terminalis-KAR-LIR<Indikativ<han
atuakkialerininnguamukalerpisi	atuakkialerineq-NNGUAQ<ental<Terminalis-KAR-LIR<Interrogativ<I
atuakkialerininnguamukartoq	atuakkialerineq-NNGUAQ<ental<Terminalis-KAR+TUQ<ental<Absolut
atuakkialerininnguakka	atuakkialerineq-NNGUAQ<flertal<min<Absolut
atuakkialerinernut	atuakkialerineq<Terminalis<flertal
atuakkialerinernukariartorpoq	atuakkialerineq<Terminalis<flertal-KAR+GIARTUR<Indikativ<han
atuakkialerinernukariartorpisi	atuakkialerineq<Terminalis<flertal-KAR+GIARTUR<Interrogativ<I
atuakkialerinernukarpoq	atuakkialerineq<Terminalis<flertal-KAR<Indikativ<han
atuakkialerinernukalerpisi	atuakkialerineq<Terminalis<flertal-KAR-LIR<Interrogativ<I
atuakkialerinernukalertoq	atuakkialerineq<Terminalis<flertal-KAR-LIR+TUQ<ental<Absolut
atuakkialerinernukartoq	atuakkialerineq<Terminalis<flertal-KAR+TUQ<ental<Absolut
atuariartorpoq	atuar+GIARTUR<Indikativ<han
atuariartorpisi	atuar+GIARTUR<Interrogativ<I
atuariartortoq	atuar+GIARTUR+TUQ<ental<Absolut
atuariartortumut	atuar+GIARTUR+TUQ<ental<Terminalis
atuariartortumukariartorpoq	atuar+GIARTUR+TUQ<ental<Terminalis-KAR+GIARTUR<Indikativ<han
atuariartortumukalertoq	atuar+GIARTUR+TUQ<ental<Terminalis-KAR-LIR+TUQ<ental<Absolut
atuariartortukka	atuar+GIARTUR+TUQ<flertal<min<Absolut
atuariartortunnguamut	atuar+GIARTUR+TUQ-NNGUAQ<ental<Terminalis
atuariartortunnguamukarpisi	atuar+GIARTUR+TUQ-NNGUAQ<ental<Terminalis-KAR<Interrogativ<I
atuariartortunnguakka	atuar+GIARTUR+TUQ-NNGUAQ<flertal<min<Absolut
atuarpoq	atuar<Indikativ<han
atuarpisi	atuar<Interrogativ<I
atualerpoq	atuar-LIR<Indikativ<han
atualerpisi	atuar-LIR<Interrogativ<I
atualertoq	atuar-LIR+TUQ<ental<Absolut
atualertumut	atuar-LIR+TUQ<ental<Terminalis
atualertumukariartorpisi	atuar-LIR+TUQ<ental<Terminalis-KAR+GIARTUR<Interrogativ<I
atualertumukarpoq	atuar-LIR+TUQ<ental<Terminalis-KAR<Indikativ<han
atualertumukalerpoq	atuar-LIR+TUQ<ental<Terminalis-KAR-LIR<Indikativ<han
atualertumukalertoq	atuar-LIR+TUQ<ental<Terminalis-KAR-LIR+TUQ<ental<Absolut
atualertumukartoq	atuar-LIR+TUQ<ental<Terminalis-KAR+TUQ<ental<Absolut
atualertukka	atuar-LIR+TUQ<flertal<min<Absolut
atualertunnguaq	atuar-LIR+TUQ-NNGUAQ<ental<Absolut
atualertunnguamut	atuar-LIR+TUQ-NNGUAQ<ental<Terminalis
atualertunnguamukariartorpoq	atuar-LIR+TUQ-NNGUAQ<ental<Terminalis-KAR+GIARTUR<Indikativ<han
atualertunnguamukarpoq	atuar-LIR+TUQ-NNGUAQ<ental<Terminalis-KAR<Indikativ<han
atualertunnguamukalerpisi	atuar-LIR+TUQ-NNGUAQ<ental<Terminalis-KAR-LIR<Interrogativ<I
atualertunnguamukalertoq	atuar-LIR+TUQ-NNGUAQ<ental<Terminalis-KAR-LIR+TUQ<ental<Absolut
atualertunnguakka	atuar-LIR+TUQ-NNGUAQ<flertal<min<Absolut
atuartoq	atuar+TUQ<ental<Absolut
atuartumut	atuar+TUQ<ental<Terminalis
atuartumukariartorpoq	atuar+TUQ<ental<Terminalis-KAR+GIARTUR<Indikativ<han
atuartumukariartorpisi	atuar+TUQ<ental<Terminalis-KAR+GIARTUR<Interrogativ<I
atuartumukarpoq	atuar+TUQ<ental<Terminalis-KAR<Indikativ<han
atuartumukarpisi	atuar+TUQ<ental<Terminalis-KAR<Interrogativ<I
atuartumukalerpoq	atuar+TUQ<ental<Terminalis-KAR-LIR<Indikativ<han
atuartumukalerpisi	atuar+TUQ<ental<Terminalis-KAR-LIR<Interrogativ<I
atuartumukartoq	atuar+TUQ<ental<Terminalis-KAR+TUQ<ental<Absolut
atuartukka	atuar+TUQ<flertal<min<Absolut
atuartunnguaq	atuar+TUQ-NNGUAQ<ental<Absolut
atuartunnguakka	atuar+TUQ-NNGUAQ<flertal<min<Absolut
eqqaq	eqqaq<ental<Absolut
eqqamut	eqqaq<ental<Terminalis
eqqamukariartorpoq	eqqaq<ental<Terminalis-KAR+GIARTUR<Indikativ<han
eqqamukariartorpisi	eqqaq<ental<Terminalis-KAR+GIARTUR<Interrogativ<I
eqqamukariartortoq	eqqaq<ental<Terminalis-KAR+GIARTUR+TUQ<ental<Absolut
eqqamukarpoq	eqqaq<ental<Terminalis-KAR<Indikativ<han
eqqamukarpisi	eqqaq<ental<Terminalis-KAR<Interrogativ<I
eqqamukalerpoq	eqqaq<ental<Terminalis-KAR-LIR<Indikativ<han
eqqamukalerpisi	eqqaq<ental<Terminalis-KAR-LIR<Interrogativ<I
eqqamukalertoq	eqqaq<ental<Terminalis-KAR-LIR+TUQ<ental<Absolut
eqqamukartoq	eqqaq<ental<Terminalis-KAR+TUQ<ental<Absolut
eqqakka	eqqaq<flertal<min<Absolut
eqqannguaq	eqqaq-NNGUAQ<ental<Absolut
eqqannguamut	eqqaq-NNGUAQ<ental<Terminalis
eqqannguamukariartorpoq	eqqaq-NNGUAQ<ental<Terminalis-KAR+GIARTUR<Indikativ<han
eqqannguamukariartorpisi	eqqaq-NNGUAQ<ental<Terminalis-KAR+GIARTUR<Interrogativ<I
eqqannguamukariartortoq	eqqaq-NNGUAQ<ental<Terminalis-KAR+GIARTUR+TUQ<ental<Absolut
eqqannguamukarpoq	eqqaq-NNGUAQ<ental<Terminalis-KAR<Indikativ<han
eqqannguamukarpisi	eqqaq-NNGUAQ<ental<Terminalis-KAR<Interrogativ<I
eqqannguamukalerpoq	eqqaq-NNGUAQ<ental<Terminalis-KAR-LIR<Indikativ<han
eqqannguamukalerpisi	eqqaq-NNGUAQ<ental<Terminalis-KAR-LIR<Interrogativ<I
eqqannguamukalertoq	eqqaq-NNGUAQ<ental<Terminalis-KAR-LIR+TUQ<ental<Absolut
eqqannguamukartoq	eqqaq-NNGUAQ<ental<Terminalis-KAR+TUQ<ental<Absolut
eqqannguakka	eqqaq-NNGUAQ<flertal<min<Absolut
ilinniarnertooq	ilinniarnertooq<ental<Absolut
ilinniarnertuumut	ilinniarnertooq<ental<Terminalis
ilinniarnertuumukariartorpoq	ilinniarnertooq<ental<Terminalis-KAR+GIARTUR<Indikativ<han
ilinniarnertuumukariartorpisi	ilinniarnertooq<ental<Terminalis-KAR+GIARTUR<Interrogativ<I
ilinniarnertuumukariartortoq	ilinniarnertooq<ental<Terminalis-KAR+GIARTUR+TUQ<ental<Absolut
ilinniarnertuumukarpoq	ilinniarnertooq<ental<Terminalis-KAR<Indikativ<han
ilinniarnertuumukarpisi	ilinniarnertooq<ental<Terminalis-KAR<Interrogativ<I
ilinniarnertuumukalerpoq	ilinniarnertooq<ental<Terminalis-KAR-LIR<Indikativ<han
ilinniarnertuumukalerpisi	ilinniarnertooq<ental<Terminalis-KAR-LIR<Interrogativ<I
ilinniarnertuumukalertoq	ilinniarnertooq<ental<Terminalis-KAR-LIR+TUQ<ental<Absolut
ilinniarnertuumukartoq	ilinniarnertooq<ental<Terminalis-KAR+TUQ<ental<Absolut
ilinniarnertuukka	ilinniarnertooq<flertal<min<Absolut
ilinniarnertuunnguaq	ilinniarnertooq-NNGUAQ<ental<Absolut
ilinniarnertuunnguamut	ilinniarnertooq-NNGUAQ<ental<Terminalis
ilinniarnertuunnguamukariartortoq	ilinniarnertooq-NNGUAQ<ental<Terminalis-KAR+GIARTUR+TUQ<ental<Absolut
ilinniarnertuunnguamukarpisi	ilinniarnertooq-NNGUAQ<ental<Terminalis-KAR<Interrogativ<I
ilinniarnertuunnguamukalerpoq	ilinniarnertooq-NNGUAQ<ental<Terminalis-KAR-LIR<Indikativ<han
ilinniarnertuunnguamukalerpisi	ilinniarnertooq-NNGUAQ<ental<Terminalis-KAR-LIR<Interrogativ<I
ilinniarnertuunnguamukalertoq	ilinniarnertooq-NNGUAQ<ental<Terminalis-KAR-LIR+TUQ<ental<Absolut
ilinniarnertuunnguamukartoq	ilinniarnertooq-NNGUAQ<ental<Terminalis-KAR+TUQ<ental<Absolut
ilinniarnertuunnguakka	ilinniarnertooq-NNGUAQ<flertal<min<Absolut
immiussiartorpoq	immiussi+GIARTUR<Indikativ<han
immiussiartorpisi	immiussi+GIARTUR<Interrogativ<I
immiussiartortoq	immiussi+GIARTUR+TUQ<ental<Absolut
immiussiartortumukariartorpisi	immiussi+GIARTUR+TUQ<ental<Terminalis-KAR+GIARTUR<Interrogativ<I
immiussiartortumukarpoq	immiussi+GIARTUR+TUQ<ental<Terminalis-KAR<Indikativ<han
immiussiartortumukarpisi	immiussi+GIARTUR+TUQ<ental<Terminalis-KAR<Interrogativ<I
immiussiartortukka	immiussi+GIARTUR+TUQ<flertal<min<Absolut
immiussiartortunnguaq	immiussi+GIARTUR+TUQ-NNGUAQ<ental<Absolut
immiussiartortunnguamut	immiussi+GIARTUR+TUQ-NNGUAQ<ental<Terminalis
immiussiartortunnguakka	immiussi+GIARTUR+TUQ-NNGUAQ<flertal<min<Absolut
immiussivoq	immiussi<Indikativ<han
immiussivisi	immiussi<Interrogativ<I
immiussilerpoq	immiussi-LIR<Indikativ<han
immiussilerpisi	immiussi-LIR<Interrogativ<I
immiussilertoq	immiussi-LIR+TUQ<ental<Absolut
immiussilertumut	immiussi-LIR+TUQ<ental<Terminalis
immiussilertumukalertoq	immiussi-LIR+TUQ<ental<Terminalis-KAR-LIR+TUQ<ental<Absolut
immiussilertukka	immiussi-LIR+TUQ<flertal<min<Absolut
immiussilertunnguaq	immiussi-LIR+TUQ-NNGUAQ<ental<Absolut
immiussilertunnguamukalerpisi	immiussi-LIR+TUQ-NNGUAQ<ental<Terminalis-KAR-LIR<Interrogativ<I
immiussisoq	immiussi+TUQ<ental<Absolut
immiussisumut	immiussi+TUQ<ental<Terminalis
immiussisumukariartortoq	immiussi+TUQ<ental<Terminalis-KAR+GIARTUR+TUQ<ental<Absolut
immiussisumukarpoq	immiussi+TUQ<ental<Terminalis-KAR<Indikativ<han
immiussisumukalerpoq	immiussi+TUQ<ental<Terminalis-KAR-LIR<Indikativ<han
immiussisumukalerpisi	immiussi+TUQ<ental<Terminalis-KAR-LIR<Interrogativ<I
immiussisumukalertoq	immiussi+TUQ<ental<Terminalis-KAR-LIR+TUQ<ental<Absolut
immiussisumukartoq	immiussi+TUQ<ental<Terminalis-KAR+TUQ<ental<Absolut
immiussisukka	immiussi+TUQ<flertal<min<Absolut
immiussisunnguaq	immiussi+TUQ-NNGUAQ<ental<Absolut
immiussisunnguamukarpoq	immiussi+TUQ-NNGUAQ<ental<Terminalis-KAR<Indikativ<han
immiussisunnguamukarpisi	immiussi+TUQ-NNGUAQ<ental<Terminalis-KAR<Interrogativ<I
immiussisunnguamukartoq	immiussi+TUQ-NNGUAQ<ental<Terminalis-KAR+TUQ<ental<Absolut
immiussisunnguakka	immiussi+TUQ-NNGUAQ<flertal<min<Absolut
inuk	inuk<ental<Absolut
inummut	inuk<ental<Terminalis
inummukariartorpoq	inuk<ental<Terminalis-KAR+GIARTUR<Indikativ<han
inummukariartorpisi	inuk<ental<Terminalis-KAR+GIARTUR<Interrogativ<I
inummukariartortoq	inuk<ental<Terminalis-KAR+GIARTUR+TUQ<ental<Absolut
inummukarpoq	inuk<ental<Terminalis-KAR<Indikativ<han
inummukarpisi	inuk<ental<Terminalis-KAR<Interrogativ<I
inummukalerpoq	inuk<ental<Terminalis-KAR-LIR<Indikativ<han
inummukalerpisi	inuk<ental<Terminalis-KAR-LIR<Interrogativ<I
inummukalertoq	inuk<ental<Terminalis-KAR-LIR+TUQ<ental<Absolut
inummukartoq	inuk<ental<Terminalis-KAR+TUQ<ental<Absolut
kitaa	kitә<ental<hans<Absolut
kimmut	kitә<ental<Terminalis
kimmukariartorpoq	kitә<ental<Terminalis-KAR+GIARTUR<Indikativ<han
kimmukariartorpisi	kitә<ental<Terminalis-KAR+GIARTUR<Interrogativ<I
kimmukariartortoq	kitә<ental<Terminalis-KAR+GIARTUR+TUQ<ental<Absolut
kimmukarpoq	kitә<ental<Terminalis-KAR<Indikativ<han
kimmukarpisi	kitә<ental<Terminalis-KAR<Interrogativ<I
kimmukalerpoq	kitә<ental<Terminalis-KAR-LIR<Indikativ<han
kimmukalerpisi	kitә<ental<Terminalis-KAR-LIR<Interrogativ<I
kimmukalertoq	kitә<ental<Terminalis-KAR-LIR+TUQ<ental<Absolut
kimmukartoq	kitә<ental<Terminalis-KAR+TUQ<ental<Absolut
kitikka	kitә<flertal<min<Absolut
kitinnguaq	kitә-NNGUAQ<ental<Absolut
kitinnguamut	kitә-NNGUAQ<ental<Terminalis
kitinnguamukariartorpisi	kitә-NNGUAQ<ental<Terminalis-KAR+GIARTUR<Interrogativ<I
kitinnguamukariartortoq	kitә-NNGUAQ<ental<Terminalis-KAR+GIARTUR+TUQ<ental<Absolut
kitinnguamukarpoq	kitә-NNGUAQ<ental<Terminalis-KAR<Indikativ<han
kitinnguamukarpisi	kitә-NNGUAQ<ental<Terminalis-KAR<Interrogativ<I
kitinnguamukalerpisi	kitә-NNGUAQ<ental<Terminalis-KAR-LIR<Interrogativ<I
kitinnguamukalertoq	kitә-NNGUAQ<ental<Terminalis-KAR-LIR+TUQ<ental<Absolut
kitinnguamukartoq	kitә-NNGUAQ<ental<Terminalis-KAR+TUQ<ental<Absolut
kitinnguakka	kitә-NNGUAQ<flertal<min<Absolut
makku	makku<Pronomen<Absolut<flertal
makkunani	makku<Pronomen<Lokalis<flertal
mittarfik	mittarfik<ental<Absolut
mittarfimmut	mittarfik<ental<Terminalis
mittarfimmukariartorpisi	mittarfik<ental<Terminalis-KAR+GIARTUR<Interrogativ<I
mittarfimmukariartortoq	mittarfik<ental<Terminalis-KAR+GIARTUR+TUQ<ental<Absolut
mittarfimmukarpoq	mittarfik<ental<Terminalis-KAR<Indikativ<han
mittarfimmukarpisi	mittarfik<ental<Terminalis-KAR<Interrogativ<I
mittarfimmukalerpoq	mittarfik<ental<Terminalis-KAR-LIR<Indikativ<han
mittarfimmukalerpisi	mittarfik<ental<Terminalis-KAR-LIR<Interrogativ<I
mittarfimmukalertoq	mittarfik<ental<Terminalis-KAR-LIR+TUQ<ental<Absolut
mittarfimmukartoq	mittarfik<ental<Terminalis-KAR+TUQ<ental<Absolut
mittarfikka	mittarfik<flertal<min<Absolut
mittarfinnut	mittarfik<flertal<Terminalis
mittarfinnukariartorpoq	mittarfik<flertal<Terminalis-KAR+GIARTUR<Indikativ<han
mittarfinnukariartorpisi	mittarfik<flertal<Terminalis-KAR+GIARTUR<Interrogativ<I
mittarfinnukariartortoq	mittarfik<flertal<Terminalis-KAR+GIARTUR+TUQ<ental<Absolut
mittarfinnukarpoq	mittarfik<flertal<Terminalis-KAR<Indikativ<han
mittarfinnukarpisi	mittarfik<flertal<Terminalis-KAR<Interrogativ<I
mittarfinnukalerpoq	mittarfik<flertal<Terminalis-KAR-LIR<Indikativ<han
mittarfinnukalerpisi	mittarfik<flertal<Terminalis-KAR-LIR<Interrogativ<I
mittarfinnukalertoq	mittarfik<flertal<Terminalis-KAR-LIR+TUQ<ental<Absolut
mittarfinnukartoq	mittarfik<flertal<Terminalis-KAR+TUQ<ental<Absolut
mittarfinnguaq	mittarfik-NNGUAQ<ental<Absolut
mittarfinnguamut	mittarfik-NNGUAQ<ental<Terminalis
mittarfinnguamukarpoq	mittarfik-NNGUAQ<ental<Terminalis-KAR<Indikativ<han
mittarfinnguamukarpisi	mittarfik-NNGUAQ<ental<Terminalis-KAR<Interrogativ<I
mittarfinnguamukalerpoq	mittarfik-NNGUAQ<ental<Terminalis-KAR-LIR<Indikativ<han
mittarfinnguamukalerpisi	mittarfik-NNGUAQ<ental<Terminalis-KAR-LIR<Interrogativ<I
mittarfinnguamukartoq	mittarfik-NNGUAQ<ental<Terminalis-KAR+TUQ<ental<Absolut
mittarfinnguakka	mittarfik-NNGUAQ<flertal<min<Absolut
oqaluttuarisaaneq	oqaluttuarisaaneq<ental<Absolut
oqaluttuarisaanermut	oqaluttuarisaaneq<ental<Terminalis
oqaluttuarisaanermukariartorpoq	oqaluttuarisaaneq<ental<Terminalis-KAR+GIARTUR<Indikativ<han
oqaluttuarisaanermukariartorpisi	oqaluttuarisaaneq<ental<Terminalis-KAR+GIARTUR<Interrogativ<I
oqaluttuarisaanermukariartortoq	oqaluttuarisaaneq<ental<Terminalis-KAR+GIARTUR+TUQ<ental<Absolut
oqaluttuarisaanermukarpoq	oqaluttuarisaaneq<ental<Terminalis-KAR<Indikativ<han
oqaluttuarisaanermukarpisi	oqaluttuarisaaneq<ental<Terminalis-KAR<Interrogativ<I
oqaluttuarisaanermukalerpoq	oqaluttuarisaaneq<ental<Terminalis-KAR-LIR<Indikativ<han
oqaluttuarisaanermukalerpisi	oqaluttuarisaaneq<ental<Terminalis-KAR-LIR<Interrogativ<I
oqaluttuarisaanermukalertoq	oqaluttuarisaaneq<ental<Terminalis-KAR-LIR+TUQ<ental<Absolut
oqaluttuarisaanermukartoq	oqaluttuarisaaneq<ental<Terminalis-KAR+TUQ<ental<Absolut
oqaluttuarisaanikka	oqaluttuarisaaneq<flertal<min<Absolut
oqaluttuarisaaninnguaq	oqaluttuarisaaneq-NNGUAQ<ental<Absolut
oqaluttuarisaaninnguamut	oqaluttuarisaaneq-NNGUAQ<ental<Terminalis
oqaluttuarisaaninnguamukariartorpoq	oqaluttuarisaaneq-NNGUAQ<ental<Terminalis-KAR+GIARTUR<Indikativ<han
oqaluttuarisaaninnguamukariartorpisi	oqaluttuarisaaneq-NNGUAQ<ental<Terminalis-KAR+GIARTUR<Interrogativ<I
oqaluttuarisaaninnguamukariartortoq	oqaluttuarisaaneq-NNGUAQ<ental<Terminalis-KAR+GIARTUR+TUQ<ental<Absolut
oqaluttuarisaaninnguamukarpoq	oqaluttuarisaaneq-NNGUAQ<ental<Terminalis-KAR<Indikativ<han
oqaluttuarisaaninnguamukarpisi	oqaluttuarisaaneq-NNGUAQ<ental<Terminalis-KAR<Interrogativ<I
oqaluttuarisaaninnguamukalerpoq	oqaluttuarisaaneq-NNGUAQ<ental<Terminalis-KAR-LIR<Indikativ<han
oqaluttuarisaaninnguamukalerpisi	oqaluttuarisaaneq-NNGUAQ<ental<Terminalis-KAR-LIR<Interrogativ<I
oqaluttuarisaaninnguamukalertoq	oqaluttuarisaaneq-NNGUAQ<ental<Terminalis-KAR-LIR+TUQ<ental<Absolut
oqaluttuarisaaninnguamukartoq	oqaluttuarisaaneq-NNGUAQ<ental<Terminalis-KAR+TUQ<ental<Absolut
oqaluttuarisaaninnguakka	oqaluttuarisaaneq-NNGUAQ<flertal<min<Absolut
oqaluttuarisaanernut	oqaluttuarisaaneq<Terminalis<flertal
oqaluttuarisaanernukariartorpoq	oqaluttuarisaaneq<Terminalis<flertal-KAR+GIARTUR<Indikativ<han
oqaluttuarisaanernukariartorpisi	oqaluttuarisaaneq<Terminalis<flertal-KAR+GIARTUR<Interrogativ<I
oqaluttuarisaanernukariartortoq	oqaluttuarisaaneq<Terminalis<flertal-KAR+GIARTUR+TUQ<ental<Absolut
oqaluttuarisaanernukarpoq	oqaluttuarisaaneq<Terminalis<flertal-KAR<Indikativ<han
oqaluttuarisaanernukarpisi	oqaluttuarisaaneq<Terminalis<flertal-KAR<Interrogativ<I
oqaluttuarisaanernukalerpoq	oqaluttuarisaaneq<Terminalis<flertal-KAR-LIR<Indikativ<han
oqaluttuarisaanernukalerpisi	oqaluttuarisaaneq<Terminalis<flertal-KAR-LIR<Interrogativ<I
oqaluttuarisaanernukalertoq	oqaluttuarisaaneq<Terminalis<flertal-KAR-LIR+TUQ<ental<Absolut
oqaluttuarisaanernukartoq	oqaluttuarisaaneq<Terminalis<flertal-KAR+TUQ<ental<Absolut
Pituffik	Pituffik<Absolut
Pituffimmut	Pituffik<Terminalis
Pituffimmukariartorpoq	Pituffik<Terminalis-KAR+GIARTUR<Indikativ<han
Pituffimmukariartorpisi	Pituffik<Terminalis-KAR+GIARTUR<Interrogativ<I
Pituffimmukariartortoq	Pituffik<Terminalis-KAR+GIARTUR+TUQ<ental<Absolut
Pituffimmukarpoq	Pituffik<Terminalis-KAR<Indikativ<han
Pituffimmukarpisi	Pituffik<Terminalis-KAR<Interrogativ<I
Pituffimmukalerpoq	Pituffik<Terminalis-KAR-LIR<Indikativ<han
Pituffimmukalerpisi	Pituffik<Terminalis-KAR-LIR<Interrogativ<I
Pituffimmukalertoq	Pituffik<Terminalis-KAR-LIR+TUQ<ental<Absolut
Pituffimmukartoq	Pituffik<Terminalis-KAR+TUQ<ental<Absolut
qaammat	qaammat<ental<Absolut
qaammammut	qaammat<ental<Terminalis
qaammammukariartorpoq	qaammat<ental<Terminalis-KAR+GIARTUR<Indikativ<han
qaammammukariartortoq	qaammat<ental<Terminalis-KAR+GIARTUR+TUQ<ental<Absolut
qaammammukarpoq	qaammat<ental<Terminalis-KAR<Indikativ<han
qaammammukarpisi	qaammat<ental<Terminalis-KAR<Interrogativ<I
qaammammukalerpoq	qaammat<ental<Terminalis-KAR-LIR<Indikativ<han
qaammammukalerpisi	qaammat<ental<Terminalis-KAR-LIR<Interrogativ<I
qaammammukalertoq	qaammat<ental<Terminalis-KAR-LIR+TUQ<ental<Absolut
qaammammukartoq	qaammat<ental<Terminalis-KAR+TUQ<ental<Absolut
qaammatikka	qaammat<flertal<min<Absolut
qaammatinnguaq	qaammat-NNGUAQ<ental<Absolut
qaammatinnguamut	qaammat-NNGUAQ<ental<Terminalis
qaammatinnguamukariartorpoq	qaammat-NNGUAQ<ental<Terminalis-KAR+GIARTUR<Indikativ<han
qaammatinnguamukariartorpisi	qaammat-NNGUAQ<ental<Terminalis-KAR+GIARTUR<Interrogativ<I
qaammatinnguamukarpoq	qaammat-NNGUAQ<ental<Terminalis-KAR<Indikativ<han
qaammatinnguamukarpisi	qaammat-NNGUAQ<ental<Terminalis-KAR<Interrogativ<I
qaammatinnguamukalerpoq	qaammat-NNGUAQ<ental<Terminalis-KAR-LIR<Indikativ<han
qaammatinnguamukalerpisi	qaammat-NNGUAQ<ental<Terminalis-KAR-LIR<Interrogativ<I
qaammatinnguamukalertoq	qaammat-NNGUAQ<ental<Terminalis-KAR-LIR+TUQ<ental<Absolut
qaammatinnguamukartoq	qaammat-NNGUAQ<ental<Terminalis-KAR+TUQ<ental<Absolut
qaammatinnguakka	qaammat-NNGUAQ<flertal<min<Absolut
qangali	qangali<Partikel
qanga	qanga<Partikel
qatanngut	qatanngut<ental<Absolut
qatanngummut	qatanngut<ental<Terminalis
qatanngummukariartorpoq	qatanngut<ental<Terminalis-KAR+GIARTUR<Indikativ<han
qatanngummukariartorpisi	qatanngut<ental<Terminalis-KAR+GIARTUR<Interrogativ<I
qatanngummukariartortoq	qatanngut<ental<Terminalis-KAR+GIARTUR+TUQ<ental<Absolut
qatanngummukarpoq	qatanngut<ental<Terminalis-KAR<Indikativ<han
qatanngummukarpisi	qatanngut<ental<Terminalis-KAR<Interrogativ<I
qatanngummukalerpoq	qatanngut<ental<Terminalis-KAR-LIR<Indikativ<han
qatanngummukalerpisi	qatanngut<ental<Terminalis-KAR-LIR<Interrogativ<I
qatanngummukalertoq	qatanngut<ental<Terminalis-KAR-LIR+TUQ<ental<Absolut
qatanngummukartoq	qatanngut<ental<Terminalis-KAR+TUQ<ental<Absolut
qatanngutikka	qatanngut<flertal<min<Absolut
qatanngutinnguaq	qatanngut-NNGUAQ<ental<Absolut
qatanngutinnguamut	qatanngut-NNGUAQ<ental<Terminalis
qatanngutinnguamukariartorpisi	qatanngut-NNGUAQ<ental<Terminalis-KAR+GIARTUR<Interrogativ<I
qatanngutinnguamukarpisi	qatanngut-NNGUAQ<ental<Terminalis-KAR<Interrogativ<I
qatanngutinnguamukalerpoq	qatanngut-NNGUAQ<ental<Terminalis-KAR-LIR<Indikativ<han
qatanngutinnguamukalerpisi	qatanngut-NNGUAQ<ental<Terminalis-KAR-LIR<Interrogativ<I
qatanngutinnguamukalertoq	qatanngut-NNGUAQ<ental<Terminalis-KAR-LIR+TUQ<ental<Absolut
qatanngutinnguamukartoq	qatanngut-NNGUAQ<ental<Terminalis-KAR+TUQ<ental<Absolut
qatanngutinnguakka	qatanngut-NNGUAQ<flertal<min<Absolut
sinneriartorpai	sinner+GIARTUR<Indikativ<HanDem
sinneriartorpaa	sinner+GIARTUR<Indikativ<HanHam
sinneriartorlugit	sinner+GIARTUR<Ledsagemåde<dem
sinneriartorlugu	sinner+GIARTUR<Ledsagemåde<ham
sinnerpai	sinner<Indikativ<HanDem
sinnerpaa	sinner<Indikativ<HanHam
sinnerlugit	sinner<Ledsagemåde<dem
sinnerlugu	sinner<Ledsagemåde<ham
sinnilerpai	sinner-LIR<Indikativ<HanDem
sinnilerpaa	sinner-LIR<Indikativ<HanHam
sinnilerlugit	sinner-LIR<Ledsagemåde<dem
sinnilerlugu	sinner-LIR<Ledsagemåde<ham
siulleq	siulleq<ental<Absolut
siullermut	siulleq<ental<Terminalis
siullermukariartorpisi	siulleq<ental<Terminalis-KAR+GIARTUR<Interrogativ<I
siullermukariartortoq	siulleq<ental<Terminalis-KAR+GIARTUR+TUQ<ental<Absolut
siullermukarpoq	siulleq<ental<Terminalis-KAR<Indikativ<han
siullermukarpisi	siulleq<ental<Terminalis-KAR<Interrogativ<I
siullermukalerpoq	siulleq<ental<Terminalis-KAR-LIR<Indikativ<han
siullermukalerpisi	siulleq<ental<Terminalis-KAR-LIR<Interrogativ<I
siullermukalertoq	siulleq<ental<Terminalis-KAR-LIR+TUQ<ental<Absolut
siullermukartoq	siulleq<ental<Terminalis-KAR+TUQ<ental<Absolut
siullikka	siulleq<flertal<min<Absolut
siullernut	siulleq<flertal<Terminalis
siullernukariartorpoq	siulleq<flertal<Terminalis-KAR+GIARTUR<Indikativ<han
siullernukariartorpisi	siulleq<flertal<Terminalis-KAR+GIARTUR<Interrogativ<I
siullernukariartortoq	siulleq<flertal<Terminalis-KAR+GIARTUR+TUQ<ental<Absolut
siullernukarpoq	siulleq<flertal<Terminalis-KAR<Indikativ<han
siullernukarpisi	siulleq<flertal<Terminalis-KAR<Interrogativ<I
siullernukalerpoq	siulleq<flertal<Terminalis-KAR-LIR<Indikativ<han
siullernukalerpisi	siulleq<flertal<Terminalis-KAR-LIR<Interrogativ<I
siullernukalertoq	siulleq<flertal<Terminalis-KAR-LIR+TUQ<ental<Absolut
siullernukartoq	siulleq<flertal<Terminalis-KAR+TUQ<ental<Absolut
siullinnguaq	siulleq-NNGUAQ<ental<Absolut
siullinnguamut	siulleq-NNGUAQ<ental<Terminalis
siullinnguamukariartorpoq	siulleq-NNGUAQ<ental<Terminalis-KAR+GIARTUR<Indikativ<han
siullinnguamukariartorpisi	siulleq-NNGUAQ<ental<Terminalis-KAR+GIARTUR<Interrogativ<I
siullinnguamukariartortoq	siulleq-NNGUAQ<ental<Terminalis-KAR+GIARTUR+TUQ<ental<Absolut
siullinnguamukarpoq	siulleq-NNGUAQ<ental<Terminalis-KAR<Indikativ<han
siullinnguamukarpisi	siulleq-NNGUAQ<ental<Terminalis-KAR<Interrogativ<I
siullinnguamukalerpoq	siulleq-NNGUAQ<ental<Terminalis-KAR-LIR<Indikativ<han
siullinnguamukalerpisi	siulleq-NNGUAQ<ental<Terminalis-KAR-LIR<Interrogativ<I
siullinnguamukalertoq	siulleq-NNGUAQ<ental<Terminalis-KAR-LIR+TUQ<ental<Absolut
siullinnguamukartoq	siulleq-NNGUAQ<ental<Terminalis-KAR+TUQ<ental<Absolut
siullinnguakka	siulleq-NNGUAQ<flertal<min<Absolut
taamaammat	taamaammat<Partikel
taava	taava<Partikel
tamatta	tamatta<Adjektiv
