aallariartorlutinguna	aallar+GIARTUR<Ledsagemåde<de_selv+UNA
aallalaartarpugut	aallar-LAAR=TAR<Indikativ<vi
aallarniarluni	aallar+NIAR<Ledsagemåde<han_selv
aallassagaluarpoq	aallar-SSA=GALUAR<Indikativ<han
aallassagaluarlunga	aallar-SSA=GALUAR<Ledsagemåde<jeg
aallassapput	aallar-SSA<Indikativ<de
aamma	aamma<Partikel
aammalu	aamma<Partikel+LU
aammaana	aamma<Partikel+UNA
aappaagu	aappaagu<Partikel
aappaaguuna	aappaagu<Partikel+UNA
aap	aap<Partikel
aalli	aap<Partikel+LI
aallu	aap<Partikel+LU
Aasiaat	Aasiaat<Absolut
Aasiaalli	Aasiaat<Absolut+LI
Aasiaallu	Aasiaat<Absolut+LU
Aasiaanuna	Aasiaat<Absolut+UNA
Aasiannik	Aasiaat<Instrumentalis
Aasiannilli	Aasiaat<Instrumentalis+LI
Aasiannillu	Aasiaat<Instrumentalis+LU
Aasianninguna	Aasiaat<Instrumentalis+UNA
Aasianni	Aasiaat<Lokalis
Aasianniilaarpungali	Aasiaat<Lokalis+IP-LAAR<Indikativ<jeg+LI
Aasianniilaarpugununa	Aasiaat<Lokalis+IP-LAAR<Indikativ<vi+UNA
Aasianniilaartarluni	Aasiaat<Lokalis+IP-LAAR=TAR<Ledsagemåde<han_selv
Aasianniillungalu	Aasiaat<Lokalis+IP<Ledsagemåde<jeg+LU
Aasianniilertoqarporlu	Aasiaat<Lokalis+IP-LIR+TUQ-QAR<Indikativ<han+LU
Aasiannili	Aasiaat<Lokalis+LI
Aasiannilu	Aasiaat<Lokalis+LU
Aasianniuna	Aasiaat<Lokalis+UNA
Aasiammiumili	Aasiaat+MIU<ental<Lokalis+LI
Aasiammiumukalaarneq	Aasiaat+MIU<ental<Terminalis-KAR-LAAR+NIQ
Aasiammiunik	Aasiaat+MIU<flertal<Instrumentalis
Aasiammiunilli	Aasiaat+MIU<flertal<Instrumentalis+LI
Aasiammiuniilaartarneq	Aasiaat+MIU<flertal<Lokalis+IP-LAAR=TAR+NIQ
Aasiammiuniuna	Aasiaat+MIU<flertal<Lokalis+UNA
Aasiammiulerigaluarlunga	Aasiaat+MIU-LIRI+GALUAR<Ledsagemåde<jeg
Aasiammiulerillunga	Aasiaat+MIU-LIRI<Ledsagemåde<jeg
Aasiammiulerisimasorli	Aasiaat+MIU-LIRI+SIMA<Participium<han+LI
Aasiammiulerisimasarpunga	Aasiaat+MIU-LIRI+SIMA=TAR<Indikativ<jeg
Aasiammiulerisimasukka	Aasiaat+MIU-LIRI+SIMA+TUQ<flertal<min<Absolut
Aasiammiulerisarpit	Aasiaat+MIU-LIRI+TAR<Interrogativ<du
Aasiammiunngussagaluarlutinguna	Aasiaat+MIU-NNGUR-SSA=GALUAR<Ledsagemåde<de_selv+UNA
Aasiammioqarpoq	Aasiaat+MIU-QAR<Indikativ<han
Aasiammioqarporli	Aasiaat+MIU-QAR<Indikativ<han+LI
Aasiammioqarporlu	Aasiaat+MIU-QAR<Indikativ<han+LU
Aasiammioqarneq	Aasiaat+MIU-QAR+NIQ<ental<Absolut
Aasiammioqarnerli	Aasiaat+MIU-QAR+NIQ<ental<Absolut+LI
Aasiammioqarnerlu	Aasiaat+MIU-QAR+NIQ<ental<Absolut+LU
Aasiammioqarneruna	Aasiaat+MIU-QAR+NIQ<ental<Absolut+UNA
Aasiammioqartoq	Aasiaat+MIU-QAR<Participium<han
Aasiammioqartorli	Aasiaat+MIU-QAR<Participium<han+LI
Aasiammioqartoruna	Aasiaat+MIU-QAR<Participium<han+UNA
Aasiammioqartoq	Aasiaat+MIU-QAR+TUQ<ental<Absolut
Aasiammioqartorli	Aasiaat+MIU-QAR+TUQ<ental<Absolut+LI
Aasiammioqartoruna	Aasiaat+MIU-QAR+TUQ<ental<Absolut+UNA
Aasiammiuujartornikkali	Aasiaat+MIU-U+GIARTUR+NIQ<flertal<min<Absolut+LI
Aasiammiuulertunga	Aasiaat+MIU-U-LIR<Participium<jeg
Aasiammiuuniarluni	Aasiaat+MIU-U+NIAR<Ledsagemåde<han_selv
Aasiammiuuniarnangalu	Aasiaat+MIU-U+NIAR=NNGIT<Ledsagemåde<jeg+LU
Aasiammiuuniartuleriartortoq	Aasiaat+MIU-U+NIAR+TUQ-LIRI+GIARTUR+TUQ<ental<Absolut
Aasiammiuusununa	Aasiaat+MIU-U<Participium<de+UNA
Aasiammiuusimavisi	Aasiaat+MIU-U+SIMA<Interrogativ<I
Aasiammiuusarpisi	Aasiaat+MIU-U+TAR<Interrogativ<I
Aasiammiuusarluni	Aasiaat+MIU-U+TAR<Ledsagemåde<han_selv
Aasiammiuusormiunngorsinnaavugulli	Aasiaat+MIU-U+TUQ+MIU-NNGUR+SINNAA<Indikativ<vi+LI
Aasiannut	Aasiaat<Terminalis
Aasiannukaraluartut	Aasiaat<Terminalis-KAR+GALUAR<Participium<de
Aasiannukanngitsoq	Aasiaat<Terminalis-KAR-NNGIT+TUQ<ental<Absolut
Aasiannukassagaluarlunga	Aasiaat<Terminalis-KAR-SSA=GALUAR<Ledsagemåde<jeg
Aasiannulli	Aasiaat<Terminalis+LI
Aasiannununa	Aasiaat<Terminalis+UNA
akisooq	akisooq<ental<Absolut
akisuumi	akisooq<ental<Lokalis
akisuunukassagaluartorli	akisooq<flertal<Terminalis-KAR-SSA=GALUAR<Participium<han+LI
akisuuinnaali	akisooq-INNAQ<ental<hans<Absolut+LI
akisuuinnaqassallunga	akisooq-INNAQ-QAR-SSA<Ledsagemåde<jeg
akisuullinuna	akisooq-LIK<flertal<Absolut+UNA
akisuunngua	akisooq-NNGUAQ<ental<hans<Absolut
akisuunnguamiuna	akisooq-NNGUAQ<ental<Lokalis+UNA
akisuunngui	akisooq-NNGUAQ<flertal<hans<Absolut
akisuunngorniarnerli	akisooq-NNGUR+NIAR+NIQ<ental<Absolut+LI
akisuunngorsimasorlu	akisooq-NNGUR+SIMA+TUQ<ental<Absolut+LU
akisuunngorsinnaavungali	akisooq-NNGUR+SINNAA<Indikativ<jeg+LI
akisuunngussaaq	akisooq-NNGUR-SSA<Indikativ<han
akisoorpassuit	akisooq+PASSUAQ<flertal<Absolut
akisoorpassuakka	akisooq+PASSUAQ<flertal<min<Absolut
akisooqalaartartorlu	akisooq-QAR-LAAR=TAR+TUQ<ental<Absolut+LU
akisooqalaartoq	akisooq-QAR-LAAR+TUQ<ental<Absolut
akisooqarnerlu	akisooq-QAR+NIQ<ental<Absolut+LU
akisooqassagaluartorli	akisooq-QAR-SSA=GALUAR<Participium<han+LI
akisooqassaaq	akisooq-QAR-SSA<Indikativ<han
aleqatununa	aleqa<ental<Aequalis+UNA
aleqaga	aleqa<ental<min<Absolut
aleqaginiarpakka	aleqa+GӘ+NIAR<Indikativ<JegDem
aleqaannaqalaarpununa	aleqa-INNAQ-QAR-LAAR<Indikativ<de+UNA
aleqallilli	aleqa-LIK<flertal<Absolut+LI
aleqalilerivunga	aleqa-LIK-LIRI<Indikativ<jeg
aleqaleriartorpunga	aleqa-LIRI+GIARTUR<Indikativ<jeg
aleqalerissagaluarpisi	aleqa-LIRI-SSA=GALUAR<Interrogativ<I
aleqamiulerippullu	aleqa+MIU-LIRI<Indikativ<de+LU
aleqamiulerisaraluarpisi	aleqa+MIU-LIRI+TAR=GALUAR<Interrogativ<I
aleqamiulerisarpugulli	aleqa+MIU-LIRI+TAR<Indikativ<vi+LI
aleqamiunngulaartarnerilli	aleqa+MIU-NNGUR-LAAR=TAR+NIQ<flertal<Relativ+LI
aleqamiunngulaartartoq	aleqa+MIU-NNGUR-LAAR=TAR<Participium<han
aleqamioqarnerli	aleqa+MIU-QAR+NIQ<ental<Absolut+LI
aleqamioqarnerlu	aleqa+MIU-QAR+NIQ<ental<Absolut+LU
aleqamiuusimalluni	aleqa+MIU-U+SIMA<Ledsagemåde<han_selv
aleqannguarli	aleqa-NNGUAQ<ental<Absolut+LI
aleqanngua	aleqa-NNGUAQ<ental<hans<Absolut
aleqannguili	aleqa-NNGUAQ<flertal<hans<Absolut+LI
aleqanngortaraluarlutinguna	aleqa-NNGUR+TAR=GALUAR<Ledsagemåde<de_selv+UNA
aleqanngortulerinianngilasi	aleqa-NNGUR+TUQ-LIRI+NIAR=NNGIT<Interrogativ<I
aleqaqanngillat	aleqa-QAR-NNGIT<Indikativ<de
aleqaqannginnikka	aleqa-QAR-NNGIT+NIQ<flertal<min<Absolut
aleqaasaraluarlungalu	aleqa-U+TAR=GALUAR<Ledsagemåde<jeg+LU
aleqaasunnguanngorpulli	aleqa-U+TUQ-NNGUAQ-NNGUR<Indikativ<de+LI
anaanakkali	anaana<flertal<min<Absolut+LI
anaanagissatigilli	anaana+GӘ-SSA<Imperativ<ViDem+LI
anaanalerilaartarpit	anaana-LIRI-LAAR=TAR<Interrogativ<du
anaanamiuunatik	anaana+MIU-U-NNGIT<Ledsagemåde<de_selv
anaananngoraluartununa	anaana-NNGUR+GALUAR<Participium<de+UNA
anaananngorneq	anaana-NNGUR+NIQ<ental<Absolut
anaanaqassasullu	anaana-QAR-SSA<Participium<de+LU
anaanaassagaluarnikka	anaana-U-SSA=GALUAR+NIQ<flertal<min<Absolut
angajuniilerluni	angaju<flertal<Lokalis+IP-LIR<Ledsagemåde<han_selv
angajumiunilli	angaju+MIU<flertal<Instrumentalis+LI
angajumiuusinnaaneri	angaju+MIU-U+SINNAA+NIQ<flertal<hans<Absolut
angajorpassuiuna	angaju+PASSUAQ<flertal<hans<Absolut+UNA
angulli	angut<ental<Absolut+LI
angummik	angut<ental<Instrumentalis
angummununa	angut<ental<Terminalis+UNA
angutimiuunanga	angut+MIU-U-NNGIT<Ledsagemåde<jeg
aniinnaa	ani-INNAQ<flertal<hans<Absolut
anilimmullu	ani-LIK<ental<Terminalis+LU
anilerisimasarnikkali	ani-LIRI+SIMA=TAR+NIQ<flertal<min<Absolut+LI
animiunngussallutik	ani+MIU-NNGUR-SSA<Ledsagemåde<de_selv
animioqartoq	ani+MIU-QAR<Participium<han
animiuusinnaavunga	ani+MIU-U+SINNAA<Indikativ<jeg
aninngulerlunga	ani-NNGUR-LIR<Ledsagemåde<jeg
aninngortungali	ani-NNGUR<Participium<jeg+LI
anerpassuarninguna	ani+PASSUAQ<flertal<Instrumentalis+UNA
aneqanngilaq	ani-QAR-NNGIT<Indikativ<han
aneqassallutik	ani-QAR-SSA<Ledsagemåde<de_selv
aneqassalluni	ani-QAR-SSA<Ledsagemåde<han_selv
aqqalutununa	aqqalu<ental<Aequalis+UNA
aqqaluga	aqqalu<ental<min<Absolut
aqqalumukanngitsoq	aqqalu<ental<Terminalis-KAR-NNGIT<Participium<han
aqqaluginiartigilli	aqqalu+GӘ+NIAR<Imperativ<ViDem+LI
aqqalugisartiginuna	aqqalu+GӘ+TAR<Imperativ<ViDem+UNA
aqqaluinnaana	aqqalu-INNAQ<ental<hans<Absolut+UNA
aqqaluinnanngorsimasartut	aqqalu-INNAQ-NNGUR+SIMA=TAR<Participium<de
aqqalulerigaluartoqalaartarpugulli	aqqalu-LIRI+GALUAR+TUQ-QAR-LAAR=TAR<Indikativ<vi+LI
aqqalumiunngussasunga	aqqalu+MIU-NNGUR-SSA<Participium<jeg
aqqalumioqarporuna	aqqalu+MIU-QAR<Indikativ<han+UNA
aqqalumiuusimavoruna	aqqalu+MIU-U+SIMA<Indikativ<han+UNA
aqqalumiuusinnaappununa	aqqalu+MIU-U+SINNAA<Indikativ<de+UNA
aqqalunnguamilli	aqqalu-NNGUAQ<ental<Instrumentalis+LI
aqqalunnguiuna	aqqalu-NNGUAQ<flertal<hans<Absolut+UNA
aqqalorpassuillu	aqqalu+PASSUAQ<flertal<Absolut+LU
aqqalorpassui	aqqalu+PASSUAQ<flertal<hans<Absolut
aqqalorpassuilu	aqqalu+PASSUAQ<flertal<hans<Absolut+LU
aqqalorpassuarnillu	aqqalu+PASSUAQ<flertal<Instrumentalis+LU
aqqalorpassuarniilaartarluniuna	aqqalu+PASSUAQ<flertal<Lokalis+IP-LAAR=TAR<Ledsagemåde<han_selv+UNA
aqqaloqalaarnerali	aqqalu-QAR-LAAR+NIQ<ental<hans<Absolut+LI
aqqaloqalaartarpit	aqqalu-QAR-LAAR=TAR<Interrogativ<du
aqqaloqanngilanga	aqqalu-QAR-NNGIT<Indikativ<jeg
aqqaloqassagaluarpunga	aqqalu-QAR-SSA=GALUAR<Indikativ<jeg
aqqaloqassagaluarlutinguna	aqqalu-QAR-SSA=GALUAR<Ledsagemåde<de_selv+UNA
aqqaloqassagaluarnikka	aqqalu-QAR-SSA=GALUAR+NIQ<flertal<min<Absolut
aqqaloqassallungaana	aqqalu-QAR-SSA<Ledsagemåde<jeg+UNA
aqqaluujartorlunga	aqqalu-U+GIARTUR<Ledsagemåde<jeg
aqqaluussallutinguna	aqqalu-U-SSA<Ledsagemåde<de_selv+UNA
arnaq	arnaq<ental<Absolut
arnarli	arnaq<ental<Absolut+LI
arnarlu	arnaq<ental<Absolut+LU
arnarali	arnaq<ental<min<Absolut+LI
arnaralu	arnaq<ental<min<Absolut+LU
arnarisimasarpaajuna	arnaq+GӘ+SIMA=TAR<Indikativ<HanHam+UNA
arnalittulli	arnaq-LIK<ental<Aequalis+LI
arnalii	arnaq-LIK<flertal<hans<Absolut
arnalerilaarnerili	arnaq-LIRI-LAAR+NIQ<flertal<hans<Absolut+LI
arnarmiumulli	arnaq+MIU<ental<Terminalis+LI
arnarmiuninguna	arnaq+MIU<flertal<Instrumentalis+UNA
arnarmiulerilaartartunga	arnaq+MIU-LIRI-LAAR=TAR<Participium<jeg
arnarmioqarporuna	arnaq+MIU-QAR<Indikativ<han+UNA
arnarmiuujartorluni	arnaq+MIU-U+GIARTUR<Ledsagemåde<han_selv
arnarmiuusungali	arnaq+MIU-U<Participium<jeg+LI
arnanngulerpoq	arnaq-NNGUR-LIR<Indikativ<han
arnanngorsimasarlungali	arnaq-NNGUR+SIMA=TAR<Ledsagemåde<jeg+LI
arnarpassui	arnaq+PASSUAQ<flertal<hans<Absolut
arnarpassuakka	arnaq+PASSUAQ<flertal<min<Absolut
arnaqalaartarlunili	arnaq-QAR-LAAR=TAR<Ledsagemåde<han_selv+LI
arnaalaarnikka	arnaq-U-LAAR+NIQ<flertal<min<Absolut
assersuulli	assersuut<ental<Absolut+LI
assersuullu	assersuut<ental<Absolut+LU
assersuununa	assersuut<ental<Absolut+UNA
assersuutaa	assersuut<ental<hans<Absolut
assersuumminguna	assersuut<ental<Instrumentalis+UNA
assersuummi	assersuut<ental<Lokalis
assersuummiillunga	assersuut<ental<Lokalis+IP<Ledsagemåde<jeg
assersuummili	assersuut<ental<Lokalis+LI
assersuummilu	assersuut<ental<Lokalis+LU
assersuummiuna	assersuut<ental<Lokalis+UNA
assersuummukalaartorli	assersuut<ental<Terminalis-KAR-LAAR+TUQ+LI
assersuummukassagaluarlungalu	assersuut<ental<Terminalis-KAR-SSA=GALUAR<Ledsagemåde<jeg+LU
assersuummulli	assersuut<ental<Terminalis+LI
assersuutigitiginuna	assersuut+GӘ<Imperativ<ViDem+UNA
assersuutigilaarpiuk	assersuut+GӘ-LAAR<Interrogativ<DuHam
assersuutaannaqassappununa	assersuut-INNAQ-QAR-SSA<Indikativ<de+UNA
assersuutilerisimasungalu	assersuut-LIRI+SIMA<Participium<jeg+LU
assersuutilerisarporlu	assersuut-LIRI+TAR<Indikativ<han+LU
assersuutimiu	assersuut+MIU<ental<Absolut
assersuutinngualeriniannginneq	assersuut-NNGUAQ-LIRI+NIAR=NNGIT+NIQ<ental<Absolut
assersuutaagaluarluni	assersuut-U+GALUAR<Ledsagemåde<han_selv
ataaseq	ataaseqTalord<Absolut
ataasiuisi	ataaseq-U<Interrogativ<I
ataatalimmut	ataata-LIK<ental<Terminalis
ateqartunga	ateqar<Participium<jeg
atianuna	ateq<ental<deres<Absolut+UNA
aterissagaluarpiuk	ateq+GӘ-SSA=GALUAR<Interrogativ<DuHam
atiinnaasarpisi	ateq-INNAQ-U+TAR<Interrogativ<I
atileriartortoqassagaluarlutillu	ateq-LIRI+GIARTUR+TUQ-QAR-SSA=GALUAR<Ledsagemåde<de_selv+LU
atinngulaartarneri	ateq-NNGUR-LAAR=TAR+NIQ<flertal<hans<Absolut
aterpassuinuna	ateq+PASSUAQ<flertal<Absolut+UNA
atulaartuali	ator-LAAR+TUQ<ental<hans<Absolut+LI
atorniartigit	ator+NIAR<Imperativ<ViDem
atornani	ator-NNGIT<Ledsagemåde<han_selv
atorsimasorlu	ator+SIMA<Participium<han+LU
atussagaluarlunga	ator-SSA=GALUAR<Ledsagemåde<mig
atussagaluartununa	ator-SSA=GALUAR<Participium<de+UNA
atussallugulu	ator-SSA<Ledsagemåde<ham+LU
atualaartarpit	atuar-LAAR=TAR<Interrogativ<du
atuartunnguamukalaartartorlu	atuar+TUQ-NNGUAQ<ental<Terminalis-KAR-LAAR=TAR<Participium<han+LU
Avanersuaq	Avanersuaq<Absolut
Avanersuarli	Avanersuaq<Absolut+LI
Avanersuarlu	Avanersuaq<Absolut+LU
Avanersuaruna	Avanersuaq<Absolut+UNA
Avanersuarmik	Avanersuaq<Instrumentalis
Avanersuarmilli	Avanersuaq<Instrumentalis+LI
Avanersuarminguna	Avanersuaq<Instrumentalis+UNA
Avanersuarmi	Avanersuaq<Lokalis
Avanersuarmiippit	Avanersuaq<Lokalis+IP<Interrogativ<du
Avanersuarmiilerneq	Avanersuaq<Lokalis+IP-LIR+NIQ
Avanersuarmili	Avanersuaq<Lokalis+LI
Avanersuarmiumi	Avanersuaq+MIU<ental<Lokalis
Avanersuarmiumili	Avanersuaq+MIU<ental<Lokalis+LI
Avanersuarmiumukalaarlutik	Avanersuaq+MIU<ental<Terminalis-KAR-LAAR<Ledsagemåde<de_selv
Avanersuarmiumulli	Avanersuaq+MIU<ental<Terminalis+LI
Avanersuarmiuni	Avanersuaq+MIU<flertal<Lokalis
Avanersuarmiunilu	Avanersuaq+MIU<flertal<Lokalis+LU
Avanersuarmiuleriniarnatik	Avanersuaq+MIU-LIRI+NIAR=NNGIT<Ledsagemåde<de_selv
Avanersuarmiulerisunga	Avanersuaq+MIU-LIRI<Participium<jeg
Avanersuarmiunngussagaluarnikka	Avanersuaq+MIU-NNGUR-SSA=GALUAR+NIQ<flertal<min<Absolut
Avanersuarmioqarpoq	Avanersuaq+MIU-QAR<Indikativ<han
Avanersuarmioqarporlu	Avanersuaq+MIU-QAR<Indikativ<han+LU
Avanersuarmioqarneq	Avanersuaq+MIU-QAR+NIQ<ental<Absolut
Avanersuarmioqarnerli	Avanersuaq+MIU-QAR+NIQ<ental<Absolut+LI
Avanersuarmioqarnerlu	Avanersuaq+MIU-QAR+NIQ<ental<Absolut+LU
Avanersuarmioqarneruna	Avanersuaq+MIU-QAR+NIQ<ental<Absolut+UNA
Avanersuarmioqartoq	Avanersuaq+MIU-QAR<Participium<han
Avanersuarmioqartorli	Avanersuaq+MIU-QAR<Participium<han+LI
Avanersuarmiuulaarpit	Avanersuaq+MIU-U-LAAR<Interrogativ<du
Avanersuarmiuuniartoq	Avanersuaq+MIU-U+NIAR<Participium<han
Avanersuarmiuusimasarnikka	Avanersuaq+MIU-U+SIMA=TAR+NIQ<flertal<min<Absolut
Avanersuarmiuusimasoqalaartarnikka	Avanersuaq+MIU-U+SIMA+TUQ-QAR-LAAR=TAR+NIQ<flertal<min<Absolut
Avanersuarmiuusinnaasoq	Avanersuaq+MIU-U+SINNAA+TUQ<ental<Absolut
Avanersuarmiuussagaluarpungali	Avanersuaq+MIU-U-SSA=GALUAR<Indikativ<jeg+LI
Avanersuarmiuusartullu	Avanersuaq+MIU-U+TAR<Participium<de+LU
Avanersuarmiuusartui	Avanersuaq+MIU-U+TAR+TUQ<flertal<hans<Absolut
Avanersuarmut	Avanersuaq<Terminalis
Avanersuarmukalaarporli	Avanersuaq<Terminalis-KAR-LAAR<Indikativ<han+LI
Avanersuarmukalaartartoqanngilaq	Avanersuaq<Terminalis-KAR-LAAR=TAR+TUQ-QAR-NNGIT<Indikativ<han
Avanersuarmukalaartartoqanngilarli	Avanersuaq<Terminalis-KAR-LAAR=TAR+TUQ-QAR-NNGIT<Indikativ<han+LI
Avanersuarmukalerpunga	Avanersuaq<Terminalis-KAR-LIR<Indikativ<jeg
Avanersuarmukalerpit	Avanersuaq<Terminalis-KAR-LIR<Interrogativ<du
Avanersuarmukanngitsoq	Avanersuaq<Terminalis-KAR-NNGIT+TUQ<ental<Absolut
Avanersuarmukassagaluarlungali	Avanersuaq<Terminalis-KAR-SSA=GALUAR<Ledsagemåde<jeg+LI
Avanersuarmukassavit	Avanersuaq<Terminalis-KAR-SSA<Interrogativ<du
Avanersuarmukassasut	Avanersuaq<Terminalis-KAR-SSA<Participium<de
Avanersuarmulli	Avanersuaq<Terminalis+LI
Avanersuarmununa	Avanersuaq<Terminalis+UNA
eqqaamagaluartigillu	eqqaama+GALUAR<Imperativ<ViDem+LU
eqqaamagaluarlugu	eqqaama+GALUAR<Ledsagemåde<ham
eqqaamajartorlugu	eqqaama+GIARTUR<Ledsagemåde<ham
eqqaamavaanngalu	eqqaama<Indikativ<DeMig+LU
eqqaamavaalu	eqqaama<Indikativ<HanDem+LU
eqqaamavassi	eqqaama<Indikativ<JegJer
eqqaamalaartigit	eqqaama-LAAR<Imperativ<ViDem
eqqaamalaartarlunga	eqqaama-LAAR=TAR<Ledsagemåde<mig
eqqaamalertigit	eqqaama-LIR<Imperativ<ViDem
eqqaamaniarpassilu	eqqaama+NIAR<Indikativ<JegJer+LU
eqqaamaniarlugit	eqqaama+NIAR<Ledsagemåde<dem
eqqaamananga	eqqaama-NNGIT<Ledsagemåde<mig
eqqaamasimatigit	eqqaama+SIMA<Imperativ<ViDem
eqqaamasimatigilli	eqqaama+SIMA<Imperativ<ViDem+LI
eqqaamasimaviuk	eqqaama+SIMA<Interrogativ<DuHam
eqqaamasimasartigit	eqqaama+SIMA=TAR<Imperativ<ViDem
eqqaamasimasartigillu	eqqaama+SIMA=TAR<Imperativ<ViDem+LU
eqqaamasimasarluguli	eqqaama+SIMA=TAR<Ledsagemåde<ham+LI
eqqaamasinnaavaallu	eqqaama+SINNAA<Indikativ<DeDem+LU
eqqaamasaraluarlugit	eqqaama+TAR=GALUAR<Ledsagemåde<dem
eqqaamasarpiuk	eqqaama+TAR<Interrogativ<DuHam
eqqaamasarlungalu	eqqaama+TAR<Ledsagemåde<mig+LU
eqqaq	eqqaq<ental<Absolut
eqqarli	eqqaq<ental<Absolut+LI
eqqaminguna	eqqaq<ental<Instrumentalis+UNA
eqqara	eqqaq<ental<min<Absolut
eqqaa	eqqaq<flertal<hans<Absolut
eqqaniippungali	eqqaq<flertal<Lokalis+IP<Indikativ<jeg+LI
eqqakka	eqqaq<flertal<min<Absolut
eqqaritiginuna	eqqaq+GӘ<Imperativ<ViDem+UNA
eqqarisimatiginuna	eqqaq+GӘ+SIMA<Imperativ<ViDem+UNA
eqqarisimasarpakkali	eqqaq+GӘ+SIMA=TAR<Indikativ<JegDem+LI
eqqarisinnaatigilli	eqqaq+GӘ+SINNAA<Imperativ<ViDem+LI
eqqarisinnaavassi	eqqaq+GӘ+SINNAA<Indikativ<JegJer
eqqaannaq	eqqaq-INNAQ<ental<Absolut
eqqaannalerilluni	eqqaq-INNAQ-LIRI<Ledsagemåde<han_selv
eqqaannalerisaraluarnera	eqqaq-INNAQ-LIRI+TAR=GALUAR+NIQ<ental<hans<Absolut
eqqaannaqarlunilu	eqqaq-INNAQ-QAR<Ledsagemåde<han_selv+LU
eqqalimmullu	eqqaq-LIK<ental<Terminalis+LU
eqqallilli	eqqaq-LIK<flertal<Absolut+LI
eqqallit	eqqaq-LIK<flertal<Relativ
eqqalerivoq	eqqaq-LIRI<Indikativ<han
eqqalerisimasarnikka	eqqaq-LIRI+SIMA=TAR+NIQ<flertal<min<Absolut
eqqalerissagaluartulli	eqqaq-LIRI-SSA=GALUAR<Participium<de+LI
eqqalerisaraluarnikka	eqqaq-LIRI+TAR=GALUAR+NIQ<flertal<min<Absolut
eqqarmiumik	eqqaq+MIU<ental<Instrumentalis
eqqarmiumiilaartunga	eqqaq+MIU<ental<Lokalis+IP-LAAR<Participium<jeg
eqqarmiumut	eqqaq+MIU<ental<Terminalis
eqqarmiuniilaarneq	eqqaq+MIU<flertal<Lokalis+IP-LAAR+NIQ
eqqarmiuniuna	eqqaq+MIU<flertal<Lokalis+UNA
eqqarmiulerisimasarnikkaana	eqqaq+MIU-LIRI+SIMA=TAR+NIQ<flertal<min<Absolut+UNA
eqqarmioqarneq	eqqaq+MIU-QAR+NIQ<ental<Absolut
eqqarmioqarnerlu	eqqaq+MIU-QAR+NIQ<ental<Absolut+LU
eqqarmioqartorli	eqqaq+MIU-QAR<Participium<han+LI
eqqarmiuulaarlutillu	eqqaq+MIU-U-LAAR<Ledsagemåde<de_selv+LU
eqqarmiuulaartartuliili	eqqaq+MIU-U-LAAR=TAR+TUQ-LIK<flertal<hans<Absolut+LI
eqqarmiuulluni	eqqaq+MIU-U<Ledsagemåde<han_selv
eqqarmiuuniarnatilli	eqqaq+MIU-U+NIAR=NNGIT<Ledsagemåde<de_selv+LI
eqqarmiuuniarnanilu	eqqaq+MIU-U+NIAR=NNGIT<Ledsagemåde<han_selv+LU
eqqarmiuusaraluartungaana	eqqaq+MIU-U+TAR=GALUAR<Participium<jeg+UNA
eqqarmiuusaraluartoqassagaluartunngussaangali	eqqaq+MIU-U+TAR=GALUAR+TUQ-QAR-SSA=GALUAR+TUQ-NNGUR-SSA<Indikativ<jeg+LI
eqqanngua	eqqaq-NNGUAQ<ental<hans<Absolut
eqqanngui	eqqaq-NNGUAQ<flertal<hans<Absolut
eqqanngualerisimasarpisi	eqqaq-NNGUAQ-LIRI+SIMA=TAR<Interrogativ<I
eqqanngualerisarlutillu	eqqaq-NNGUAQ-LIRI+TAR<Ledsagemåde<de_selv+LU
eqqanngoraluartorli	eqqaq-NNGUR+GALUAR<Participium<han+LI
eqqanngornernukassalluni	eqqaq-NNGUR+NIQ<flertal<Terminalis-KAR-SSA<Ledsagemåde<han_selv
eqqanngornani	eqqaq-NNGUR-NNGIT<Ledsagemåde<han_selv
eqqanngortarneralli	eqqaq-NNGUR+TAR+NIQ<ental<deres+LI
eqqarpassuilli	eqqaq+PASSUAQ<flertal<Absolut+LI
eqqarpassuakka	eqqaq+PASSUAQ<flertal<min<Absolut
eqqarpassuakkaana	eqqaq+PASSUAQ<flertal<min<Absolut+UNA
eqqaqalertoqartaraluarnertununa	eqqaq-QAR-LIR+TUQ-QAR+TAR=GALUAR+NIQ<ental<Aequalis+UNA
eqqaqassavisi	eqqaq-QAR-SSA<Interrogativ<I
eqqaajartortunga	eqqaq-U+GIARTUR<Participium<jeg
eqqaaneralli	eqqaq-U+NIQ<ental<deres+LI
eqqaanangali	eqqaq-U-NNGIT<Ledsagemåde<jeg+LI
eqqaasaraluarpullu	eqqaq-U+TAR=GALUAR<Indikativ<de+LU
eqqaasarnikka	eqqaq-U+TAR+NIQ<flertal<min<Absolut
eqqumiitsuliortoq	eqqumiitsuliortoq<ental<Absolut
eqqumiitsuliortumi	eqqumiitsuliortoq<ental<Lokalis
eqqumiitsuliortumiilaartoq	eqqumiitsuliortoq<ental<Lokalis+IP-LAAR<Participium<han
eqqumiitsuliortumiinnianngitsungaana	eqqumiitsuliortoq<ental<Lokalis+IP+NIAR=NNGIT<Participium<jeg+UNA
eqqumiitsuliortora	eqqumiitsuliortoq<ental<min<Absolut
eqqumiitsuliortoralu	eqqumiitsuliortoq<ental<min<Absolut+LU
eqqumiitsuliortumukartoqarporli	eqqumiitsuliortoq<ental<Terminalis-KAR+TUQ-QAR<Indikativ<han+LI
eqqumiitsuliortumulli	eqqumiitsuliortoq<ental<Terminalis+LI
eqqumiitsuliortui	eqqumiitsuliortoq<flertal<hans<Absolut
eqqumiitsuliortuilu	eqqumiitsuliortoq<flertal<hans<Absolut+LU
eqqumiitsuliortunik	eqqumiitsuliortoq<flertal<Instrumentalis
eqqumiitsuliortunilli	eqqumiitsuliortoq<flertal<Instrumentalis+LI
eqqumiitsuliortuni	eqqumiitsuliortoq<flertal<Lokalis
eqqumiitsuliortukka	eqqumiitsuliortoq<flertal<min<Absolut
eqqumiitsuliortukkali	eqqumiitsuliortoq<flertal<min<Absolut+LI
eqqumiitsuliortoriartorlugilli	eqqumiitsuliortoq+GӘ+GIARTUR<Ledsagemåde<dem+LI
eqqumiitsuliortorilaarpaali	eqqumiitsuliortoq+GӘ-LAAR<Indikativ<HanHam+LI
eqqumiitsuliortorilaarlugilli	eqqumiitsuliortoq+GӘ-LAAR<Ledsagemåde<dem+LI
eqqumiitsuliortorissagaluarpakka	eqqumiitsuliortoq+GӘ-SSA=GALUAR<Indikativ<JegDem
eqqumiitsuliortorisartigillu	eqqumiitsuliortoq+GӘ+TAR<Imperativ<ViDem+LU
eqqumiitsuliortuinnaq	eqqumiitsuliortoq-INNAQ<ental<Absolut
eqqumiitsuliortuinnaali	eqqumiitsuliortoq-INNAQ<ental<hans<Absolut+LI
eqqumiitsuliortuinnaat	eqqumiitsuliortoq-INNAQ<flertal<Relativ
eqqumiitsuliortuinnaleriniartoq	eqqumiitsuliortoq-INNAQ-LIRI+NIAR+TUQ<ental<Absolut
eqqumiitsuliortuinnalerisimavit	eqqumiitsuliortoq-INNAQ-LIRI+SIMA<Interrogativ<du
eqqumiitsuliortuinnaalaartartoqanngilangali	eqqumiitsuliortoq-INNAQ-U-LAAR=TAR+TUQ-QAR-NNGIT<Indikativ<jeg+LI
eqqumiitsuliortulik	eqqumiitsuliortoq-LIK<ental<Absolut
eqqumiitsuliortulia	eqqumiitsuliortoq-LIK<ental<hans<Absolut
eqqumiitsuliortullit	eqqumiitsuliortoq-LIK<flertal<Absolut
eqqumiitsuliortullinuna	eqqumiitsuliortoq-LIK<flertal<Absolut+UNA
eqqumiitsuliortullilli	eqqumiitsuliortoq-LIK<flertal<Relativ+LI
eqqumiitsuliortulinngunngilanga	eqqumiitsuliortoq-LIK-NNGUR-NNGIT<Indikativ<jeg
eqqumiitsuliortulerillunili	eqqumiitsuliortoq-LIRI<Ledsagemåde<han_selv+LI
eqqumiitsuliortulerillunga	eqqumiitsuliortoq-LIRI<Ledsagemåde<jeg
eqqumiitsuliortulerissalluni	eqqumiitsuliortoq-LIRI-SSA<Ledsagemåde<han_selv
eqqumiitsuliortormiumullu	eqqumiitsuliortoq+MIU<ental<Terminalis+LU
eqqumiitsuliortormioqarporli	eqqumiitsuliortoq+MIU-QAR<Indikativ<han+LI
eqqumiitsuliortormioqarneq	eqqumiitsuliortoq+MIU-QAR+NIQ<ental<Absolut
eqqumiitsuliortormioqarneruna	eqqumiitsuliortoq+MIU-QAR+NIQ<ental<Absolut+UNA
eqqumiitsuliortormioqartoq	eqqumiitsuliortoq+MIU-QAR<Participium<han
eqqumiitsuliortormioqartoq	eqqumiitsuliortoq+MIU-QAR+TUQ<ental<Absolut
eqqumiitsuliortormiuujartorpit	eqqumiitsuliortoq+MIU-U+GIARTUR<Interrogativ<du
eqqumiitsuliortormiuuvungaana	eqqumiitsuliortoq+MIU-U<Indikativ<jeg+UNA
eqqumiitsuliortormiuulerluni	eqqumiitsuliortoq+MIU-U-LIR<Ledsagemåde<han_selv
eqqumiitsuliortormiuuniarpunga	eqqumiitsuliortoq+MIU-U+NIAR<Indikativ<jeg
eqqumiitsuliortormiuunnginnerilli	eqqumiitsuliortoq+MIU-U-NNGIT+NIQ<flertal<Absolut+LI
eqqumiitsuliortormiuussagaluarlutilli	eqqumiitsuliortoq+MIU-U-SSA=GALUAR<Ledsagemåde<de_selv+LI
eqqumiitsuliortunngua	eqqumiitsuliortoq-NNGUAQ<ental<hans<Absolut
eqqumiitsuliortunngualu	eqqumiitsuliortoq-NNGUAQ<ental<hans<Absolut+LU
eqqumiitsuliortunngui	eqqumiitsuliortoq-NNGUAQ<flertal<hans<Absolut
eqqumiitsuliortunnguusaraluarpisi	eqqumiitsuliortoq-NNGUAQ-U+TAR=GALUAR<Interrogativ<I
eqqumiitsuliortunngulaartungali	eqqumiitsuliortoq-NNGUR-LAAR<Participium<jeg+LI
eqqumiitsuliortunngulaartarlutinguna	eqqumiitsuliortoq-NNGUR-LAAR=TAR<Ledsagemåde<de_selv+UNA
eqqumiitsuliortunngornanga	eqqumiitsuliortoq-NNGUR-NNGIT<Ledsagemåde<jeg
eqqumiitsuliortunngortullu	eqqumiitsuliortoq-NNGUR<Participium<de+LU
eqqumiitsuliortunngussagaluartumununa	eqqumiitsuliortoq-NNGUR-SSA=GALUAR+TUQ<ental<Terminalis+UNA
eqqumiitsuliortunngussasulli	eqqumiitsuliortoq-NNGUR-SSA<Participium<de+LI
eqqumiitsuliortorpassuilli	eqqumiitsuliortoq+PASSUAQ<flertal<Absolut+LI
eqqumiitsuliortorpassuarni	eqqumiitsuliortoq+PASSUAQ<flertal<Lokalis
eqqumiitsuliortoqalaarpisi	eqqumiitsuliortoq-QAR-LAAR<Interrogativ<I
eqqumiitsuliortoqalaartungalu	eqqumiitsuliortoq-QAR-LAAR<Participium<jeg+LU
eqqumiitsuliortoqalaartarpoq	eqqumiitsuliortoq-QAR-LAAR=TAR<Indikativ<han
eqqumiitsuliortoqalaartarnikkalu	eqqumiitsuliortoq-QAR-LAAR=TAR+NIQ<flertal<min<Absolut+LU
eqqumiitsuliortoqalaartartoq	eqqumiitsuliortoq-QAR-LAAR=TAR<Participium<han
eqqumiitsuliortoqalaartunngussaanga	eqqumiitsuliortoq-QAR-LAAR+TUQ-NNGUR-SSA<Indikativ<jeg
eqqumiitsuliortoqarlunga	eqqumiitsuliortoq-QAR<Ledsagemåde<jeg
eqqumiitsuliortoqalernernik	eqqumiitsuliortoq-QAR-LIR+NIQ<flertal<Instrumentalis
eqqumiitsuliortoqanngitsulli	eqqumiitsuliortoq-QAR-NNGIT<Participium<de+LI
eqqumiitsuliortoqanngitsoq	eqqumiitsuliortoq-QAR-NNGIT+TUQ<ental<Absolut
eqqumiitsuliortoqassagaluarpunga	eqqumiitsuliortoq-QAR-SSA=GALUAR<Indikativ<jeg
eqqumiitsuliortoqassagaluartungali	eqqumiitsuliortoq-QAR-SSA=GALUAR<Participium<jeg+LI
eqqumiitsuliortuujartornerilu	eqqumiitsuliortoq-U+GIARTUR+NIQ<flertal<hans<Absolut+LU
eqqumiitsuliortuulaartarlunili	eqqumiitsuliortoq-U-LAAR=TAR<Ledsagemåde<han_selv+LI
eqqumiitsuliortuulluni	eqqumiitsuliortoq-U<Ledsagemåde<han_selv
eqqumiitsuliortuuniarnanga	eqqumiitsuliortoq-U+NIAR=NNGIT<Ledsagemåde<jeg
eqqumiitsuliortuusununa	eqqumiitsuliortoq-U<Participium<de+UNA
eqqumiitsuliortuusimasarlungali	eqqumiitsuliortoq-U+SIMA=TAR<Ledsagemåde<jeg+LI
eqqumiitsuliortuusimasoq	eqqumiitsuliortoq-U+SIMA+TUQ<ental<Absolut
eqqumiitsuliortuussallutik	eqqumiitsuliortoq-U-SSA<Ledsagemåde<de_selv
Esbjerg	Esbjerg<Absolut
Esbjergili	Esbjerg<Absolut+LI
Esbjergilu	Esbjerg<Absolut+LU
Esbjergiuna	Esbjerg<Absolut+UNA
Esbjergimik	Esbjerg<Instrumentalis
Esbjergimilli	Esbjerg<Instrumentalis+LI
Esbjergimillu	Esbjerg<Instrumentalis+LU
Esbjergiminguna	Esbjerg<Instrumentalis+UNA
Esbjergimi	Esbjerg<Lokalis
Esbjergimiikkaluarneruna	Esbjerg<Lokalis+IP+GALUAR+NIQ+UNA
Esbjergimiilaartoqarpoq	Esbjerg<Lokalis+IP-LAAR+TUQ-QAR<Indikativ<han
Esbjergimiinniarnangaana	Esbjerg<Lokalis+IP+NIAR=NNGIT<Ledsagemåde<jeg+UNA
Esbjergimiittulli	Esbjerg<Lokalis+IP<Participium<de+LI
Esbjergimiissinnaavisi	Esbjerg<Lokalis+IP+SINNAA<Interrogativ<I
Esbjergimiissagaluarlunga	Esbjerg<Lokalis+IP-SSA=GALUAR<Ledsagemåde<jeg
Esbjergimiissallutinguna	Esbjerg<Lokalis+IP-SSA<Ledsagemåde<de_selv+UNA
Esbjergimili	Esbjerg<Lokalis+LI
Esbjergimilu	Esbjerg<Lokalis+LU
Esbjergimiuna	Esbjerg<Lokalis+UNA
Esbjergimiu	Esbjerg+MIU<ental<Absolut
Esbjergimiumik	Esbjerg+MIU<ental<Instrumentalis
Esbjergimiumiissasulli	Esbjerg+MIU<ental<Lokalis+IP-SSA<Participium<de+LI
Esbjergimiunik	Esbjerg+MIU<flertal<Instrumentalis
Esbjergimiunilli	Esbjerg+MIU<flertal<Instrumentalis+LI
Esbjergimiuni	Esbjerg+MIU<flertal<Lokalis
Esbjergimiuniilaartartorli	Esbjerg+MIU<flertal<Lokalis+IP-LAAR=TAR<Participium<han+LI
Esbjergimiuniissaanga	Esbjerg+MIU<flertal<Lokalis+IP-SSA<Indikativ<jeg
Esbjergimiuniissasunga	Esbjerg+MIU<flertal<Lokalis+IP-SSA<Participium<jeg
Esbjergimiulerigaluarlunili	Esbjerg+MIU-LIRI+GALUAR<Ledsagemåde<han_selv+LI
Esbjergimiuleriniarnatinguna	Esbjerg+MIU-LIRI+NIAR=NNGIT<Ledsagemåde<de_selv+UNA
Esbjergimiuleriniarnani	Esbjerg+MIU-LIRI+NIAR=NNGIT<Ledsagemåde<han_selv
Esbjergimiulerinianngitsormiuniinniartut	Esbjerg+MIU-LIRI+NIAR=NNGIT+TUQ+MIU<flertal<Lokalis+IP+NIAR<Participium<de
Esbjergimiuleriniartoq	Esbjerg+MIU-LIRI+NIAR<Participium<han
Esbjergimiulerinikkaana	Esbjerg+MIU-LIRI+NIQ<flertal<min<Absolut+UNA
Esbjergimiulerisimavugununa	Esbjerg+MIU-LIRI+SIMA<Indikativ<vi+UNA
Esbjergimiulerisarpit	Esbjerg+MIU-LIRI+TAR<Interrogativ<du
Esbjergimiunngoraluarpit	Esbjerg+MIU-NNGUR+GALUAR<Interrogativ<du
Esbjergimiunngoraluarnerit	Esbjerg+MIU-NNGUR+GALUAR+NIQ<flertal<Relativ
Esbjergimiunngulaarpisi	Esbjerg+MIU-NNGUR-LAAR<Interrogativ<I
Esbjergimiunngulaartarpit	Esbjerg+MIU-NNGUR-LAAR=TAR<Interrogativ<du
Esbjergimiunngulaartartorli	Esbjerg+MIU-NNGUR-LAAR=TAR<Participium<han+LI
Esbjergimiunngorlunga	Esbjerg+MIU-NNGUR<Ledsagemåde<jeg
Esbjergimiunngulerpisi	Esbjerg+MIU-NNGUR-LIR<Interrogativ<I
Esbjergimiunngulertumi	Esbjerg+MIU-NNGUR-LIR+TUQ<ental<Lokalis
Esbjergimiunngunnginnernukanngitsorli	Esbjerg+MIU-NNGUR-NNGIT+NIQ<flertal<Terminalis-KAR-NNGIT+TUQ<ental<Absolut+LI
Esbjergimiunngortaraluarlutik	Esbjerg+MIU-NNGUR+TAR=GALUAR<Ledsagemåde<de_selv
Esbjergimiunngortaraluarnikka	Esbjerg+MIU-NNGUR+TAR=GALUAR+NIQ<flertal<min<Absolut
Esbjergimiunngortartunga	Esbjerg+MIU-NNGUR+TAR<Participium<jeg
Esbjergimioqarpoq	Esbjerg+MIU-QAR<Indikativ<han
Esbjergimioqarporli	Esbjerg+MIU-QAR<Indikativ<han+LI
Esbjergimioqarporlu	Esbjerg+MIU-QAR<Indikativ<han+LU
Esbjergimioqarneq	Esbjerg+MIU-QAR+NIQ<ental<Absolut
Esbjergimioqarnerli	Esbjerg+MIU-QAR+NIQ<ental<Absolut+LI
Esbjergimioqarneruna	Esbjerg+MIU-QAR+NIQ<ental<Absolut+UNA
Esbjergimioqartoq	Esbjerg+MIU-QAR<Participium<han
Esbjergimioqartorli	Esbjerg+MIU-QAR<Participium<han+LI
Esbjergimioqartorlu	Esbjerg+MIU-QAR<Participium<han+LU
Esbjergimioqartoruna	Esbjerg+MIU-QAR<Participium<han+UNA
Esbjergimioqartoq	Esbjerg+MIU-QAR+TUQ<ental<Absolut
Esbjergimioqartorli	Esbjerg+MIU-QAR+TUQ<ental<Absolut+LI
Esbjergimioqartorlu	Esbjerg+MIU-QAR+TUQ<ental<Absolut+LU
Esbjergimioqartoruna	Esbjerg+MIU-QAR+TUQ<ental<Absolut+UNA
Esbjergimiuugaluartulli	Esbjerg+MIU-U+GALUAR<Participium<de+LI
Esbjergimiuugaluartunga	Esbjerg+MIU-U+GALUAR<Participium<jeg
Esbjergimiuugaluartuliiuna	Esbjerg+MIU-U+GALUAR+TUQ-LIK<flertal<hans<Absolut+UNA
Esbjergimiuujartortulerissagaluarlungalu	Esbjerg+MIU-U+GIARTUR+TUQ-LIRI-SSA=GALUAR<Ledsagemåde<jeg+LU
Esbjergimiuuvugulli	Esbjerg+MIU-U<Indikativ<vi+LI
Esbjergimiuuisi	Esbjerg+MIU-U<Interrogativ<I
Esbjergimiuullutinguna	Esbjerg+MIU-U<Ledsagemåde<de_selv+UNA
Esbjergimiuullungalu	Esbjerg+MIU-U<Ledsagemåde<jeg+LU
Esbjergimiuulerpugut	Esbjerg+MIU-U-LIR<Indikativ<vi
Esbjergimiuulerpisi	Esbjerg+MIU-U-LIR<Interrogativ<I
Esbjergimiuulernertut	Esbjerg+MIU-U-LIR+NIQ<ental<Aequalis
Esbjergimiuulernikka	Esbjerg+MIU-U-LIR+NIQ<flertal<min<Absolut
Esbjergimiuulertoqassavit	Esbjerg+MIU-U-LIR+TUQ-QAR-SSA<Interrogativ<du
Esbjergimiuunianngillat	Esbjerg+MIU-U+NIAR=NNGIT<Indikativ<de
Esbjergimiuuniarnanga	Esbjerg+MIU-U+NIAR=NNGIT<Ledsagemåde<jeg
Esbjergimiuuniartoq	Esbjerg+MIU-U+NIAR<Participium<han
Esbjergimiuuneq	Esbjerg+MIU-U+NIQ<ental<Absolut
Esbjergimiuunikka	Esbjerg+MIU-U+NIQ<flertal<min<Absolut
Esbjergimiuunerillu	Esbjerg+MIU-U+NIQ<flertal<Relativ+LU
Esbjergimiuusorlu	Esbjerg+MIU-U<Participium<han+LU
Esbjergimiuusungali	Esbjerg+MIU-U<Participium<jeg+LI
Esbjergimiuusimanikka	Esbjerg+MIU-U+SIMA+NIQ<flertal<min<Absolut
Esbjergimiuusimasarpit	Esbjerg+MIU-U+SIMA=TAR<Interrogativ<du
Esbjergimiuusimasoq	Esbjerg+MIU-U+SIMA+TUQ<ental<Absolut
Esbjergimiuusimasunnguili	Esbjerg+MIU-U+SIMA+TUQ-NNGUAQ<flertal<hans<Absolut+LI
Esbjergimiuusinnaavoq	Esbjerg+MIU-U+SINNAA<Indikativ<han
Esbjergimiuusinnaavorlu	Esbjerg+MIU-U+SINNAA<Indikativ<han+LU
Esbjergimiuusinnaallutilli	Esbjerg+MIU-U+SINNAA<Ledsagemåde<de_selv+LI
Esbjergimiuusinnaasunngussallutik	Esbjerg+MIU-U+SINNAA+TUQ-NNGUR-SSA<Ledsagemåde<de_selv
Esbjergimiuussallutinguna	Esbjerg+MIU-U-SSA<Ledsagemåde<de_selv+UNA
Esbjergimiuusarput	Esbjerg+MIU-U+TAR<Indikativ<de
Esbjergimiuusoq	Esbjerg+MIU-U+TUQ<ental<Absolut
Esbjergimiuusunngussagaluarlungali	Esbjerg+MIU-U+TUQ-NNGUR-SSA=GALUAR<Ledsagemåde<jeg+LI
Esbjergimut	Esbjerg<Terminalis
Esbjergimukariartorpunga	Esbjerg<Terminalis-KAR+GIARTUR<Indikativ<jeg
Esbjergimukalaarpugulli	Esbjerg<Terminalis-KAR-LAAR<Indikativ<vi+LI
Esbjergimukalaarpugununa	Esbjerg<Terminalis-KAR-LAAR<Indikativ<vi+UNA
Esbjergimukalaarpit	Esbjerg<Terminalis-KAR-LAAR<Interrogativ<du
Esbjergimukalaarlunili	Esbjerg<Terminalis-KAR-LAAR<Ledsagemåde<han_selv+LI
Esbjergimukalaartulli	Esbjerg<Terminalis-KAR-LAAR<Participium<de+LI
Esbjergimukalaartunga	Esbjerg<Terminalis-KAR-LAAR<Participium<jeg
Esbjergimukalaartungaana	Esbjerg<Terminalis-KAR-LAAR<Participium<jeg+UNA
Esbjergimukalaartarneq	Esbjerg<Terminalis-KAR-LAAR=TAR+NIQ
Esbjergimukalaartartoqanngilaq	Esbjerg<Terminalis-KAR-LAAR=TAR+TUQ-QAR-NNGIT<Indikativ<han
Esbjergimukalaartorli	Esbjerg<Terminalis-KAR-LAAR+TUQ+LI
Esbjergimukarlungali	Esbjerg<Terminalis-KAR<Ledsagemåde<jeg+LI
Esbjergimukalerpunga	Esbjerg<Terminalis-KAR-LIR<Indikativ<jeg
Esbjergimukanngilaq	Esbjerg<Terminalis-KAR-NNGIT<Indikativ<han
Esbjergimukanngilatit	Esbjerg<Terminalis-KAR-NNGIT<Interrogativ<du
Esbjergimukassappununa	Esbjerg<Terminalis-KAR-SSA<Indikativ<de+UNA
Esbjergimukassalluni	Esbjerg<Terminalis-KAR-SSA<Ledsagemåde<han_selv
Esbjergimukartoq	Esbjerg<Terminalis-KAR+TUQ
Esbjergimulli	Esbjerg<Terminalis+LI
Esbjergimullu	Esbjerg<Terminalis+LU
Esbjergimununa	Esbjerg<Terminalis+UNA
Finland	Finland<Absolut
Finlandili	Finland<Absolut+LI
Finlandilu	Finland<Absolut+LU
Finlandiuna	Finland<Absolut+UNA
Finlandimik	Finland<Instrumentalis
Finlandimilli	Finland<Instrumentalis+LI
Finlandimillu	Finland<Instrumentalis+LU
Finlandiminguna	Finland<Instrumentalis+UNA
Finlandimi	Finland<Lokalis
Finlandimiikkaluarnerli	Finland<Lokalis+IP+GALUAR+NIQ+LI
Finlandimiippugullu	Finland<Lokalis+IP<Indikativ<vi+LU
Finlandimiilaartarlunga	Finland<Lokalis+IP-LAAR=TAR<Ledsagemåde<jeg
Finlandimili	Finland<Lokalis+LI
Finlandimilu	Finland<Lokalis+LU
Finlandimiuna	Finland<Lokalis+UNA
Finlandimiu	Finland+MIU<ental<Absolut
Finlandimiuli	Finland+MIU<ental<Absolut+LI
Finlandimiumi	Finland+MIU<ental<Lokalis
Finlandimiumukarnerli	Finland+MIU<ental<Terminalis-KAR+NIQ+LI
Finlandimiumukassagaluarneq	Finland+MIU<ental<Terminalis-KAR-SSA=GALUAR+NIQ
Finlandimiumullu	Finland+MIU<ental<Terminalis+LU
Finlandimiunilli	Finland+MIU<flertal<Instrumentalis+LI
Finlandimiunillu	Finland+MIU<flertal<Instrumentalis+LU
Finlandimiuni	Finland+MIU<flertal<Lokalis
Finlandimiuniippit	Finland+MIU<flertal<Lokalis+IP<Interrogativ<du
Finlandimiuniippisi	Finland+MIU<flertal<Lokalis+IP<Interrogativ<I
Finlandimiuniissagaluarlunga	Finland+MIU<flertal<Lokalis+IP-SSA=GALUAR<Ledsagemåde<jeg
Finlandimiuniittorlu	Finland+MIU<flertal<Lokalis+IP+TUQ+LU
Finlandimiulerigaluarlungali	Finland+MIU-LIRI+GALUAR<Ledsagemåde<jeg+LI
Finlandimiuleriartorpunga	Finland+MIU-LIRI+GIARTUR<Indikativ<jeg
Finlandimiuleriartortormioqarpoq	Finland+MIU-LIRI+GIARTUR+TUQ+MIU-QAR<Indikativ<han
Finlandimiuleriartortorpassuakka	Finland+MIU-LIRI+GIARTUR+TUQ+PASSUAQ<flertal<min<Absolut
Finlandimiulerissalluni	Finland+MIU-LIRI-SSA<Ledsagemåde<han_selv
Finlandimiulerisullilli	Finland+MIU-LIRI+TUQ-LIK<flertal<Absolut+LI
Finlandimiunngoraluarlutik	Finland+MIU-NNGUR+GALUAR<Ledsagemåde<de_selv
Finlandimiunngoraluartunga	Finland+MIU-NNGUR+GALUAR<Participium<jeg
Finlandimiunngorpit	Finland+MIU-NNGUR<Interrogativ<du
Finlandimiunngulaartarpit	Finland+MIU-NNGUR-LAAR=TAR<Interrogativ<du
Finlandimiunngulaartullillu	Finland+MIU-NNGUR-LAAR+TUQ-LIK<flertal<Relativ+LU
Finlandimiunngortunga	Finland+MIU-NNGUR<Participium<jeg
Finlandimiunngortungali	Finland+MIU-NNGUR<Participium<jeg+LI
Finlandimiunngorsimavunga	Finland+MIU-NNGUR+SIMA<Indikativ<jeg
Finlandimiunngorsinnaavit	Finland+MIU-NNGUR+SINNAA<Interrogativ<du
Finlandimiunngorsinnaanikka	Finland+MIU-NNGUR+SINNAA+NIQ<flertal<min<Absolut
Finlandimiunngussagaluartunga	Finland+MIU-NNGUR-SSA=GALUAR<Participium<jeg
Finlandimiunngussagaluartoq	Finland+MIU-NNGUR-SSA=GALUAR+TUQ<ental<Absolut
Finlandimiunngussasullu	Finland+MIU-NNGUR-SSA<Participium<de+LU
Finlandimiunngussasununa	Finland+MIU-NNGUR-SSA<Participium<de+UNA
Finlandimiunngortarpit	Finland+MIU-NNGUR+TAR<Interrogativ<du
Finlandimioqarpoq	Finland+MIU-QAR<Indikativ<han
Finlandimioqarporli	Finland+MIU-QAR<Indikativ<han+LI
Finlandimioqarneq	Finland+MIU-QAR+NIQ<ental<Absolut
Finlandimioqarnerli	Finland+MIU-QAR+NIQ<ental<Absolut+LI
Finlandimioqarnerlu	Finland+MIU-QAR+NIQ<ental<Absolut+LU
Finlandimioqarneruna	Finland+MIU-QAR+NIQ<ental<Absolut+UNA
Finlandimioqartoq	Finland+MIU-QAR<Participium<han
Finlandimioqartorli	Finland+MIU-QAR<Participium<han+LI
Finlandimioqartoq	Finland+MIU-QAR+TUQ<ental<Absolut
Finlandimioqartorlu	Finland+MIU-QAR+TUQ<ental<Absolut+LU
Finlandimioqartoruna	Finland+MIU-QAR+TUQ<ental<Absolut+UNA
Finlandimiuugaluarpungali	Finland+MIU-U+GALUAR<Indikativ<jeg+LI
Finlandimiuujartorpisi	Finland+MIU-U+GIARTUR<Interrogativ<I
Finlandimiuujartortorillunga	Finland+MIU-U+GIARTUR+TUQ+GӘ<Ledsagemåde<mig
Finlandimiuuvoq	Finland+MIU-U<Indikativ<han
Finlandimiuuvunga	Finland+MIU-U<Indikativ<jeg
Finlandimiuuit	Finland+MIU-U<Interrogativ<du
Finlandimiuuisi	Finland+MIU-U<Interrogativ<I
Finlandimiuulaarlutik	Finland+MIU-U-LAAR<Ledsagemåde<de_selv
Finlandimiuulaartartoriviuk	Finland+MIU-U-LAAR=TAR+TUQ+GӘ<Interrogativ<DuHam
Finlandimiuulluni	Finland+MIU-U<Ledsagemåde<han_selv
Finlandimiuuniarpulli	Finland+MIU-U+NIAR<Indikativ<de+LI
Finlandimiuuniarnikka	Finland+MIU-U+NIAR+NIQ<flertal<min<Absolut
Finlandimiuuniarnatillu	Finland+MIU-U+NIAR=NNGIT<Ledsagemåde<de_selv+LU
Finlandimiuuniarnatinguna	Finland+MIU-U+NIAR=NNGIT<Ledsagemåde<de_selv+UNA
Finlandimiuuniarnanili	Finland+MIU-U+NIAR=NNGIT<Ledsagemåde<han_selv+LI
Finlandimiuuniannginneq	Finland+MIU-U+NIAR=NNGIT+NIQ<ental<Absolut
Finlandimiuunianngitsoq	Finland+MIU-U+NIAR=NNGIT<Participium<han
Finlandimiuuniartulialli	Finland+MIU-U+NIAR+TUQ-LIK<ental<deres+LI
Finlandimiuuniartunnguaq	Finland+MIU-U+NIAR+TUQ-NNGUAQ<ental<Absolut
Finlandimiuunerinuna	Finland+MIU-U+NIQ<flertal<Absolut+UNA
Finlandimiuunikka	Finland+MIU-U+NIQ<flertal<min<Absolut
Finlandimiuunikkali	Finland+MIU-U+NIQ<flertal<min<Absolut+LI
Finlandimiuunerilli	Finland+MIU-U+NIQ<flertal<Relativ+LI
Finlandimiuunernununa	Finland+MIU-U+NIQ<flertal<Terminalis+UNA
Finlandimiuunanga	Finland+MIU-U-NNGIT<Ledsagemåde<jeg
Finlandimiuusunga	Finland+MIU-U<Participium<jeg
Finlandimiuusimalluniuna	Finland+MIU-U+SIMA<Ledsagemåde<han_selv+UNA
Finlandimiuusimaneq	Finland+MIU-U+SIMA+NIQ<ental<Absolut
Finlandimiuusimasarnikkali	Finland+MIU-U+SIMA=TAR+NIQ<flertal<min<Absolut+LI
Finlandimiuusinnaavisi	Finland+MIU-U+SINNAA<Interrogativ<I
Finlandimiuussappununa	Finland+MIU-U-SSA<Indikativ<de+UNA
Finlandimiuussavit	Finland+MIU-U-SSA<Interrogativ<du
Finlandimiuusaraluarpungali	Finland+MIU-U+TAR=GALUAR<Indikativ<jeg+LI
Finlandimiuusaraluarluni	Finland+MIU-U+TAR=GALUAR<Ledsagemåde<han_selv
Finlandimiuusaraluarlungaana	Finland+MIU-U+TAR=GALUAR<Ledsagemåde<jeg+UNA
Finlandimiuusarnera	Finland+MIU-U+TAR+NIQ<ental<hans<Absolut
Finlandimiuusarnikka	Finland+MIU-U+TAR+NIQ<flertal<min<Absolut
Finlandimiuusartungali	Finland+MIU-U+TAR<Participium<jeg+LI
Finlandimiuusormiuulernikkali	Finland+MIU-U+TUQ+MIU-U-LIR+NIQ<flertal<min<Absolut+LI
Finlandimut	Finland<Terminalis
Finlandimukalaarpunga	Finland<Terminalis-KAR-LAAR<Indikativ<jeg
Finlandimukalaartoq	Finland<Terminalis-KAR-LAAR<Participium<han
Finlandimukalaartarpit	Finland<Terminalis-KAR-LAAR=TAR<Interrogativ<du
Finlandimukalaartarneq	Finland<Terminalis-KAR-LAAR=TAR+NIQ
Finlandimukalaartartunga	Finland<Terminalis-KAR-LAAR=TAR<Participium<jeg
Finlandimukalertoqanngilaq	Finland<Terminalis-KAR-LIR+TUQ-QAR-NNGIT<Indikativ<han
Finlandimukanngilagut	Finland<Terminalis-KAR-NNGIT<Indikativ<vi
Finlandimukanngilatit	Finland<Terminalis-KAR-NNGIT<Interrogativ<du
Finlandimukanngitsoruna	Finland<Terminalis-KAR-NNGIT+TUQ<ental<Absolut+UNA
Finlandimukassagaluartorli	Finland<Terminalis-KAR-SSA=GALUAR+TUQ+LI
Finlandimukassasut	Finland<Terminalis-KAR-SSA<Participium<de
Finlandimukartoq	Finland<Terminalis-KAR+TUQ
Finlandimulli	Finland<Terminalis+LI
Finlandimullu	Finland<Terminalis+LU
Finlandimununa	Finland<Terminalis+UNA
Gentofte	Gentofte<Absolut
Gentofteli	Gentofte<Absolut+LI
Gentoftelu	Gentofte<Absolut+LU
Gentofteuna	Gentofte<Absolut+UNA
Gentoftemik	Gentofte<Instrumentalis
Gentoftemilli	Gentofte<Instrumentalis+LI
Gentoftemillu	Gentofte<Instrumentalis+LU
Gentofteminguna	Gentofte<Instrumentalis+UNA
Gentoftemi	Gentofte<Lokalis
Gentoftemiikkaluarlutik	Gentofte<Lokalis+IP+GALUAR<Ledsagemåde<de_selv
Gentoftemiikkaluartungaana	Gentofte<Lokalis+IP+GALUAR<Participium<jeg+UNA
Gentoftemiippisi	Gentofte<Lokalis+IP<Interrogativ<I
Gentoftemiilaarluni	Gentofte<Lokalis+IP-LAAR<Ledsagemåde<han_selv
Gentoftemiilaartarnerlu	Gentofte<Lokalis+IP-LAAR=TAR+NIQ+LU
Gentoftemiilaartartut	Gentofte<Lokalis+IP-LAAR=TAR<Participium<de
Gentoftemiillutik	Gentofte<Lokalis+IP<Ledsagemåde<de_selv
Gentoftemiilerpit	Gentofte<Lokalis+IP-LIR<Interrogativ<du
Gentoftemiinngilasi	Gentofte<Lokalis+IP-NNGIT<Interrogativ<I
Gentoftemiissimaneq	Gentofte<Lokalis+IP+SIMA+NIQ
Gentoftemiissagaluarneruna	Gentofte<Lokalis+IP-SSA=GALUAR+NIQ+UNA
Gentoftemiissagaluartut	Gentofte<Lokalis+IP-SSA=GALUAR<Participium<de
Gentoftemiissalluni	Gentofte<Lokalis+IP-SSA<Ledsagemåde<han_selv
Gentoftemiittoq	Gentofte<Lokalis+IP+TUQ
Gentoftemili	Gentofte<Lokalis+LI
Gentoftemilu	Gentofte<Lokalis+LU
Gentoftemiu	Gentofte+MIU<ental<Absolut
Gentoftemiuli	Gentofte+MIU<ental<Absolut+LI
Gentoftemiutut	Gentofte+MIU<ental<Aequalis
Gentoftemiumi	Gentofte+MIU<ental<Lokalis
Gentoftemiumiuna	Gentofte+MIU<ental<Lokalis+UNA
Gentoftemiuga	Gentofte+MIU<ental<min<Absolut
Gentoftemiugali	Gentofte+MIU<ental<min<Absolut+LI
Gentoftemiugalu	Gentofte+MIU<ental<min<Absolut+LU
Gentoftemiuili	Gentofte+MIU<flertal<hans<Absolut+LI
Gentoftemiuilu	Gentofte+MIU<flertal<hans<Absolut+LU
Gentoftemiunik	Gentofte+MIU<flertal<Instrumentalis
Gentoftemiuniilaartoq	Gentofte+MIU<flertal<Lokalis+IP-LAAR<Participium<han
Gentoftemiukka	Gentofte+MIU<flertal<min<Absolut
Gentoftemiulerisimasarnikkali	Gentofte+MIU-LIRI+SIMA=TAR+NIQ<flertal<min<Absolut+LI
Gentoftemiulerissagaluarpoq	Gentofte+MIU-LIRI-SSA=GALUAR<Indikativ<han
Gentoftemiulerisormioqartoq	Gentofte+MIU-LIRI+TUQ+MIU-QAR<Participium<han
Gentoftemiulerisoqalerpunga	Gentofte+MIU-LIRI+TUQ-QAR-LIR<Indikativ<jeg
Gentoftemiunngorpullu	Gentofte+MIU-NNGUR<Indikativ<de+LU
Gentoftemiunngulaartarlutinguna	Gentofte+MIU-NNGUR-LAAR=TAR<Ledsagemåde<de_selv+UNA
Gentoftemiunngorniarluni	Gentofte+MIU-NNGUR+NIAR<Ledsagemåde<han_selv
Gentoftemiunngorsimasungaana	Gentofte+MIU-NNGUR+SIMA<Participium<jeg+UNA
Gentoftemiunngussalluni	Gentofte+MIU-NNGUR-SSA<Ledsagemåde<han_selv
Gentoftemiunngussallunilu	Gentofte+MIU-NNGUR-SSA<Ledsagemåde<han_selv+LU
Gentoftemut	Gentofte<Terminalis
Gentoftemukalaarlutik	Gentofte<Terminalis-KAR-LAAR<Ledsagemåde<de_selv
Gentoftemukarnianngilarli	Gentofte<Terminalis-KAR+NIAR=NNGIT<Indikativ<han+LI
Gentoftemukanngillalli	Gentofte<Terminalis-KAR-NNGIT<Indikativ<de+LI
Gentoftemukanngilangali	Gentofte<Terminalis-KAR-NNGIT<Indikativ<jeg+LI
Gentoftemukannginnerlu	Gentofte<Terminalis-KAR-NNGIT+NIQ<ental<Absolut+LU
Gentoftemukanngitsut	Gentofte<Terminalis-KAR-NNGIT<Participium<de
Gentoftemukartorlu	Gentofte<Terminalis-KAR<Participium<han+LU
Gentoftemukassagaluarnerli	Gentofte<Terminalis-KAR-SSA=GALUAR+NIQ+LI
Gentoftemukassagaluartulli	Gentofte<Terminalis-KAR-SSA=GALUAR<Participium<de+LI
Gentoftemukassagaluartoq	Gentofte<Terminalis-KAR-SSA=GALUAR<Participium<han
Gentoftemukassaanga	Gentofte<Terminalis-KAR-SSA<Indikativ<jeg
Gentoftemukassavit	Gentofte<Terminalis-KAR-SSA<Interrogativ<du
Gentoftemukassallunili	Gentofte<Terminalis-KAR-SSA<Ledsagemåde<han_selv+LI
Gentoftemukassallunilu	Gentofte<Terminalis-KAR-SSA<Ledsagemåde<han_selv+LU
Gentoftemukassasoq	Gentofte<Terminalis-KAR-SSA<Participium<han
Gentoftemukassasunga	Gentofte<Terminalis-KAR-SSA<Participium<jeg
Gentoftemulli	Gentofte<Terminalis+LI
Gentoftemullu	Gentofte<Terminalis+LU
Gentoftemununa	Gentofte<Terminalis+UNA
ilaa	ilaa<Partikel
ilaa	ila<ental<hans<Absolut
ilakka	ila<flertal<min<Absolut
ilaannaqalaarpisi	ila-INNAQ-QAR-LAAR<Interrogativ<I
ilallit	ila-LIK<flertal<Relativ
ilamiunngortartulerilaartarput	ila+MIU-NNGUR+TAR+TUQ-LIRI-LAAR=TAR<Indikativ<de
ilamiuuniarluni	ila+MIU-U+NIAR<Ledsagemåde<han_selv
ilannguamilli	ila-NNGUAQ<ental<Instrumentalis+LI
ilannguamukarsimanerli	ila-NNGUAQ<ental<Terminalis-KAR+SIMA+NIQ+LI
ilannguusunga	ila-NNGUAQ-U<Participium<jeg
ilanngorniarnanga	ila-NNGUR+NIAR=NNGIT<Ledsagemåde<jeg
ilanngorsimanernulli	ila-NNGUR+SIMA+NIQ<flertal<Terminalis+LI
ilarpassuarnut	ila+PASSUAQ<flertal<Terminalis
ilaqalertorli	ila-QAR-LIR<Participium<han+LI
ilaqannginneriuna	ila-QAR-NNGIT+NIQ<flertal<hans<Absolut+UNA
ilaqutariivili	ilaqutariit<flertal<hans<Absolut+LI
ilaqutariinnik	ilaqutariit<flertal<Instrumentalis
ilaqutariinnullu	ilaqutariit<flertal<Terminalis+LU
ilaqutariimmiunik	ilaqutariit+MIU<flertal<Instrumentalis
ilaqutariinngornerit	ilaqutariit-NNGUR+NIQ<flertal<Absolut
ilaasaraluarnikka	ila-U+TAR=GALUAR+NIQ<flertal<min<Absolut
ilinniarporli	ilinniar<Indikativ<han+LI
ilinniarpunga	ilinniar<Indikativ<jeg
ilinnialaartarluni	ilinniar-LAAR=TAR<Ledsagemåde<han_selv
ilinnialaartarnikka	ilinniar-LAAR=TAR+NIQ<flertal<min<Absolut
ilinnialaartarnikkaana	ilinniar-LAAR=TAR+NIQ<flertal<min<Absolut+UNA
ilinnialernerni	ilinniar-LIR+NIQ<flertal<Lokalis
ilinniarnertuuinnanngussagaluarnikka	ilinniarnertooq-INNAQ-NNGUR-SSA=GALUAR+NIQ<flertal<min<Absolut
ilinniarneri	ilinniar+NIQ<flertal<hans<Absolut
ilinniarnerillu	ilinniar+NIQ<flertal<Relativ+LU
ilinnianngillalli	ilinniar-NNGIT<Indikativ<de+LI
ilinniarnangaana	ilinniar-NNGIT<Ledsagemåde<jeg+UNA
ilinniarsimasarnikka	ilinniar+SIMA=TAR+NIQ<flertal<min<Absolut
ilinniarsimasartoq	ilinniar+SIMA=TAR<Participium<han
ilinniarsinnaasoruna	ilinniar+SINNAA<Participium<han+UNA
ilinniassagaluartorli	ilinniar-SSA=GALUAR+TUQ<ental<Absolut+LI
ilinniassagaluartullilli	ilinniar-SSA=GALUAR+TUQ-LIK<flertal<Absolut+LI
ilinniartaraluartunga	ilinniar+TAR=GALUAR<Participium<jeg
ilinniartarnikka	ilinniar+TAR+NIQ<flertal<min<Absolut
Ilisimatusarfik	Ilisimatusarfik<ental<Absolut
Ilisimatusarfilli	Ilisimatusarfik<ental<Absolut+LI
Ilisimatusarfillu	Ilisimatusarfik<ental<Absolut+LU
Ilisimatusarfinguna	Ilisimatusarfik<ental<Absolut+UNA
Ilisimatusarfimmukassavit	Ilisimatusarfik<ental<Terminalis-KAR-SSA<Interrogativ<du
Ilisimatusarfinnili	Ilisimatusarfik<flertal<Lokalis+LI
Ilisimatusarfigigaluarpaajuna	Ilisimatusarfik+GӘ+GALUAR<Indikativ<HanHam+UNA
Ilisimatusarfigitigit	Ilisimatusarfik+GӘ<Imperativ<ViDem
Ilisimatusarfigilerlugilli	Ilisimatusarfik+GӘ-LIR<Ledsagemåde<dem+LI
Ilisimatusarfigissagaluarpiuk	Ilisimatusarfik+GӘ-SSA=GALUAR<Interrogativ<DuHam
Ilisimatusarfigissagaluarlugilli	Ilisimatusarfik+GӘ-SSA=GALUAR<Ledsagemåde<dem+LI
Ilisimatusarfigissallugu	Ilisimatusarfik+GӘ-SSA<Ledsagemåde<ham
Ilisimatusarfilerigaluarpungalu	Ilisimatusarfik-LIRI+GALUAR<Indikativ<jeg+LU
Ilisimatusarfimmiuulerpungali	Ilisimatusarfik+MIU-U-LIR<Indikativ<jeg+LI
Ilisimatusarfinngua	Ilisimatusarfik-NNGUAQ<ental<hans<Absolut
Ilisimatusarfinnguiuna	Ilisimatusarfik-NNGUAQ<flertal<hans<Absolut+UNA
Ilisimatusarfippassuarnilli	Ilisimatusarfik+PASSUAQ<flertal<Instrumentalis+LI
Ilisimatusarfippassuakkali	Ilisimatusarfik+PASSUAQ<flertal<min<Absolut+LI
Ilisimatusarfeqalaarneq	Ilisimatusarfik-QAR-LAAR+NIQ<ental<Absolut
Ilisimatusarfeqalaarnerli	Ilisimatusarfik-QAR-LAAR+NIQ<ental<Absolut+LI
Ilisimatusarfeqalaartarnerli	Ilisimatusarfik-QAR-LAAR=TAR+NIQ<ental<Absolut+LI
Ilisimatusarfeqalaartartorlu	Ilisimatusarfik-QAR-LAAR=TAR<Participium<han+LU
Ilisimatusarfeqalaartartoq	Ilisimatusarfik-QAR-LAAR=TAR+TUQ<ental<Absolut
Ilisimatusarfeqalerpoq	Ilisimatusarfik-QAR-LIR<Indikativ<han
Ilisimatusarfeqalerneq	Ilisimatusarfik-QAR-LIR+NIQ<ental<Absolut
Ilisimatusarfeqalertoq	Ilisimatusarfik-QAR-LIR<Participium<han
Ilisimatusarfeqalertorlu	Ilisimatusarfik-QAR-LIR<Participium<han+LU
Ilisimatusarfeqalertoq	Ilisimatusarfik-QAR-LIR+TUQ<ental<Absolut
Ilisimatusarfeqalertoruna	Ilisimatusarfik-QAR-LIR+TUQ<ental<Absolut+UNA
Ilisimatusarfeqanngilaq	Ilisimatusarfik-QAR-NNGIT<Indikativ<han
Ilisimatusarfeqannginneq	Ilisimatusarfik-QAR-NNGIT+NIQ<ental<Absolut
Ilisimatusarfeqannginneralli	Ilisimatusarfik-QAR-NNGIT+NIQ<ental<deres+LI
Ilisimatusarfeqanngitsoq	Ilisimatusarfik-QAR-NNGIT<Participium<han
Ilisimatusarfeqarsinnaavorlu	Ilisimatusarfik-QAR+SINNAA<Indikativ<han+LU
Ilisimatusarfeqassagaluarneq	Ilisimatusarfik-QAR-SSA=GALUAR+NIQ<ental<Absolut
Ilisimatusarfeqassagaluartoq	Ilisimatusarfik-QAR-SSA=GALUAR<Participium<han
Ilisimatusarfeqassaaruna	Ilisimatusarfik-QAR-SSA<Indikativ<han+UNA
Illoqqortoormiununa	Illoqqortoormiut<Absolut+UNA
Illoqqortoormiunilli	Illoqqortoormiut<Instrumentalis+LI
Illoqqortoormiunillu	Illoqqortoormiut<Instrumentalis+LU
Illoqqortoormiuninguna	Illoqqortoormiut<Instrumentalis+UNA
Illoqqortoormiuni	Illoqqortoormiut<Lokalis
Illoqqortoormiuniilaartartungalu	Illoqqortoormiut<Lokalis+IP-LAAR=TAR<Participium<jeg+LU
Illoqqortoormiormiumik	Illoqqortoormiut+MIU<ental<Instrumentalis
Illoqqortoormiormiumiikkaluarlunili	Illoqqortoormiut+MIU<ental<Lokalis+IP+GALUAR<Ledsagemåde<han_selv+LI
Illoqqortoormiormiumili	Illoqqortoormiut+MIU<ental<Lokalis+LI
Illoqqortoormiormiuniilaartoq	Illoqqortoormiut+MIU<flertal<Lokalis+IP-LAAR<Participium<han
Illoqqortoormiormiulerigaluarpugullu	Illoqqortoormiut+MIU-LIRI+GALUAR<Indikativ<vi+LU
Illoqqortoormiormiulerillungalu	Illoqqortoormiut+MIU-LIRI<Ledsagemåde<jeg+LU
Illoqqortoormiormiuleriniarnani	Illoqqortoormiut+MIU-LIRI+NIAR=NNGIT<Ledsagemåde<han_selv
Illoqqortoormiormiunngunngitsununa	Illoqqortoormiut+MIU-NNGUR-NNGIT<Participium<de+UNA
Illoqqortoormiormioqartoq	Illoqqortoormiut+MIU-QAR<Participium<han
Illoqqortoormiormioqartoq	Illoqqortoormiut+MIU-QAR+TUQ<ental<Absolut
Illoqqortoormiormiuujartorpit	Illoqqortoormiut+MIU-U+GIARTUR<Interrogativ<du
Illoqqortoormiormiuuisi	Illoqqortoormiut+MIU-U<Interrogativ<I
Illoqqortoormiormiuulerpoq	Illoqqortoormiut+MIU-U-LIR<Indikativ<han
Illoqqortoormiormiuuniannginneranuna	Illoqqortoormiut+MIU-U+NIAR=NNGIT+NIQ<ental<deres+UNA
Illoqqortoormiormiuusimasarpunga	Illoqqortoormiut+MIU-U+SIMA=TAR<Indikativ<jeg
Illoqqortoormiunukalaartarnerlu	Illoqqortoormiut<Terminalis-KAR-LAAR=TAR+NIQ+LU
Illoqqortoormiunukanngitsunga	Illoqqortoormiut<Terminalis-KAR-NNGIT<Participium<jeg
Illoqqortoormiunukassagaluartoq	Illoqqortoormiut<Terminalis-KAR-SSA=GALUAR+TUQ
Illoqqortoormiunulli	Illoqqortoormiut<Terminalis+LI
Illoqqortoormiunununa	Illoqqortoormiut<Terminalis+UNA
illukkaana	illu<flertal<min<Absolut+UNA
illuinnartullu	illu-INNAQ<ental<Aequalis+LU
illulerisuulertulillu	illu-LIRI+TUQ-U-LIR+TUQ-LIK<ental<Absolut+LU
illumioqartoq	illu+MIU-QAR+TUQ<ental<Absolut
illunnguilu	illu-NNGUAQ<flertal<hans<Absolut+LU
illunngussagaluarpoq	illu-NNGUR-SSA=GALUAR<Indikativ<han
illorpassuakka	illu+PASSUAQ<flertal<min<Absolut
illoqanngitsullit	illu-QAR-NNGIT+TUQ-LIK<flertal<Absolut
illoqartunga	illu-QAR<Participium<jeg
illoqassagaluarpunga	illu-QAR-SSA=GALUAR<Indikativ<jeg
illoqassagaluartullu	illu-QAR-SSA=GALUAR<Participium<de+LU
illuulluni	illu-U<Ledsagemåde<han_selv
Ilulissat	Ilulissat<Absolut
Ilulissallu	Ilulissat<Absolut+LU
Ilulissanuna	Ilulissat<Absolut+UNA
Ilulissanik	Ilulissat<Instrumentalis
Ilulissanilli	Ilulissat<Instrumentalis+LI
Ilulissani	Ilulissat<Lokalis
Ilulissaniissimallunga	Ilulissat<Lokalis+IP+SIMA<Ledsagemåde<jeg
Iluliarmiunik	Ilulissat+MIU<flertal<Instrumentalis
Iluliarmiunngulaartunga	Ilulissat+MIU-NNGUR-LAAR<Participium<jeg
Iluliarmiunngulertoqalaarpugullu	Ilulissat+MIU-NNGUR-LIR+TUQ-QAR-LAAR<Indikativ<vi+LU
Iluliarmiunngortunga	Ilulissat+MIU-NNGUR<Participium<jeg
Iluliarmioqarneq	Ilulissat+MIU-QAR+NIQ<ental<Absolut
Iluliarmioqarnerlu	Ilulissat+MIU-QAR+NIQ<ental<Absolut+LU
Iluliarmioqartoq	Ilulissat+MIU-QAR<Participium<han
Iluliarmioqartoq	Ilulissat+MIU-QAR+TUQ<ental<Absolut
Iluliarmiuulaarpunga	Ilulissat+MIU-U-LAAR<Indikativ<jeg
Iluliarmiuullutinguna	Ilulissat+MIU-U<Ledsagemåde<de_selv+UNA
Iluliarmiuullunga	Ilulissat+MIU-U<Ledsagemåde<jeg
Iluliarmiuulertuinnalerissagaluarnernik	Ilulissat+MIU-U-LIR+TUQ-INNAQ-LIRI-SSA=GALUAR+NIQ<flertal<Instrumentalis
Iluliarmiuunikkali	Ilulissat+MIU-U+NIQ<flertal<min<Absolut+LI
Iluliarmiuunerillu	Ilulissat+MIU-U+NIQ<flertal<Relativ+LU
Iluliarmiuusimasarpit	Ilulissat+MIU-U+SIMA=TAR<Interrogativ<du
Iluliarmiuussagaluartunngulerlunga	Ilulissat+MIU-U-SSA=GALUAR+TUQ-NNGUR-LIR<Ledsagemåde<jeg
Iluliarmiuussaaq	Ilulissat+MIU-U-SSA<Indikativ<han
Iluliarmiuusorli	Ilulissat+MIU-U+TUQ<ental<Absolut+LI
Ilulissanukalerluni	Ilulissat<Terminalis-KAR-LIR<Ledsagemåde<han_selv
Ilulissanukassagaluartoruna	Ilulissat<Terminalis-KAR-SSA=GALUAR+TUQ+UNA
Ilulissanununa	Ilulissat<Terminalis+UNA
imaakkaluartoqarsinnaavit	imaap+GALUAR+TUQ-QAR+SINNAA<Interrogativ<du
imaakkiartortungalu	imaap+GIARTUR<Participium<jeg+LU
imaappit	imaap<Interrogativ<du
imaalaarpoq	imaap-LAAR<Indikativ<han
imaalaartarpit	imaap-LAAR=TAR<Interrogativ<du
imaalaartarnerilli	imaap-LAAR=TAR+NIQ<flertal<Absolut+LI
imaalaartarnerinuna	imaap-LAAR=TAR+NIQ<flertal<Relativ+UNA
imaalluni	imaap<Ledsagemåde<han_selv
imaallunili	imaap<Ledsagemåde<han_selv+LI
imaallunga	imaap<Ledsagemåde<jeg
imaanniarpit	imaap+NIAR<Interrogativ<du
imaanniarneq	imaap+NIAR+NIQ<ental<Absolut
imaanniarnangali	imaap+NIAR=NNGIT<Ledsagemåde<jeg+LI
imaannikka	imaap+NIQ<flertal<min<Absolut
imaannani	imaap-NNGIT<Ledsagemåde<han_selv
imaannangalu	imaap-NNGIT<Ledsagemåde<jeg+LU
imaannginneq	imaap-NNGIT+NIQ<ental<Absolut
imaannginnikka	imaap-NNGIT+NIQ<flertal<min<Absolut
imaanngitsukka	imaap-NNGIT+TUQ<flertal<min<Absolut
imaattullu	imaap<Participium<de+LU
imaattunga	imaap<Participium<jeg
imaassinnaalluni	imaap+SINNAA<Ledsagemåde<han_selv
imaassavit	imaap-SSA<Interrogativ<du
imaattaraluarpoq	imaap+TAR=GALUAR<Indikativ<han
imaattaraluarpisi	imaap+TAR=GALUAR<Interrogativ<I
imaattartoqalaartunga	imaap+TAR+TUQ-QAR-LAAR<Participium<jeg
imaattunngui	imaap+TUQ-NNGUAQ<flertal<hans<Absolut
immikkoortoq	immikkoortoq<ental<Absolut
immikkoortuinnalerisimasorlu	immikkoortoq-INNAQ-LIRI+SIMA<Participium<han+LU
immikkoortuinnaqalerpugununa	immikkoortoq-INNAQ-QAR-LIR<Indikativ<vi+UNA
immikkoortulimmullu	immikkoortoq-LIK<ental<Terminalis+LU
immikkoortullit	immikkoortoq-LIK<flertal<Absolut
immikkoortulikka	immikkoortoq-LIK<flertal<min<Absolut
immikkoortunngussagaluarlutik	immikkoortoq-NNGUR-SSA=GALUAR<Ledsagemåde<de_selv
immikkoortoqalaartartoqarpunga	immikkoortoq-QAR-LAAR=TAR+TUQ-QAR<Indikativ<jeg
immikkoortoqanngilarlu	immikkoortoq-QAR-NNGIT<Indikativ<han+LU
immikkoortuuvugununa	immikkoortoq-U<Indikativ<vi+UNA
immikkulli	immikkut<Partikel+LI
immikkununa	immikkut<Partikel+UNA
immiussigaluarpunga	immiussi+GALUAR<Indikativ<jeg
immiussivoruna	immiussi<Indikativ<han+UNA
immiussivugulli	immiussi<Indikativ<vi+LI
immiussivugununa	immiussi<Indikativ<vi+UNA
immiussivit	immiussi<Interrogativ<du
immiussivisi	immiussi<Interrogativ<I
immiussiniarnani	immiussi+NIAR=NNGIT<Ledsagemåde<han_selv
immiussinaniuna	immiussi-NNGIT<Ledsagemåde<han_selv+UNA
immiussisimasarpit	immiussi+SIMA=TAR<Interrogativ<du
immiussisimasartut	immiussi+SIMA=TAR<Participium<de
immiussissagaluarnikkali	immiussi-SSA=GALUAR+NIQ<flertal<min<Absolut+LI
inulli	inuk<ental<Absolut+LI
inullu	inuk<ental<Absolut+LU
inunguna	inuk<ental<Absolut+UNA
inummiissinnaasununa	inuk<ental<Lokalis+IP+SINNAA<Participium<de+UNA
inunnillu	inuk<flertal<Instrumentalis+LU
inunnilu	inuk<flertal<Lokalis+LU
inugivarsi	inuk+GӘ<Indikativ<I_Ham
inuginianngilaannga	inuk+GӘ+NIAR=NNGIT<Indikativ<DeMig
inugisinnaatigilli	inuk+GӘ+SINNAA<Imperativ<ViDem+LI
inuinnaalli	inuk-INNAQ<flertal<Relativ+LI
inuinnanngulertungalu	inuk-INNAQ-NNGUR-LIR<Participium<jeg+LU
inullillu	inuk-LIK<flertal<Absolut+LU
inummiumi	inuk+MIU<ental<Lokalis
inuppassuillu	inuk+PASSUAQ<flertal<Absolut+LU
inuppassui	inuk+PASSUAQ<flertal<hans<Absolut
inuppassuarnillu	inuk+PASSUAQ<flertal<Instrumentalis+LU
inoqaraluartoruna	inuk-QAR+GALUAR<Participium<han+UNA
inoqalaarpoq	inuk-QAR-LAAR<Indikativ<han
inoqalaarneq	inuk-QAR-LAAR+NIQ<ental<Absolut
inoqalaartartoq	inuk-QAR-LAAR=TAR<Participium<han
inoqalaartartorlu	inuk-QAR-LAAR=TAR<Participium<han+LU
inoqalaartartorlu	inuk-QAR-LAAR=TAR+TUQ<ental<Absolut+LU
inoqalaartoq	inuk-QAR-LAAR+TUQ<ental<Absolut
inoqalerneq	inuk-QAR-LIR+NIQ<ental<Absolut
inoqalernerli	inuk-QAR-LIR+NIQ<ental<Absolut+LI
inoqalertorli	inuk-QAR-LIR<Participium<han+LI
inoqalertoq	inuk-QAR-LIR+TUQ<ental<Absolut
inoqalertoruna	inuk-QAR-LIR+TUQ<ental<Absolut+UNA
inoqannginneriuna	inuk-QAR-NNGIT+NIQ<flertal<hans<Absolut+UNA
inoqannginnernukassagaluarpugut	inuk-QAR-NNGIT+NIQ<flertal<Terminalis-KAR-SSA=GALUAR<Indikativ<vi
inoqanngitsoq	inuk-QAR-NNGIT+TUQ<ental<Absolut
inoqanngitsorli	inuk-QAR-NNGIT+TUQ<ental<Absolut+LI
inoqarsimaneq	inuk-QAR+SIMA+NIQ<ental<Absolut
inoqarsimasarneq	inuk-QAR+SIMA=TAR+NIQ<ental<Absolut
inoqarsimasartoq	inuk-QAR+SIMA=TAR<Participium<han
inoqarsinnaasunga	inuk-QAR+SINNAA<Participium<jeg
inoqassagaluarnerli	inuk-QAR-SSA=GALUAR+NIQ<ental<Absolut+LI
inoqassaaq	inuk-QAR-SSA<Indikativ<han
inoqassasorli	inuk-QAR-SSA<Participium<han+LI
inoqartarneq	inuk-QAR+TAR+NIQ<ental<Absolut
inoqartoq	inuk-QAR+TUQ<ental<Absolut
inunngussagaluarnertullu	inunngor-SSA=GALUAR+NIQ<ental<Aequalis+LU
inunngussavisi	inunngor-SSA<Interrogativ<I
inunngortartut	inunngor+TAR<Participium<de
isuma	isuma<ental<Absolut
isumamilu	isuma<ental<Lokalis+LU
isumamullu	isuma<ental<Terminalis+LU
isumaali	isuma<flertal<hans<Absolut+LI
isumani	isuma<flertal<Lokalis
isumaniittorli	isuma<flertal<Lokalis+IP+TUQ+LI
isumagiartortigit	isuma+GӘ+GIARTUR<Imperativ<ViDem
isumagivassi	isuma+GӘ<Indikativ<JegJer
isumagilaartiginuna	isuma+GӘ-LAAR<Imperativ<ViDem+UNA
isumagilaarparsili	isuma+GӘ-LAAR<Indikativ<I_Ham+LI
isumagisartigilli	isuma+GӘ+TAR<Imperativ<ViDem+LI
isumaannaat	isuma-INNAQ<ental<deres<Absolut
isumaannaa	isuma-INNAQ<flertal<hans<Absolut
isumaannarninguna	isuma-INNAQ<flertal<Instrumentalis+UNA
isumaannakkali	isuma-INNAQ<flertal<min<Absolut+LI
isumaannaanuna	isuma-INNAQ<flertal<Relativ+UNA
isumaliaana	isuma-LIK<ental<hans<Absolut+UNA
isumallilli	isuma-LIK<flertal<Absolut+LI
isumalerippulli	isuma-LIRI<Indikativ<de+LI
isumalerippununa	isuma-LIRI<Indikativ<de+UNA
isumalerivunga	isuma-LIRI<Indikativ<jeg
isumalerivisi	isuma-LIRI<Interrogativ<I
isumalerilaarneq	isuma-LIRI-LAAR+NIQ<ental<Absolut
isumalerillunga	isuma-LIRI<Ledsagemåde<jeg
isumaleriniarnangalu	isuma-LIRI+NIAR=NNGIT<Ledsagemåde<jeg+LU
isumalerisimasoq	isuma-LIRI+SIMA<Participium<han
isumalerisinnaasuinnaanuna	isuma-LIRI+SINNAA+TUQ-INNAQ<flertal<Relativ+UNA
isumalerissalluni	isuma-LIRI-SSA<Ledsagemåde<han_selv
isumamiumiikkiartornerli	isuma+MIU<ental<Lokalis+IP+GIARTUR+NIQ+LI
isumamiuninguna	isuma+MIU<flertal<Instrumentalis+UNA
isumamiunngunngilatit	isuma+MIU-NNGUR-NNGIT<Interrogativ<du
isumamiunngunnginneq	isuma+MIU-NNGUR-NNGIT+NIQ<ental<Absolut
isumamioqarnerli	isuma+MIU-QAR+NIQ<ental<Absolut+LI
isumamioqartorlu	isuma+MIU-QAR<Participium<han+LU
isumamiuugaluartorlu	isuma+MIU-U+GALUAR<Participium<han+LU
isumamiuusununa	isuma+MIU-U<Participium<de+UNA
isumamiuusinnaasoqalerlunilu	isuma+MIU-U+SINNAA+TUQ-QAR-LIR<Ledsagemåde<han_selv+LU
isumanngui	isuma-NNGUAQ<flertal<hans<Absolut
isumanngualerinikka	isuma-NNGUAQ-LIRI+NIQ<flertal<min<Absolut
isumannguusaraluarluni	isuma-NNGUAQ-U+TAR=GALUAR<Ledsagemåde<han_selv
isumannguusartoq	isuma-NNGUAQ-U+TAR<Participium<han
isumanngornani	isuma-NNGUR-NNGIT<Ledsagemåde<han_selv
isumarpassuartut	isuma+PASSUAQ<flertal<Aequalis
isumarpassuili	isuma+PASSUAQ<flertal<hans<Absolut+LI
isumarpassuarni	isuma+PASSUAQ<flertal<Lokalis
isumarpassuakka	isuma+PASSUAQ<flertal<min<Absolut
isumarpassuarnut	isuma+PASSUAQ<flertal<Terminalis
isumarpassuarnununa	isuma+PASSUAQ<flertal<Terminalis+UNA
isumaqalaartarpulli	isuma-QAR-LAAR=TAR<Indikativ<de+LI
isumaqarneq	isumaqar+NIQ<ental<Absolut
isumaqannginnikka	isumaqar-NNGIT+NIQ<flertal<min<Absolut
isumaqanngitsuinnalerivit	isuma-QAR-NNGIT+TUQ-INNAQ-LIRI<Interrogativ<du
isumaqarsinnaasuniuna	isuma-QAR+SINNAA+TUQ<flertal<Lokalis+UNA
isumaqassagaluarpullu	isuma-QAR-SSA=GALUAR<Indikativ<de+LU
isumaqassaagut	isumaqar-SSA<Indikativ<vi
isumaqassasoq	isumaqar-SSA<Participium<han
isumaqartaraluarneq	isuma-QAR+TAR=GALUAR+NIQ<ental<Absolut
isumaallutinguna	isuma-U<Ledsagemåde<de_selv+UNA
isumaassappulli	isuma-U-SSA<Indikativ<de+LI
isumaasartunga	isuma-U+TAR<Participium<jeg
Ivittuut	Ivittuut<Absolut
Ivittuulli	Ivittuut<Absolut+LI
Ivittuullu	Ivittuut<Absolut+LU
Ivittuununa	Ivittuut<Absolut+UNA
Ivittuunik	Ivittuut<Instrumentalis
Ivittuunilli	Ivittuut<Instrumentalis+LI
Ivittuunillu	Ivittuut<Instrumentalis+LU
Ivittuuninguna	Ivittuut<Instrumentalis+UNA
Ivittuuni	Ivittuut<Lokalis
Ivittuuniittungalu	Ivittuut<Lokalis+IP<Participium<jeg+LU
Ivittuunili	Ivittuut<Lokalis+LI
Ivittuuniuna	Ivittuut<Lokalis+UNA
Ivittoormiu	Ivittuut+MIU<ental<Absolut
Ivittoormiuuna	Ivittuut+MIU<ental<Absolut+UNA
Ivittoormiumilli	Ivittuut+MIU<ental<Instrumentalis+LI
Ivittoormiumillu	Ivittuut+MIU<ental<Instrumentalis+LU
Ivittoormiumi	Ivittuut+MIU<ental<Lokalis
Ivittoormiumilu	Ivittuut+MIU<ental<Lokalis+LU
Ivittoormiumulli	Ivittuut+MIU<ental<Terminalis+LI
Ivittoormiunilli	Ivittuut+MIU<flertal<Instrumentalis+LI
Ivittoormiuni	Ivittuut+MIU<flertal<Lokalis
Ivittoormiuniuna	Ivittuut+MIU<flertal<Lokalis+UNA
Ivittoormiulerilaartarpoq	Ivittuut+MIU-LIRI-LAAR=TAR<Indikativ<han
Ivittoormiuleriniarnikka	Ivittuut+MIU-LIRI+NIAR+NIQ<flertal<min<Absolut
Ivittoormiulerisunga	Ivittuut+MIU-LIRI<Participium<jeg
Ivittoormiulerisarlunili	Ivittuut+MIU-LIRI+TAR<Ledsagemåde<han_selv+LI
Ivittoormiunngortorissagaluarlugillu	Ivittuut+MIU-NNGUR+TUQ+GӘ-SSA=GALUAR<Ledsagemåde<dem+LU
Ivittoormioqarpoq	Ivittuut+MIU-QAR<Indikativ<han
Ivittoormioqarporli	Ivittuut+MIU-QAR<Indikativ<han+LI
Ivittoormioqarporlu	Ivittuut+MIU-QAR<Indikativ<han+LU
Ivittoormioqarporuna	Ivittuut+MIU-QAR<Indikativ<han+UNA
Ivittoormioqarneq	Ivittuut+MIU-QAR+NIQ<ental<Absolut
Ivittoormioqarnerli	Ivittuut+MIU-QAR+NIQ<ental<Absolut+LI
Ivittoormioqarneruna	Ivittuut+MIU-QAR+NIQ<ental<Absolut+UNA
Ivittoormioqartoq	Ivittuut+MIU-QAR<Participium<han
Ivittoormioqartorli	Ivittuut+MIU-QAR<Participium<han+LI
Ivittoormioqartoq	Ivittuut+MIU-QAR+TUQ<ental<Absolut
Ivittoormioqartorlu	Ivittuut+MIU-QAR+TUQ<ental<Absolut+LU
Ivittoormiuugaluarpit	Ivittuut+MIU-U+GALUAR<Interrogativ<du
Ivittoormiuugaluarnikka	Ivittuut+MIU-U+GALUAR+NIQ<flertal<min<Absolut
Ivittoormiuugaluartunnguusimasulerisinnaasunga	Ivittuut+MIU-U+GALUAR+TUQ-NNGUAQ-U+SIMA+TUQ-LIRI+SINNAA<Participium<jeg
Ivittoormiuuvoq	Ivittuut+MIU-U<Indikativ<han
Ivittoormiuulaartulli	Ivittuut+MIU-U-LAAR<Participium<de+LI
Ivittoormiuulaartunga	Ivittuut+MIU-U-LAAR<Participium<jeg
Ivittoormiuulluniuna	Ivittuut+MIU-U<Ledsagemåde<han_selv+UNA
Ivittoormiuullungalu	Ivittuut+MIU-U<Ledsagemåde<jeg+LU
Ivittoormiuulerluni	Ivittuut+MIU-U-LIR<Ledsagemåde<han_selv
Ivittoormiuuniarpit	Ivittuut+MIU-U+NIAR<Interrogativ<du
Ivittoormiuuniarnanilu	Ivittuut+MIU-U+NIAR=NNGIT<Ledsagemåde<han_selv+LU
Ivittoormiuunianngitsungali	Ivittuut+MIU-U+NIAR=NNGIT<Participium<jeg+LI
Ivittoormiuuniartungali	Ivittuut+MIU-U+NIAR<Participium<jeg+LI
Ivittoormiuuniartoraana	Ivittuut+MIU-U+NIAR+TUQ<ental<min<Absolut+UNA
Ivittoormiuunngilagununa	Ivittuut+MIU-U-NNGIT<Indikativ<vi+UNA
Ivittoormiuusorlu	Ivittuut+MIU-U<Participium<han+LU
Ivittoormiuusunga	Ivittuut+MIU-U<Participium<jeg
Ivittoormiuusimanerillu	Ivittuut+MIU-U+SIMA+NIQ<flertal<Absolut+LU
Ivittoormiuusarnikkalu	Ivittuut+MIU-U+TAR+NIQ<flertal<min<Absolut+LU
Ivittoormiuusunngorpunga	Ivittuut+MIU-U+TUQ-NNGUR<Indikativ<jeg
Ivittuunut	Ivittuut<Terminalis
Ivittuunukalaartarneq	Ivittuut<Terminalis-KAR-LAAR=TAR+NIQ
Ivittuunukalaartartut	Ivittuut<Terminalis-KAR-LAAR=TAR<Participium<de
Ivittuunukalaartartoq	Ivittuut<Terminalis-KAR-LAAR=TAR+TUQ
Ivittuunukalerpit	Ivittuut<Terminalis-KAR-LIR<Interrogativ<du
Ivittuunukalerlunga	Ivittuut<Terminalis-KAR-LIR<Ledsagemåde<jeg
Ivittuunukarnianngilanga	Ivittuut<Terminalis-KAR+NIAR=NNGIT<Indikativ<jeg
Ivittuunukarsimasartoqanngilaq	Ivittuut<Terminalis-KAR+SIMA=TAR+TUQ-QAR-NNGIT<Indikativ<han
Ivittuunukassagaluarlunilu	Ivittuut<Terminalis-KAR-SSA=GALUAR<Ledsagemåde<han_selv+LU
Ivittuunulli	Ivittuut<Terminalis+LI
Ivittuunununa	Ivittuut<Terminalis+UNA
kalaaleq	kalaaleq<ental<Absolut
kalaalerlu	kalaaleq<ental<Absolut+LU
kalaaleruna	kalaaleq<ental<Absolut+UNA
kalaallimilli	kalaaleq<ental<Instrumentalis+LI
kalaalliminguna	kalaaleq<ental<Instrumentalis+UNA
kalaallimi	kalaaleq<ental<Lokalis
kalaallimiilaarpit	kalaaleq<ental<Lokalis+IP-LAAR<Interrogativ<du
kalaallimiillutinguna	kalaaleq<ental<Lokalis+IP<Ledsagemåde<de_selv+UNA
kalaallimut	kalaaleq<ental<Terminalis
kalaallimukalaarpunga	kalaaleq<ental<Terminalis-KAR-LAAR<Indikativ<jeg
kalaallinik	kalaaleq<flertal<Instrumentalis
kalaallininguna	kalaaleq<flertal<Instrumentalis+UNA
kalaallini	kalaaleq<flertal<Lokalis
kalaalliniilaartungalu	kalaaleq<flertal<Lokalis+IP-LAAR<Participium<jeg+LU
kalaalliniillutillu	kalaaleq<flertal<Lokalis+IP<Ledsagemåde<de_selv+LU
kalaalliniissagaluarpit	kalaaleq<flertal<Lokalis+IP-SSA=GALUAR<Interrogativ<du
kalaallinili	kalaaleq<flertal<Lokalis+LI
kalaallinilu	kalaaleq<flertal<Lokalis+LU
kalaalerigaluarparsi	kalaaleq+GӘ+GALUAR<Indikativ<I_Ham
kalaalerigaluarparsili	kalaaleq+GӘ+GALUAR<Indikativ<I_Ham+LI
kalaalerisarpagullu	kalaaleq+GӘ+TAR<Indikativ<ViDem+LU
kalaaliinnaa	kalaaleq-INNAQ<ental<hans<Absolut
kalaaliinnaat	kalaaleq-INNAQ<flertal<Relativ
kalaaliinnaleriartorpulli	kalaaleq-INNAQ-LIRI+GIARTUR<Indikativ<de+LI
kalaaliinnaalaartarnikka	kalaaleq-INNAQ-U-LAAR=TAR+NIQ<flertal<min<Absolut
kalaaliinnaallunga	kalaaleq-INNAQ-U<Ledsagemåde<jeg
kalaalilik	kalaaleq-LIK<ental<Absolut
kalaalililerilerpungalu	kalaaleq-LIK-LIRI-LIR<Indikativ<jeg+LU
kalaalilinngoraluartormiuusinnaallutilli	kalaaleq-LIK-NNGUR+GALUAR+TUQ+MIU-U+SINNAA<Ledsagemåde<de_selv+LI
kalaalinngua	kalaaleq-NNGUAQ<ental<hans<Absolut
kalaalinngui	kalaaleq-NNGUAQ<flertal<hans<Absolut
kalaalinnguiuna	kalaaleq-NNGUAQ<flertal<hans<Absolut+UNA
kalaalinnguanngulerpulli	kalaaleq-NNGUAQ-NNGUR-LIR<Indikativ<de+LI
kalaalinnguusoqalaarpit	kalaaleq-NNGUAQ-U+TUQ-QAR-LAAR<Interrogativ<du
kalaalinnguusoqassavisi	kalaaleq-NNGUAQ-U+TUQ-QAR-SSA<Interrogativ<I
kalaalinngunngitsunilu	kalaaleq-NNGUR-NNGIT+TUQ<flertal<Lokalis+LU
kalaalinngorsimaneralli	kalaaleq-NNGUR+SIMA+NIQ<ental<deres+LI
kalaalinngorsinnaasulli	kalaaleq-NNGUR+SINNAA<Participium<de+LI
kalaalerpassuit	kalaaleq+PASSUAQ<flertal<Absolut
kalaalerpassuartulli	kalaaleq+PASSUAQ<flertal<Aequalis+LI
kalaalerpassuartullu	kalaaleq+PASSUAQ<flertal<Aequalis+LU
kalaalerpassuiuna	kalaaleq+PASSUAQ<flertal<hans<Absolut+UNA
kalaaleqaraluartoq	kalaaleq-QAR+GALUAR+TUQ<ental<Absolut
kalaaleqariartorneq	kalaaleq-QAR+GIARTUR+NIQ<ental<Absolut
kalaaleqalaartarpoq	kalaaleq-QAR-LAAR=TAR<Indikativ<han
kalaaleqalaartarneq	kalaaleq-QAR-LAAR=TAR+NIQ<ental<Absolut
kalaaleqalerpoq	kalaaleq-QAR-LIR<Indikativ<han
kalaaleqarniarnerli	kalaaleq-QAR+NIAR+NIQ<ental<Absolut+LI
kalaaleqannginnikkalu	kalaaleq-QAR-NNGIT+NIQ<flertal<min<Absolut+LU
kalaaleqassagaluarporlu	kalaaleq-QAR-SSA=GALUAR<Indikativ<han+LU
kalaaleqassaaq	kalaaleq-QAR-SSA<Indikativ<han
kalaaliugaluarpisi	kalaaleq-U+GALUAR<Interrogativ<I
kalaaliulluni	kalaaleq-U<Ledsagemåde<han_selv
kalaaliulernernillu	kalaaleq-U-LIR+NIQ<flertal<Instrumentalis+LU
kalaallisut	kalaallisut<Partikel
kalaallisulli	kalaallisut<Partikel+LI
kalaallisununa	kalaallisut<Partikel+UNA
Kangaatsiaq	Kangaatsiaq<Absolut
Kangaatsiarli	Kangaatsiaq<Absolut+LI
Kangaatsiarlu	Kangaatsiaq<Absolut+LU
Kangaatsiaruna	Kangaatsiaq<Absolut+UNA
Kangaatsiamik	Kangaatsiaq<Instrumentalis
Kangaatsiamilli	Kangaatsiaq<Instrumentalis+LI
Kangaatsiamillu	Kangaatsiaq<Instrumentalis+LU
Kangaatsiaminguna	Kangaatsiaq<Instrumentalis+UNA
Kangaatsiami	Kangaatsiaq<Lokalis
Kangaatsiamiippisi	Kangaatsiaq<Lokalis+IP<Interrogativ<I
Kangaatsiamiissagaluarpugununa	Kangaatsiaq<Lokalis+IP-SSA=GALUAR<Indikativ<vi+UNA
Kangaatsiamili	Kangaatsiaq<Lokalis+LI
Kangaatsiamilu	Kangaatsiaq<Lokalis+LU
Kangaatsiamiuna	Kangaatsiaq<Lokalis+UNA
Kangaatsiarmiumi	Kangaatsiaq+MIU<ental<Lokalis
Kangaatsiarmiunngulaarluni	Kangaatsiaq+MIU-NNGUR-LAAR<Ledsagemåde<han_selv
Kangaatsiarmioqarneq	Kangaatsiaq+MIU-QAR+NIQ<ental<Absolut
Kangaatsiarmioqartorlu	Kangaatsiaq+MIU-QAR+TUQ<ental<Absolut+LU
Kangaatsiarmiuulertulli	Kangaatsiaq+MIU-U-LIR<Participium<de+LI
Kangaatsiarmiuulertuussavisi	Kangaatsiaq+MIU-U-LIR+TUQ-U-SSA<Interrogativ<I
Kangaatsiarmiuusinnaasuinnaqanngilatit	Kangaatsiaq+MIU-U+SINNAA+TUQ-INNAQ-QAR-NNGIT<Interrogativ<du
Kangaatsiarmiuussagaluartoq	Kangaatsiaq+MIU-U-SSA=GALUAR<Participium<han
Kangaatsiamut	Kangaatsiaq<Terminalis
Kangaatsiamukalaarpoq	Kangaatsiaq<Terminalis-KAR-LAAR<Indikativ<han
Kangaatsiamukalaarnerli	Kangaatsiaq<Terminalis-KAR-LAAR+NIQ+LI
Kangaatsiamukalaartarneq	Kangaatsiaq<Terminalis-KAR-LAAR=TAR+NIQ
Kangaatsiamukalaartartoqarpoq	Kangaatsiaq<Terminalis-KAR-LAAR=TAR+TUQ-QAR<Indikativ<han
Kangaatsiamukalerpulli	Kangaatsiaq<Terminalis-KAR-LIR<Indikativ<de+LI
Kangaatsiamukanngilatit	Kangaatsiaq<Terminalis-KAR-NNGIT<Interrogativ<du
Kangaatsiamukassagaluartoqanngilaq	Kangaatsiaq<Terminalis-KAR-SSA=GALUAR+TUQ-QAR-NNGIT<Indikativ<han
Kangaatsiamulli	Kangaatsiaq<Terminalis+LI
Kangaatsiamununa	Kangaatsiaq<Terminalis+UNA
Kangerlussuaq	Kangerlussuaq<Absolut
Kangerlussuarli	Kangerlussuaq<Absolut+LI
Kangerlussuaruna	Kangerlussuaq<Absolut+UNA
Kangerlussuarmik	Kangerlussuaq<Instrumentalis
Kangerlussuarmilli	Kangerlussuaq<Instrumentalis+LI
Kangerlussuarmillu	Kangerlussuaq<Instrumentalis+LU
Kangerlussuarminguna	Kangerlussuaq<Instrumentalis+UNA
Kangerlussuarmi	Kangerlussuaq<Lokalis
Kangerlussuarmili	Kangerlussuaq<Lokalis+LI
Kangerlussuarmiuna	Kangerlussuaq<Lokalis+UNA
Kangerlussuarmiumulli	Kangerlussuaq+MIU<ental<Terminalis+LI
Kangerlussuarmiunik	Kangerlussuaq+MIU<flertal<Instrumentalis
Kangerlussuarmiuni	Kangerlussuaq+MIU<flertal<Lokalis
Kangerlussuarmiunilu	Kangerlussuaq+MIU<flertal<Lokalis+LU
Kangerlussuarmiulerisimallungalu	Kangerlussuaq+MIU-LIRI+SIMA<Ledsagemåde<jeg+LU
Kangerlussuarmiunngorniarnernukalerpit	Kangerlussuaq+MIU-NNGUR+NIAR+NIQ<flertal<Terminalis-KAR-LIR<Interrogativ<du
Kangerlussuarmiunngorsimasartoq	Kangerlussuaq+MIU-NNGUR+SIMA=TAR<Participium<han
Kangerlussuarmiunngussaaq	Kangerlussuaq+MIU-NNGUR-SSA<Indikativ<han
Kangerlussuarmiunngussaangali	Kangerlussuaq+MIU-NNGUR-SSA<Indikativ<jeg+LI
Kangerlussuarmioqarneq	Kangerlussuaq+MIU-QAR+NIQ<ental<Absolut
Kangerlussuarmioqartorli	Kangerlussuaq+MIU-QAR<Participium<han+LI
Kangerlussuarmioqartoruna	Kangerlussuaq+MIU-QAR<Participium<han+UNA
Kangerlussuarmioqartoq	Kangerlussuaq+MIU-QAR+TUQ<ental<Absolut
Kangerlussuarmioqartorli	Kangerlussuaq+MIU-QAR+TUQ<ental<Absolut+LI
Kangerlussuarmiuugaluarpisi	Kangerlussuaq+MIU-U+GALUAR<Interrogativ<I
Kangerlussuarmiuulaarneriuna	Kangerlussuaq+MIU-U-LAAR+NIQ<flertal<hans<Absolut+UNA
Kangerlussuarmiuusinnaalluni	Kangerlussuaq+MIU-U+SINNAA<Ledsagemåde<han_selv
Kangerlussuarmiuusaraluarnerni	Kangerlussuaq+MIU-U+TAR=GALUAR+NIQ<flertal<Lokalis
Kangerlussuarmiuusuinnaassasungali	Kangerlussuaq+MIU-U+TUQ-INNAQ-U-SSA<Participium<jeg+LI
Kangerlussuarmukalaartartunga	Kangerlussuaq<Terminalis-KAR-LAAR=TAR<Participium<jeg
Kangerlussuarmukalerpoq	Kangerlussuaq<Terminalis-KAR-LIR<Indikativ<han
Kangerlussuarmukalerpisi	Kangerlussuaq<Terminalis-KAR-LIR<Interrogativ<I
Kangerlussuarmukartaraluarneq	Kangerlussuaq<Terminalis-KAR+TAR=GALUAR+NIQ
Kangerlussuarmullu	Kangerlussuaq<Terminalis+LU
kiisa	kiisa<Partikel
kiisali	kiisa<Partikel+LI
kiisalu	kiisa<Partikel+LU
kiisaana	kiisa<Partikel+UNA
kingulleq	kingulleq<ental<Absolut
kingullerli	kingulleq<ental<Absolut+LI
kingullernullu	kingulleq<flertal<Terminalis+LU
kingulliinnarmulli	kingulleq-INNAQ<ental<Terminalis+LI
kingulliinnaqanngillalli	kingulleq-INNAQ-QAR-NNGIT<Indikativ<de+LI
kingulliinnaasinnaanerali	kingulleq-INNAQ-U+SINNAA+NIQ<ental<hans<Absolut+LI
kingullilerillutik	kingulleq-LIRI<Ledsagemåde<de_selv
kingullilerisarnikka	kingulleq-LIRI+TAR+NIQ<flertal<min<Absolut
kingullermioqarpoq	kingulleq+MIU-QAR<Indikativ<han
kingullerpassuakka	kingulleq+PASSUAQ<flertal<min<Absolut
kingulleqalaarlunga	kingulleq-QAR-LAAR<Ledsagemåde<jeg
kingulleqalaarnerali	kingulleq-QAR-LAAR+NIQ<ental<min<Absolut+LI
kingulleqalaartartulerisimavunga	kingulleq-QAR-LAAR=TAR+TUQ-LIRI+SIMA<Indikativ<jeg
kingulliusulli	kingulleq-U<Participium<de+LI
kisimi	kisimi<Adjektiv
kisimili	kisimi<Adjektiv+LI
kisimilu	kisimi<Adjektiv+LU
kisimiuna	kisimi<Adjektiv+UNA
kitaali	kitә<ental<hans<Absolut+LI
kitaalu	kitә<ental<hans<Absolut+LU
kitaani	kitә<ental<hans<Lokalis
kitaanili	kitә<ental<hans<Lokalis+LI
kitaanukalaarneq	kitә<ental<hans<Terminalis-KAR-LAAR+NIQ
kitaanullu	kitә<ental<hans<Terminalis+LU
kitiga	kitә<ental<min<Absolut
kitigali	kitә<ental<min<Absolut+LI
kitigaana	kitә<ental<min<Absolut+UNA
kitaa	kitә<flertal<hans<Absolut
kitaalu	kitә<flertal<hans<Absolut+LU
kitinngualu	kitә-NNGUAQ<ental<hans<Absolut+LU
kitinngui	kitә-NNGUAQ<flertal<hans<Absolut
kitinnguanngulaartartoq	kitә-NNGUAQ-NNGUR-LAAR=TAR+TUQ<ental<Absolut
kitinnguugaluarnikka	kitә-NNGUAQ-U+GALUAR+NIQ<flertal<min<Absolut
kitinnguulerpunga	kitә-NNGUAQ-U-LIR<Indikativ<jeg
kitinnguusimavisi	kitә-NNGUAQ-U+SIMA<Interrogativ<I
kunngitut	kunngi<ental<Aequalis
kunngitulli	kunngi<ental<Aequalis+LI
kunngitununa	kunngi<ental<Aequalis+UNA
kunngimik	kunngi<ental<Instrumentalis
kunngimilli	kunngi<ental<Instrumentalis+LI
kunngimi	kunngi<ental<Lokalis
kunngiili	kunngi<flertal<hans<Absolut+LI
kunnginiissasungaana	kunngi<flertal<Lokalis+IP-SSA<Participium<jeg+UNA
kunngikkalu	kunngi<flertal<min<Absolut+LU
kunngigivakka	kunngi+GӘ<Indikativ<JegDem
kunngigivakkaana	kunngi+GӘ<Indikativ<JegDem+UNA
kunngigillugulu	kunngi+GӘ<Ledsagemåde<ham+LU
kunngiginiartigit	kunngi+GӘ+NIAR<Imperativ<ViDem
kunngiginiarpagut	kunngi+GӘ+NIAR<Indikativ<ViDem
kunngiinnaanuna	kunngi-INNAQ<flertal<Relativ+UNA
kunngiinnalerisimasuunangali	kunngi-INNAQ-LIRI+SIMA+TUQ-U-NNGIT<Ledsagemåde<jeg+LI
kunngilik	kunngi-LIK<ental<Absolut
kunngilia	kunngi-LIK<ental<hans<Absolut
kunngilimmut	kunngi-LIK<ental<Terminalis
kunngillinuna	kunngi-LIK<flertal<Absolut+UNA
kunngillillu	kunngi-LIK<flertal<Relativ+LU
kunngilerilerpisi	kunngi-LIRI-LIR<Interrogativ<I
kunngilerisungali	kunngi-LIRI<Participium<jeg+LI
kunngimioqarnerlu	kunngi+MIU-QAR+NIQ<ental<Absolut+LU
kunngimioqarneruna	kunngi+MIU-QAR+NIQ<ental<Absolut+UNA
kunngimiuunatilli	kunngi+MIU-U-NNGIT<Ledsagemåde<de_selv+LI
kunnginnguali	kunngi-NNGUAQ<ental<hans<Absolut+LI
kunnginnguaana	kunngi-NNGUAQ<ental<hans<Absolut+UNA
kunnginnguaqassagaluarlungaana	kunngi-NNGUAQ-QAR-SSA=GALUAR<Ledsagemåde<jeg+UNA
kunnginngussavit	kunngi-NNGUR-SSA<Interrogativ<du
kunnginngortaraluarlungali	kunngi-NNGUR+TAR=GALUAR<Ledsagemåde<jeg+LI
kunngerpassuit	kunngi+PASSUAQ<flertal<Absolut
kunngerpassuilli	kunngi+PASSUAQ<flertal<Absolut+LI
kunngerpassuinuna	kunngi+PASSUAQ<flertal<Absolut+UNA
kunngerpassui	kunngi+PASSUAQ<flertal<hans<Absolut
kunngerpassuili	kunngi+PASSUAQ<flertal<hans<Absolut+LI
kunngerpassuilu	kunngi+PASSUAQ<flertal<hans<Absolut+LU
kunngerpassuiuna	kunngi+PASSUAQ<flertal<hans<Absolut+UNA
kunngerpassuarni	kunngi+PASSUAQ<flertal<Lokalis
kunngerpassuarniuna	kunngi+PASSUAQ<flertal<Lokalis+UNA
kunngerpassuakkali	kunngi+PASSUAQ<flertal<min<Absolut+LI
kunngerpassuarnukalaarpoq	kunngi+PASSUAQ<flertal<Terminalis-KAR-LAAR<Indikativ<han
kunngeqariartorpisi	kunngi-QAR+GIARTUR<Interrogativ<I
kunngeqalaarpit	kunngi-QAR-LAAR<Interrogativ<du
kunngeqalaartarlunga	kunngi-QAR-LAAR=TAR<Ledsagemåde<jeg
kunngeqalerlunga	kunngi-QAR-LIR<Ledsagemåde<jeg
kunngeqalertuniikkaluarlutik	kunngi-QAR-LIR+TUQ<flertal<Lokalis+IP+GALUAR<Ledsagemåde<de_selv
kunngeqanngillalli	kunngi-QAR-NNGIT<Indikativ<de+LI
kunngeqanngilasi	kunngi-QAR-NNGIT<Interrogativ<I
kunngeqanngitsulerinngilatit	kunngi-QAR-NNGIT+TUQ-LIRI-NNGIT<Interrogativ<du
kunngeqassagaluarnerit	kunngi-QAR-SSA=GALUAR+NIQ<flertal<Relativ
kunngeqassagaluartunga	kunngi-QAR-SSA=GALUAR<Participium<jeg
kunngeqassagaluartunngortaraluarnikkali	kunngi-QAR-SSA=GALUAR+TUQ-NNGUR+TAR=GALUAR+NIQ<flertal<min<Absolut+LI
kunngeqassavit	kunngi-QAR-SSA<Interrogativ<du
kunngeqassasunga	kunngi-QAR-SSA<Participium<jeg
kunngeqartartulli	kunngi-QAR+TAR<Participium<de+LI
kunngiusaraluarlutilli	kunngi-U+TAR=GALUAR<Ledsagemåde<de_selv+LI
makku	makku<Pronomen<flertal<Absolut
makkuli	makku<Pronomen<flertal<Absolut+LI
makkunani	makku<Pronomen<flertal<Lokalis
makkunaniilaartarluni	makku<Pronomen<flertal<Lokalis+IP-LAAR=TAR<Ledsagemåde<han_selv
makkunaniillutinguna	makku<Pronomen<flertal<Lokalis+IP<Ledsagemåde<de_selv+UNA
makkunanili	makku<Pronomen<flertal<Lokalis+LI
Maniitsoq	Maniitsoq<Absolut
Maniitsorli	Maniitsoq<Absolut+LI
Maniitsorlu	Maniitsoq<Absolut+LU
Maniitsoruna	Maniitsoq<Absolut+UNA
Maniitsumik	Maniitsoq<Instrumentalis
Maniitsumilli	Maniitsoq<Instrumentalis+LI
Maniitsumillu	Maniitsoq<Instrumentalis+LU
Maniitsuminguna	Maniitsoq<Instrumentalis+UNA
Maniitsumi	Maniitsoq<Lokalis
Maniitsumiikkiartorpulli	Maniitsoq<Lokalis+IP+GIARTUR<Indikativ<de+LI
Maniitsumiilaartarpunga	Maniitsoq<Lokalis+IP-LAAR=TAR<Indikativ<jeg
Maniitsumiillutilli	Maniitsoq<Lokalis+IP<Ledsagemåde<de_selv+LI
Maniitsumiinngilanga	Maniitsoq<Lokalis+IP-NNGIT<Indikativ<jeg
Maniitsumiinnginneq	Maniitsoq<Lokalis+IP-NNGIT+NIQ<ental<Absolut
Maniitsumiinngitsoq	Maniitsoq<Lokalis+IP-NNGIT+TUQ<ental<Absolut
Maniitsumiissinnaavunga	Maniitsoq<Lokalis+IP+SINNAA<Indikativ<jeg
Maniitsumiissapput	Maniitsoq<Lokalis+IP-SSA<Indikativ<de
Maniitsumiittoq	Maniitsoq<Lokalis+IP+TUQ
Maniitsumiittorli	Maniitsoq<Lokalis+IP+TUQ+LI
Maniitsumili	Maniitsoq<Lokalis+LI
Maniitsumilu	Maniitsoq<Lokalis+LU
Maniitsumiuna	Maniitsoq<Lokalis+UNA
Maniitsormiu	Maniitsoq+MIU<ental<Absolut
Maniitsormiumik	Maniitsoq+MIU<ental<Instrumentalis
Maniitsormiumi	Maniitsoq+MIU<ental<Lokalis
Maniitsormiumut	Maniitsoq+MIU<ental<Terminalis
Maniitsormiumukalaartarpungaana	Maniitsoq+MIU<ental<Terminalis-KAR-LAAR=TAR<Indikativ<jeg+UNA
Maniitsormiunik	Maniitsoq+MIU<flertal<Instrumentalis
Maniitsormiunilli	Maniitsoq+MIU<flertal<Instrumentalis+LI
Maniitsormiuni	Maniitsoq+MIU<flertal<Lokalis
Maniitsormiunilu	Maniitsoq+MIU<flertal<Lokalis+LU
Maniitsormiulerivit	Maniitsoq+MIU-LIRI<Interrogativ<du
Maniitsormiulerilaartulli	Maniitsoq+MIU-LIRI-LAAR<Participium<de+LI
Maniitsormiulerinerinuna	Maniitsoq+MIU-LIRI+NIQ<flertal<Absolut+UNA
Maniitsormiulerissagaluartunga	Maniitsoq+MIU-LIRI-SSA=GALUAR<Participium<jeg
Maniitsormiulerissaangali	Maniitsoq+MIU-LIRI-SSA<Indikativ<jeg+LI
Maniitsormiunngulaarneri	Maniitsoq+MIU-NNGUR-LAAR+NIQ<flertal<hans<Absolut
Maniitsormiunngulertullu	Maniitsoq+MIU-NNGUR-LIR<Participium<de+LU
Maniitsormiunngornanga	Maniitsoq+MIU-NNGUR-NNGIT<Ledsagemåde<jeg
Maniitsormiunngorsimasullu	Maniitsoq+MIU-NNGUR+SIMA<Participium<de+LU
Maniitsormiunngussaangalu	Maniitsoq+MIU-NNGUR-SSA<Indikativ<jeg+LU
Maniitsormioqarporli	Maniitsoq+MIU-QAR<Indikativ<han+LI
Maniitsormioqarneq	Maniitsoq+MIU-QAR+NIQ<ental<Absolut
Maniitsormioqarnerlu	Maniitsoq+MIU-QAR+NIQ<ental<Absolut+LU
Maniitsormioqartorli	Maniitsoq+MIU-QAR<Participium<han+LI
Maniitsormioqartoruna	Maniitsoq+MIU-QAR<Participium<han+UNA
Maniitsormioqartoq	Maniitsoq+MIU-QAR+TUQ<ental<Absolut
Maniitsormioqartorli	Maniitsoq+MIU-QAR+TUQ<ental<Absolut+LI
Maniitsormioqartoruna	Maniitsoq+MIU-QAR+TUQ<ental<Absolut+UNA
Maniitsormiuugaluartoq	Maniitsoq+MIU-U+GALUAR<Participium<han
Maniitsormiuugaluartungaana	Maniitsoq+MIU-U+GALUAR<Participium<jeg+UNA
Maniitsormiuujartorluni	Maniitsoq+MIU-U+GIARTUR<Ledsagemåde<han_selv
Maniitsormiuujartornerinuna	Maniitsoq+MIU-U+GIARTUR+NIQ<flertal<Relativ+UNA
Maniitsormiuuppununa	Maniitsoq+MIU-U<Indikativ<de+UNA
Maniitsormiuuvunga	Maniitsoq+MIU-U<Indikativ<jeg
Maniitsormiuulaarporli	Maniitsoq+MIU-U-LAAR<Indikativ<han+LI
Maniitsormiuuniarnanga	Maniitsoq+MIU-U+NIAR=NNGIT<Ledsagemåde<jeg
Maniitsormiuunianngitsunga	Maniitsoq+MIU-U+NIAR=NNGIT<Participium<jeg
Maniitsormiuuneralu	Maniitsoq+MIU-U+NIQ<ental<hans<Absolut+LU
Maniitsormiuusulli	Maniitsoq+MIU-U<Participium<de+LI
Maniitsormiuusimasoq	Maniitsoq+MIU-U+SIMA<Participium<han
Maniitsormiuusimasarpugut	Maniitsoq+MIU-U+SIMA=TAR<Indikativ<vi
Maniitsormiuusimasarpisi	Maniitsoq+MIU-U+SIMA=TAR<Interrogativ<I
Maniitsormiuusarpunga	Maniitsoq+MIU-U+TAR<Indikativ<jeg
Maniitsumut	Maniitsoq<Terminalis
Maniitsumukalaartoq	Maniitsoq<Terminalis-KAR-LAAR<Participium<han
Maniitsumukalaartartunga	Maniitsoq<Terminalis-KAR-LAAR=TAR<Participium<jeg
Maniitsumukalertununa	Maniitsoq<Terminalis-KAR-LIR<Participium<de+UNA
Maniitsumukanngilatit	Maniitsoq<Terminalis-KAR-NNGIT<Interrogativ<du
Maniitsumukannginneruna	Maniitsoq<Terminalis-KAR-NNGIT+NIQ<ental<Absolut+UNA
Maniitsumukanngitsunga	Maniitsoq<Terminalis-KAR-NNGIT<Participium<jeg
Maniitsumukassagaluarpit	Maniitsoq<Terminalis-KAR-SSA=GALUAR<Interrogativ<du
Maniitsumukassagaluartorlu	Maniitsoq<Terminalis-KAR-SSA=GALUAR+TUQ+LU
Maniitsumukassagaluartoqarpoq	Maniitsoq<Terminalis-KAR-SSA=GALUAR+TUQ-QAR<Indikativ<han
Maniitsumukassagaluartoqanngilarlu	Maniitsoq<Terminalis-KAR-SSA=GALUAR+TUQ-QAR-NNGIT<Indikativ<han+LU
Maniitsumukassaangali	Maniitsoq<Terminalis-KAR-SSA<Indikativ<jeg+LI
Maniitsumulli	Maniitsoq<Terminalis+LI
Maniitsumullu	Maniitsoq<Terminalis+LU
Maniitsumununa	Maniitsoq<Terminalis+UNA
manna	manna<Pronomen<ental
mannali	manna<Pronomen<ental+LI
marluinnarnillu	marluk-INNAQ<flertal<Instrumentalis+LU
marluinnalerivit	marluk-INNAQ-LIRI<Interrogativ<du
marlunngoraluartoqassaagulli	marluk-NNGUR+GALUAR+TUQ-QAR-SSA<Indikativ<vi+LI
marlunngorlunga	marluk-NNGUR<Ledsagemåde<jeg
marlunngunngilarlu	marluk-NNGUR-NNGIT<Indikativ<han+LU
marlunngussalluni	marluk-NNGUR-SSA<Ledsagemåde<han_selv
marlunngussallunga	marluk-NNGUR-SSA<Ledsagemåde<jeg
marlulli	marluk<Talord<Absolut>Pl+LI
marlullu	marluk<Talord<Absolut>Pl+LU
marlunguna	marluk<Talord<Absolut>Pl+UNA
marlutut	marluk<Talord<Aequalis
marlutulli	marluk<Talord<Aequalis+LI
marlunukalaarpugulli	marluk<Talord<flertal<Terminalis-KAR-LAAR<Indikativ<vi+LI
marlunilli	marluk<Talord<Instrumentalis+LI
massakkut	massakkut<Partikel
massakkulli	massakkut<Partikel+LI
massakkullu	massakkut<Partikel+LU
massakkununa	massakkut<Partikel+UNA
meeraq	meeraq<ental<Absolut
meeqqatut	meeraq<ental<Aequalis
meeqqatulli	meeraq<ental<Aequalis+LI
meeraat	meeraq<ental<deres
meeqqamut	meeraq<ental<Terminalis
meeqqamukanngillallu	meeraq<ental<Terminalis-KAR-NNGIT<Indikativ<de+LU
meeqqamulli	meeraq<ental<Terminalis+LI
meeqqamullu	meeraq<ental<Terminalis+LU
meeqqanik	meeraq<flertal<Instrumentalis
meeqqanilli	meeraq<flertal<Instrumentalis+LI
meeqqanillu	meeraq<flertal<Instrumentalis+LU
meeqqani	meeraq<flertal<Lokalis
meeqqaniissalluni	meeraq<flertal<Lokalis+IP-SSA<Ledsagemåde<han_selv
meeqqanili	meeraq<flertal<Lokalis+LI
meeqqanilu	meeraq<flertal<Lokalis+LU
meeqqaniuna	meeraq<flertal<Lokalis+UNA
meeqqakka	meeraq<flertal<min<Absolut
meeqqanukalaarneq	meeraq<flertal<Terminalis-KAR-LAAR+NIQ
meeqqanulli	meeraq<flertal<Terminalis+LI
meeqqanununa	meeraq<flertal<Terminalis+UNA
meerariniarlunga	meeraq+GӘ+NIAR<Ledsagemåde<mig
meerariniarnangaana	meeraq+GӘ+NIAR=NNGIT<Ledsagemåde<mig+UNA
meeraannarmiikkaluarpunga	meeraq-INNAQ<ental<Lokalis+IP+GALUAR<Indikativ<jeg
meeraannalerigaluarluni	meeraq-INNAQ-LIRI+GALUAR<Ledsagemåde<han_selv
meerallillu	meeraq-LIK<flertal<Relativ+LU
meeralilerisimasarpugut	meeraq-LIK-LIRI+SIMA=TAR<Indikativ<vi
meeralerilaarpunga	meeraq-LIRI-LAAR<Indikativ<jeg
meeralerillungali	meeraq-LIRI<Ledsagemåde<jeg+LI
meerarmiulu	meeraq+MIU<ental<Absolut+LU
meerarmiunilli	meeraq+MIU<flertal<Instrumentalis+LI
meerarmiunngulerpugununa	meeraq+MIU-NNGUR-LIR<Indikativ<vi+UNA
meerarmiunngunnginnikka	meeraq+MIU-NNGUR-NNGIT+NIQ<flertal<min<Absolut
meerarmioqarpoq	meeraq+MIU-QAR<Indikativ<han
meerarmioqarporli	meeraq+MIU-QAR<Indikativ<han+LI
meerarmioqartoq	meeraq+MIU-QAR<Participium<han
meerarmiuulertungali	meeraq+MIU-U-LIR<Participium<jeg+LI
meeranngua	meeraq-NNGUAQ<ental<hans<Absolut
meerannguilu	meeraq-NNGUAQ<flertal<hans<Absolut+LU
meeranngoraluarnikkali	meeraq-NNGUR+GALUAR+NIQ<flertal<min<Absolut+LI
meeranngussavit	meeraq-NNGUR-SSA<Interrogativ<du
meeranngortaraluartulli	meeraq-NNGUR+TAR=GALUAR<Participium<de+LI
meerarpassui	meeraq+PASSUAQ<flertal<hans<Absolut
meerarpassuilu	meeraq+PASSUAQ<flertal<hans<Absolut+LU
meerarpassuiuna	meeraq+PASSUAQ<flertal<hans<Absolut+UNA
meerarpassuarniillunga	meeraq+PASSUAQ<flertal<Lokalis+IP<Ledsagemåde<jeg
mittarfik	mittarfik<ental<Absolut
mittarfilli	mittarfik<ental<Absolut+LI
mittarfinguna	mittarfik<ental<Absolut+UNA
mittarfittut	mittarfik<ental<Aequalis
mittarfittulli	mittarfik<ental<Aequalis+LI
mittarfittununa	mittarfik<ental<Aequalis+UNA
mittarfimmilli	mittarfik<ental<Instrumentalis+LI
mittarfigali	mittarfik<ental<min<Absolut+LI
mittarfinnillu	mittarfik<flertal<Instrumentalis+LU
mittarfinniuna	mittarfik<flertal<Lokalis+UNA
mittarfinnulli	mittarfik<flertal<Terminalis+LI
mittarfigilerpassi	mittarfik+GӘ-LIR<Indikativ<JegJer
mittarfigissagaluarpaalli	mittarfik+GӘ-SSA=GALUAR<Indikativ<DeDem+LI
mittarfigisaraluartigit	mittarfik+GӘ+TAR=GALUAR<Imperativ<ViDem
mittarfiinnaalu	mittarfik-INNAQ<ental<hans<Absolut+LU
mittarfillit	mittarfik-LIK<flertal<Absolut
mittarfimmiuniilertoruna	mittarfik+MIU<flertal<Lokalis+IP-LIR+TUQ+UNA
mittarfimmiuuniarnanga	mittarfik+MIU-U+NIAR=NNGIT<Ledsagemåde<jeg
mittarfinnguunani	mittarfik-NNGUAQ-U-NNGIT<Ledsagemåde<han_selv
mittarfinngorpisi	mittarfik-NNGUR<Interrogativ<I
mittarfippassuit	mittarfik+PASSUAQ<flertal<Absolut
mittarfippassuillu	mittarfik+PASSUAQ<flertal<Absolut+LU
mittarfeqalaarpugullu	mittarfik-QAR-LAAR<Indikativ<vi+LU
mittarfeqalaarpisi	mittarfik-QAR-LAAR<Interrogativ<I
mittarfeqalaartarpununa	mittarfik-QAR-LAAR=TAR<Indikativ<de+UNA
mittarfeqalaartarpugut	mittarfik-QAR-LAAR=TAR<Indikativ<vi
mittarfeqalaartarpit	mittarfik-QAR-LAAR=TAR<Interrogativ<du
mittarfeqalaartarpisi	mittarfik-QAR-LAAR=TAR<Interrogativ<I
mittarfeqalaartartoruna	mittarfik-QAR-LAAR=TAR<Participium<han+UNA
mittarfeqalaartartunga	mittarfik-QAR-LAAR=TAR<Participium<jeg
mittarfeqalaartartungalu	mittarfik-QAR-LAAR=TAR<Participium<jeg+LU
mittarfeqalaartormioqartoq	mittarfik-QAR-LAAR+TUQ+MIU-QAR+TUQ<ental<Absolut
mittarfeqalerluniuna	mittarfik-QAR-LIR<Ledsagemåde<han_selv+UNA
mittarfeqalernikkali	mittarfik-QAR-LIR+NIQ<flertal<min<Absolut+LI
mittarfeqalernikkaana	mittarfik-QAR-LIR+NIQ<flertal<min<Absolut+UNA
mittarfeqalertut	mittarfik-QAR-LIR<Participium<de
mittarfeqalertoruna	mittarfik-QAR-LIR<Participium<han+UNA
mittarfeqalertumi	mittarfik-QAR-LIR+TUQ<ental<Lokalis
mittarfeqalertuleriniarpoq	mittarfik-QAR-LIR+TUQ-LIRI+NIAR<Indikativ<han
mittarfeqarniarpugulli	mittarfik-QAR+NIAR<Indikativ<vi+LI
mittarfeqarniartulinnik	mittarfik-QAR+NIAR+TUQ-LIK<flertal<Instrumentalis
mittarfeqanngilangalu	mittarfik-QAR-NNGIT<Indikativ<jeg+LU
mittarfeqanngilatit	mittarfik-QAR-NNGIT<Interrogativ<du
mittarfeqanngitsununa	mittarfik-QAR-NNGIT<Participium<de+UNA
mittarfeqanngitsoq	mittarfik-QAR-NNGIT<Participium<han
mittarfeqartoq	mittarfik-QAR<Participium<han
mittarfeqarsimasungali	mittarfik-QAR+SIMA<Participium<jeg+LI
mittarfeqarsimasarlunga	mittarfik-QAR+SIMA=TAR<Ledsagemåde<jeg
mittarfeqarsimasuussagaluarpungali	mittarfik-QAR+SIMA+TUQ-U-SSA=GALUAR<Indikativ<jeg+LI
mittarfeqassagaluarnermut	mittarfik-QAR-SSA=GALUAR+NIQ<ental<Terminalis
mittarfeqassagaluartullu	mittarfik-QAR-SSA=GALUAR<Participium<de+LU
mittarfeqassagaluartormioqarnerli	mittarfik-QAR-SSA=GALUAR+TUQ+MIU-QAR+NIQ<ental<Absolut+LI
mittarfeqassavisi	mittarfik-QAR-SSA<Interrogativ<I
mittarfeqassasut	mittarfik-QAR-SSA<Participium<de
mittarfeqassasorli	mittarfik-QAR-SSA<Participium<han+LI
mittarfeqassasunga	mittarfik-QAR-SSA<Participium<jeg
mittarfeqassasungali	mittarfik-QAR-SSA<Participium<jeg+LI
mittarfeqartuugaluartorisinnaatigillu	mittarfik-QAR+TUQ-U+GALUAR+TUQ+GӘ+SINNAA<Imperativ<ViDem+LU
mittarfiussavit	mittarfik-U-SSA<Interrogativ<du
najami	naja<ental<Lokalis
najani	naja<flertal<Lokalis
najaginiarnagit	naja+GӘ+NIAR=NNGIT<Ledsagemåde<dem
najaannaa	naja-INNAQ<flertal<hans<Absolut
najaannaqalaarpit	naja-INNAQ-QAR-LAAR<Interrogativ<du
najalilli	naja-LIK<ental<Absolut+LI
najamiuulaartarnertut	naja+MIU-U-LAAR=TAR+NIQ<ental<Aequalis
najamiuusimasarlunilu	naja+MIU-U+SIMA=TAR<Ledsagemåde<han_selv+LU
najannguaqanngitsunga	naja-NNGUAQ-QAR-NNGIT<Participium<jeg
najanngornianngitsunga	naja-NNGUR+NIAR=NNGIT<Participium<jeg
najarpassuarnik	naja+PASSUAQ<flertal<Instrumentalis
najaqalaarpoq	naja-QAR-LAAR<Indikativ<han
najaqanngilangali	naja-QAR-NNGIT<Indikativ<jeg+LI
najugaqarsimappulli	najugaqar+SIMA<Indikativ<de+LI
najugaqassagaluartutullu	najugaqar-SSA=GALUAR+TUQ<ental<Aequalis+LU
najugaqartarpugulli	najugaqar+TAR<Indikativ<vi+LI
najugaq	najugaq<ental<Absolut
najukkatut	najugaq<ental<Aequalis
najukkamik	najugaq<ental<Instrumentalis
najukkamillu	najugaq<ental<Instrumentalis+LU
najukkami	najugaq<ental<Lokalis
najukkamukalerluni	najugaq<ental<Terminalis-KAR-LIR<Ledsagemåde<han_selv
najukkamullu	najugaq<ental<Terminalis+LU
najukkaniissavisi	najugaq<flertal<Lokalis+IP-SSA<Interrogativ<I
najukkakka	najugaq<flertal<min<Absolut
najukkakkalu	najugaq<flertal<min<Absolut+LU
najukkanukalaartarpit	najugaq<flertal<Terminalis-KAR-LAAR=TAR<Interrogativ<du
najugariviuk	najugaq+GӘ<Interrogativ<DuHam
najugaannaa	najugaq-INNAQ<ental<hans<Absolut
najugaleripput	najugaq-LIRI<Indikativ<de
najugarmiumut	najugaq+MIU<ental<Terminalis
najugarmioqarpoq	najugaq+MIU-QAR<Indikativ<han
najugarmioqartorli	najugaq+MIU-QAR<Participium<han+LI
najuganngorlungali	najugaq-NNGUR<Ledsagemåde<jeg+LI
najugarpassuarnukalaarpisi	najugaq+PASSUAQ<flertal<Terminalis-KAR-LAAR<Interrogativ<I
najugaagaluartunngorniarnanga	najugaq-U+GALUAR+TUQ-NNGUR+NIAR=NNGIT<Ledsagemåde<jeg
nalunarpugut	nalunar<Indikativ<vi
nalunalaarneri	nalunar-LAAR+NIQ<flertal<hans<Absolut
nalunalerpit	nalunar-LIR<Interrogativ<du
nalunalertullu	nalunar-LIR<Participium<de+LU
nalunarniarlunili	nalunar+NIAR<Ledsagemåde<han_selv+LI
nalunarniarnanili	nalunar+NIAR=NNGIT<Ledsagemåde<han_selv+LI
nalunarniannginneq	nalunar+NIAR=NNGIT+NIQ<ental<Absolut
nalunarnerilu	nalunar+NIQ<flertal<hans<Absolut+LU
nalunanngillanuna	nalunar-NNGIT<Indikativ<de+UNA
nalunanngilasi	nalunar-NNGIT<Interrogativ<I
nalunarnani	nalunar-NNGIT<Ledsagemåde<han_selv
nalunarnangalu	nalunar-NNGIT<Ledsagemåde<jeg+LU
nalunannginnikka	nalunar-NNGIT+NIQ<flertal<min<Absolut
nalunanngitsoq	nalunar-NNGIT<Participium<han
nalunanngitsorli	nalunar-NNGIT<Participium<han+LI
nalunanngitsungali	nalunar-NNGIT<Participium<jeg+LI
nalunanngitsoq	nalunar-NNGIT+TUQ<ental<Absolut
nalunanngitsorillungali	nalunar-NNGIT+TUQ+GӘ<Ledsagemåde<mig+LI
nalunarsimasungali	nalunar+SIMA<Participium<jeg+LI
nalunassagaluarput	nalunar-SSA=GALUAR<Indikativ<de
nalunassagaluarpisi	nalunar-SSA=GALUAR<Interrogativ<I
nalunassagaluartungali	nalunar-SSA=GALUAR<Participium<jeg+LI
nalunassagaluartormioqartoq	nalunar-SSA=GALUAR+TUQ+MIU-QAR+TUQ<ental<Absolut
nalunassagaluartunngoriartortorisaraluartigit	nalunar-SSA=GALUAR+TUQ-NNGUR+GIARTUR+TUQ+GӘ+TAR=GALUAR<Imperativ<ViDem
nalunassapput	nalunar-SSA<Indikativ<de
nalunassasunga	nalunar-SSA<Participium<jeg
nalunartaraluarpunga	nalunar+TAR=GALUAR<Indikativ<jeg
nalunartaraluarpungali	nalunar+TAR=GALUAR<Indikativ<jeg+LI
nalunartaraluarlunga	nalunar+TAR=GALUAR<Ledsagemåde<jeg
nalunartaraluartulli	nalunar+TAR=GALUAR<Participium<de+LI
nalunartarlungalu	nalunar+TAR<Ledsagemåde<jeg+LU
nalunartoqalaarnerlu	nalunar+TUQ-QAR-LAAR+NIQ<ental<Absolut+LU
nammineq	nammineq<Adjektiv
namminerli	nammineq<Adjektiv+LI
namminerlu	nammineq<Adjektiv+LU
nammineruna	nammineq<Adjektiv+UNA
Nanortalik	Nanortalik<Absolut
Nanortalilli	Nanortalik<Absolut+LI
Nanortalillu	Nanortalik<Absolut+LU
Nanortalinguna	Nanortalik<Absolut+UNA
Nanortalimmik	Nanortalik<Instrumentalis
Nanortalimmilli	Nanortalik<Instrumentalis+LI
Nanortalimmillu	Nanortalik<Instrumentalis+LU
Nanortalimminguna	Nanortalik<Instrumentalis+UNA
Nanortalimmi	Nanortalik<Lokalis
Nanortalimmiuna	Nanortalik<Lokalis+UNA
Nanortalimmiu	Nanortalik+MIU<ental<Absolut
Nanortalimmiuni	Nanortalik+MIU<flertal<Lokalis
Nanortalimmiuleriartorpunga	Nanortalik+MIU-LIRI+GIARTUR<Indikativ<jeg
Nanortalimmiulerilaartarneralli	Nanortalik+MIU-LIRI-LAAR=TAR+NIQ<ental<deres+LI
Nanortalimmiulerillunga	Nanortalik+MIU-LIRI<Ledsagemåde<jeg
Nanortalimmiulerinerit	Nanortalik+MIU-LIRI+NIQ<flertal<Relativ
Nanortalimmioqarporli	Nanortalik+MIU-QAR<Indikativ<han+LI
Nanortalimmioqarneq	Nanortalik+MIU-QAR+NIQ<ental<Absolut
Nanortalimmioqartorli	Nanortalik+MIU-QAR<Participium<han+LI
Nanortalimmioqartoq	Nanortalik+MIU-QAR+TUQ<ental<Absolut
Nanortalimmioqartorlu	Nanortalik+MIU-QAR+TUQ<ental<Absolut+LU
Nanortalimmiuugaluartuussaaruna	Nanortalik+MIU-U+GALUAR+TUQ-U-SSA<Indikativ<han+UNA
Nanortalimmiuuvungalu	Nanortalik+MIU-U<Indikativ<jeg+LU
Nanortalimmiuulaarlungali	Nanortalik+MIU-U-LAAR<Ledsagemåde<jeg+LI
Nanortalimmiuussagaluartulerisinnaasunga	Nanortalik+MIU-U-SSA=GALUAR+TUQ-LIRI+SINNAA<Participium<jeg
Nanortalimmiuusaraluartuusorpassuarni	Nanortalik+MIU-U+TAR=GALUAR+TUQ-U+TUQ+PASSUAQ<flertal<Lokalis
Nanortalimmiuusoq	Nanortalik+MIU-U+TUQ<ental<Absolut
Nanortalimmukalaartungaana	Nanortalik<Terminalis-KAR-LAAR<Participium<jeg+UNA
Nanortalimmukarsimaneq	Nanortalik<Terminalis-KAR+SIMA+NIQ
Nanortalimmullu	Nanortalik<Terminalis+LU
Narsaq	Narsaq<Absolut
Narsarlu	Narsaq<Absolut+LU
Narsaruna	Narsaq<Absolut+UNA
Narsamik	Narsaq<Instrumentalis
Narsamillu	Narsaq<Instrumentalis+LU
Narsaminguna	Narsaq<Instrumentalis+UNA
Narsami	Narsaq<Lokalis
Narsamiillutik	Narsaq<Lokalis+IP<Ledsagemåde<de_selv
Narsamili	Narsaq<Lokalis+LI
Narsarmiumi	Narsaq+MIU<ental<Lokalis
Narsarmiumut	Narsaq+MIU<ental<Terminalis
Narsarmioqarneq	Narsaq+MIU-QAR+NIQ<ental<Absolut
Narsarmioqartoruna	Narsaq+MIU-QAR<Participium<han+UNA
Narsarmioqartoq	Narsaq+MIU-QAR+TUQ<ental<Absolut
Narsarmioqartorlu	Narsaq+MIU-QAR+TUQ<ental<Absolut+LU
Narsarmiuujartortunnguamut	Narsaq+MIU-U+GIARTUR+TUQ-NNGUAQ<ental<Terminalis
Narsarmiuusulli	Narsaq+MIU-U<Participium<de+LI
Narsamukalaartungaana	Narsaq<Terminalis-KAR-LAAR<Participium<jeg+UNA
Narsamukalaartoq	Narsaq<Terminalis-KAR-LAAR+TUQ
Narsamukalerlungali	Narsaq<Terminalis-KAR-LIR<Ledsagemåde<jeg+LI
Narsamukartungaana	Narsaq<Terminalis-KAR<Participium<jeg+UNA
Narsamulli	Narsaq<Terminalis+LI
Narsamullu	Narsaq<Terminalis+LU
Narsarsuaq	Narsarsuaq<Absolut
Narsarsuarmik	Narsarsuaq<Instrumentalis
Narsarsuarmili	Narsarsuaq<Lokalis+LI
Narsarsuarmioqartoq	Narsarsuaq+MIU-QAR<Participium<han
Narsarsuarmiuusut	Narsarsuaq+MIU-U<Participium<de
Narsarsuarmiuussagaluartoq	Narsarsuaq+MIU-U-SSA=GALUAR<Participium<han
Narsarsuarmukalaartarpisi	Narsarsuaq<Terminalis-KAR-LAAR=TAR<Interrogativ<I
Narsarsuarmukalerneq	Narsarsuaq<Terminalis-KAR-LIR+NIQ
Narsarsuarmukalertoqanngilarlu	Narsarsuaq<Terminalis-KAR-LIR+TUQ-QAR-NNGIT<Indikativ<han+LU
nukagiartorlugu	nuka+GӘ+GIARTUR<Ledsagemåde<ham
nukalillu	nuka-LIK<ental<Absolut+LU
nukallinuna	nuka-LIK<flertal<Absolut+UNA
nukallillu	nuka-LIK<flertal<Relativ+LU
nukalilerissagaluarlutik	nuka-LIK-LIRI-SSA=GALUAR<Ledsagemåde<de_selv
nukaleriniarnanga	nuka-LIRI+NIAR=NNGIT<Ledsagemåde<jeg
nukamiulerinngilasi	nuka+MIU-LIRI-NNGIT<Interrogativ<I
nukamiunngulaartarpununa	nuka+MIU-NNGUR-LAAR=TAR<Indikativ<de+UNA
nukamiunngulerpugut	nuka+MIU-NNGUR-LIR<Indikativ<vi
nukamioqarporli	nuka+MIU-QAR<Indikativ<han+LI
nukamioqarnerlu	nuka+MIU-QAR+NIQ<ental<Absolut+LU
nukamioqartorli	nuka+MIU-QAR<Participium<han+LI
nukamiuulaarpit	nuka+MIU-U-LAAR<Interrogativ<du
nukamiuulluni	nuka+MIU-U<Ledsagemåde<han_selv
nukanngussalluni	nuka-NNGUR-SSA<Ledsagemåde<han_selv
nukarpassuit	nuka+PASSUAQ<flertal<Absolut
nukarpassuilli	nuka+PASSUAQ<flertal<Absolut+LI
nukarpassuillu	nuka+PASSUAQ<flertal<Absolut+LU
nukaqalaarpununa	nuka-QAR-LAAR<Indikativ<de+UNA
nukaqarsimasarneri	nuka-QAR+SIMA=TAR+NIQ<flertal<hans<Absolut
nukarlermiuni	nukarleq+MIU<flertal<Lokalis
nukaagaluartunga	nuka-U+GALUAR<Participium<jeg
nukaaniarput	nuka-U+NIAR<Indikativ<de
nuliaq	nuliaq<ental<Absolut
nuliatulli	nuliaq<ental<Aequalis+LI
nuliaali	nuliaq<ental<hans<Absolut+LI
nuliamik	nuliaq<ental<Instrumentalis
nuliara	nuliaq<ental<min<Absolut
nuliakka	nuliaq<flertal<min<Absolut
nuliarissagaluartigilli	nuliaq+GӘ-SSA=GALUAR<Imperativ<ViDem+LI
nuliarisartiginuna	nuliaq+GӘ+TAR<Imperativ<ViDem+UNA
nuliarisarpiuk	nuliaq+GӘ+TAR<Interrogativ<DuHam
nuliaannaaniartunngorniartullu	nuliaq-INNAQ-U+NIAR+TUQ-NNGUR+NIAR<Participium<de+LU
nuliaannaanikka	nuliaq-INNAQ-U+NIQ<flertal<min<Absolut
nulialia	nuliaq-LIK<ental<hans<Absolut
nuliallilli	nuliaq-LIK<flertal<Absolut+LI
nulialerigaluartununa	nuliaq-LIRI+GALUAR<Participium<de+UNA
nuliarmioqarporli	nuliaq+MIU-QAR<Indikativ<han+LI
nuliarmioqartoq	nuliaq+MIU-QAR<Participium<han
nuliarmioqartorli	nuliaq+MIU-QAR+TUQ<ental<Absolut+LI
nuliarmiuussavit	nuliaq+MIU-U-SSA<Interrogativ<du
nuliannguali	nuliaq-NNGUAQ<ental<hans<Absolut+LI
nuliannguani	nuliaq-NNGUAQ<flertal<Lokalis
nulianngoraluarnerilli	nuliaq-NNGUR+GALUAR+NIQ<flertal<Relativ+LI
nuliarpassuartullu	nuliaq+PASSUAQ<flertal<Aequalis+LU
nuliarpassui	nuliaq+PASSUAQ<flertal<hans<Absolut
nuliaqariartorpulli	nuliaq-QAR+GIARTUR<Indikativ<de+LI
nuliaqarsimasut	nuliaq-QAR+SIMA<Participium<de
nuliaqassagaluarpungali	nuliaq-QAR-SSA=GALUAR<Indikativ<jeg+LI
nuliaasuniillutillu	nuliaq-U+TUQ<flertal<Lokalis+IP<Ledsagemåde<de_selv+LU
nunali	nuna<ental<Absolut+LI
nunatullu	nuna<ental<Aequalis+LU
nunaa	nuna<flertal<hans<Absolut
nunagilaarpaallu	nuna+GӘ-LAAR<Indikativ<DeDem+LU
nunagilaartartigilli	nuna+GӘ-LAAR=TAR<Imperativ<ViDem+LI
nunaannaauna	nuna-INNAQ<flertal<hans<Absolut+UNA
nunaannarnik	nuna-INNAQ<flertal<Instrumentalis
nunaannaasaraluarlunilu	nuna-INNAQ-U+TAR=GALUAR<Ledsagemåde<han_selv+LU
nunalikka	nuna-LIK<flertal<min<Absolut
nunalileriniarpulli	nuna-LIK-LIRI+NIAR<Indikativ<de+LI
nunamiulerivugut	nuna+MIU-LIRI<Indikativ<vi
nunamioqarpoq	nuna+MIU-QAR<Indikativ<han
nunamioqartoq	nuna+MIU-QAR<Participium<han
nunamiuulertui	nuna+MIU-U-LIR+TUQ<flertal<hans<Absolut
nunamiuusimasartuleriniarnanga	nuna+MIU-U+SIMA=TAR+TUQ-LIRI+NIAR=NNGIT<Ledsagemåde<jeg
nunamiuussavit	nuna+MIU-U-SSA<Interrogativ<du
nunannguuniartoq	nuna-NNGUAQ-U+NIAR+TUQ<ental<Absolut
nunannguusinnaavunga	nuna-NNGUAQ-U+SINNAA<Indikativ<jeg
nunanngulernikkalu	nuna-NNGUR-LIR+NIQ<flertal<min<Absolut+LU
nunanngortaraluarpit	nuna-NNGUR+TAR=GALUAR<Interrogativ<du
nunarpassuakka	nuna+PASSUAQ<flertal<min<Absolut
Nuuk	Nuuk<Absolut
Nuulli	Nuuk<Absolut+LI
Nuullu	Nuuk<Absolut+LU
Nuunguna	Nuuk<Absolut+UNA
Nuummik	Nuuk<Instrumentalis
Nuummillu	Nuuk<Instrumentalis+LU
Nuummi	Nuuk<Lokalis
Nuummiilerlunga	Nuuk<Lokalis+IP-LIR<Ledsagemåde<jeg
Nuummiilertoq	Nuuk<Lokalis+IP-LIR+TUQ
Nuummili	Nuuk<Lokalis+LI
Nuummilu	Nuuk<Lokalis+LU
Nuummiu	Nuuk+MIU<ental<Absolut
Nuummiumiittarpungalu	Nuuk+MIU<ental<Lokalis+IP+TAR<Indikativ<jeg+LU
Nuummiumukalaartunga	Nuuk+MIU<ental<Terminalis-KAR-LAAR<Participium<jeg
Nuummiumukalaartarnerli	Nuuk+MIU<ental<Terminalis-KAR-LAAR=TAR+NIQ+LI
Nuummiuni	Nuuk+MIU<flertal<Lokalis
Nuummiuniittartoq	Nuuk+MIU<flertal<Lokalis+IP+TAR+TUQ
Nuummiulerinianngitsunga	Nuuk+MIU-LIRI+NIAR=NNGIT<Participium<jeg
Nuummiunngorniarlutik	Nuuk+MIU-NNGUR+NIAR<Ledsagemåde<de_selv
Nuummiunngorneri	Nuuk+MIU-NNGUR+NIQ<flertal<hans<Absolut
Nuummiunngorsimasullu	Nuuk+MIU-NNGUR+SIMA<Participium<de+LU
Nuummiunngorsinnaasullu	Nuuk+MIU-NNGUR+SINNAA<Participium<de+LU
Nuummioqarporli	Nuuk+MIU-QAR<Indikativ<han+LI
Nuummioqarneq	Nuuk+MIU-QAR+NIQ<ental<Absolut
Nuummioqarnerli	Nuuk+MIU-QAR+NIQ<ental<Absolut+LI
Nuummioqarnerlu	Nuuk+MIU-QAR+NIQ<ental<Absolut+LU
Nuummioqartoq	Nuuk+MIU-QAR<Participium<han
Nuummiuujartortui	Nuuk+MIU-U+GIARTUR+TUQ<flertal<hans<Absolut
Nuummiuuvunga	Nuuk+MIU-U<Indikativ<jeg
Nuummiuulaartarpunga	Nuuk+MIU-U-LAAR=TAR<Indikativ<jeg
Nuummiuulluni	Nuuk+MIU-U<Ledsagemåde<han_selv
Nuummiuusimavit	Nuuk+MIU-U+SIMA<Interrogativ<du
Nuummiuussallunili	Nuuk+MIU-U-SSA<Ledsagemåde<han_selv+LI
Nuummukarluni	Nuuk<Terminalis-KAR<Ledsagemåde<han_selv
Nuummukanngilatit	Nuuk<Terminalis-KAR-NNGIT<Interrogativ<du
Nuummukanngitsoq	Nuuk<Terminalis-KAR-NNGIT+TUQ<ental<Absolut
Nuummukassallunili	Nuuk<Terminalis-KAR-SSA<Ledsagemåde<han_selv+LI
Nuummukartarlungali	Nuuk<Terminalis-KAR+TAR<Ledsagemåde<jeg+LI
Nuummulli	Nuuk<Terminalis+LI
nuukkaluartungali	nuup+GALUAR<Participium<jeg+LI
nuukkaluartoqassagaluartut	nuup+GALUAR+TUQ-QAR-SSA=GALUAR<Participium<de
nuukkiartorpunga	nuup+GIARTUR<Indikativ<jeg
nuukkiartorlunga	nuup+GIARTUR<Ledsagemåde<jeg
nuuppugulli	nuup<Indikativ<vi+LI
nuulaartarpit	nuup-LAAR=TAR<Interrogativ<du
nuulaartarpisi	nuup-LAAR=TAR<Interrogativ<I
nuullutik	nuup<Ledsagemåde<de_selv
nuulluni	nuup<Ledsagemåde<han_selv
nuullungaana	nuup<Ledsagemåde<jeg+UNA
nuulerpunga	nuup-LIR<Indikativ<jeg
nuunnianngillalli	nuup+NIAR=NNGIT<Indikativ<de+LI
nuunnianngilagulli	nuup+NIAR=NNGIT<Indikativ<vi+LI
nuunnatinguna	nuup-NNGIT<Ledsagemåde<de_selv+UNA
nuunnangali	nuup-NNGIT<Ledsagemåde<jeg+LI
nuunngitsununa	nuup-NNGIT<Participium<de+UNA
nuuttorlu	nuup<Participium<han+LU
nuussimavugut	nuup+SIMA<Indikativ<vi
nuussimallunga	nuup+SIMA<Ledsagemåde<jeg
nuussimasarnerilli	nuup+SIMA=TAR+NIQ<flertal<Relativ+LI
nuussinnaasunnguussagaluarpullu	nuup+SINNAA+TUQ-NNGUAQ-U-SSA=GALUAR<Indikativ<de+LU
nuussagaluarnikkaana	nuup-SSA=GALUAR+NIQ<flertal<min<Absolut+UNA
nuussavisi	nuup-SSA<Interrogativ<I
nuuttoq	nuup+TUQ<ental<Absolut
nuuttoqassagaluarlutilli	nuup+TUQ-QAR-SSA=GALUAR<Ledsagemåde<de_selv+LI
oqaaseq	oqaaseq<ental<Absolut
oqaatsitut	oqaaseq<ental<Aequalis
oqaatsitulli	oqaaseq<ental<Aequalis+LI
oqaatsimi	oqaaseq<ental<Lokalis
oqaatsimiuna	oqaaseq<ental<Lokalis+UNA
oqaatsimut	oqaaseq<ental<Terminalis
oqaatsinik	oqaaseq<flertal<Instrumentalis
oqaatsinilli	oqaaseq<flertal<Instrumentalis+LI
oqaatsininguna	oqaaseq<flertal<Instrumentalis+UNA
oqaatsini	oqaaseq<flertal<Lokalis
oqaatsiniinniarlungali	oqaaseq<flertal<Lokalis+IP+NIAR<Ledsagemåde<jeg+LI
oqaatsiniinnginnerlu	oqaaseq<flertal<Lokalis+IP-NNGIT+NIQ<ental<Absolut+LU
oqaatsiniissimaneq	oqaaseq<flertal<Lokalis+IP+SIMA+NIQ
oqaatsinili	oqaaseq<flertal<Lokalis+LI
oqaatsikka	oqaaseq<flertal<min<Absolut
oqaatsikkali	oqaaseq<flertal<min<Absolut+LI
oqaatsinut	oqaaseq<flertal<Terminalis
oqaatsinukarpugullu	oqaaseq<flertal<Terminalis-KAR<Indikativ<vi+LU
oqaatsinukassallunga	oqaaseq<flertal<Terminalis-KAR-SSA<Ledsagemåde<jeg
oqaatsinulli	oqaaseq<flertal<Terminalis+LI
oqaasiinnaallu	oqaaseq-INNAQ<ental<deres<Absolut+LU
oqaasiinnaa	oqaaseq-INNAQ<ental<hans<Absolut
oqaasillit	oqaaseq-LIK<flertal<Absolut
oqaasillilli	oqaaseq-LIK<flertal<Absolut+LI
oqaasililerisimasoqalaarlunga	oqaaseq-LIK-LIRI+SIMA+TUQ-QAR-LAAR<Ledsagemåde<jeg
oqaasermioqarnerli	oqaaseq+MIU-QAR+NIQ<ental<Absolut+LI
oqaasermiuusullu	oqaaseq+MIU-U<Participium<de+LU
oqaasinngorneruna	oqaaseq-NNGUR+NIQ<ental<Absolut+UNA
oqaasinngunngilanga	oqaaseq-NNGUR-NNGIT<Indikativ<jeg
oqaasinngorsimanerit	oqaaseq-NNGUR+SIMA+NIQ<flertal<Absolut
oqaaserpassuarnukalaarlutillu	oqaaseq+PASSUAQ<flertal<Terminalis-KAR-LAAR<Ledsagemåde<de_selv+LU
oqaaseqanngilangali	oqaaseq-QAR-NNGIT<Indikativ<jeg+LI
oqaaseqannginnernulli	oqaaseq-QAR-NNGIT+NIQ<flertal<Terminalis+LI
oqaaseqassaangali	oqaaseq-QAR-SSA<Indikativ<jeg+LI
oqaasiuniarnerit	oqaaseq-U+NIAR+NIQ<flertal<Absolut
oqaasilerineq	oqaasilerineq<ental<Absolut
oqaasilerinerlu	oqaasilerineq<ental<Absolut+LU
oqaasilerinerinnalerilaartartutut	oqaasilerineq-INNAQ-LIRI-LAAR=TAR+TUQ<ental<Aequalis
oqaasilerinerpassui	oqaasilerineq+PASSUAQ<flertal<hans<Absolut
oqaasilerisua	oqaasilerisoq<ental<hans<Absolut
oqaasilerisullinuna	oqaasilerisoq-LIK<flertal<Absolut+UNA
oqaasilerisoqassagaluartoqassappununa	oqaasilerisoq-QAR-SSA=GALUAR+TUQ-QAR-SSA<Indikativ<de+UNA
oqaluttuaraluarpisi	oqaluttuar+GALUAR<Interrogativ<I
oqaluttuarporli	oqaluttuar<Indikativ<han+LI
oqaluttuarpit	oqaluttuar<Interrogativ<du
oqaluttualaarneq	oqaluttuar-LAAR+NIQ<ental<Absolut
oqaluttualaarnikkalu	oqaluttuar-LAAR+NIQ<flertal<min<Absolut+LU
oqaluttualaartoruna	oqaluttuar-LAAR<Participium<han+UNA
oqaluttualaartungalu	oqaluttuar-LAAR<Participium<jeg+LU
oqaluttualaartarlutik	oqaluttuar-LAAR=TAR<Ledsagemåde<de_selv
oqaluttualaartoq	oqaluttuar-LAAR+TUQ<ental<Absolut
oqaluttualaartutulli	oqaluttuar-LAAR+TUQ<ental<Aequalis+LI
oqaluttualaartuunikka	oqaluttuar-LAAR+TUQ-U+NIQ<flertal<min<Absolut
oqaluttuarluni	oqaluttuar<Ledsagemåde<han_selv
oqaluttuarlunga	oqaluttuar<Ledsagemåde<jeg
oqaluttualertunga	oqaluttuar-LIR<Participium<jeg
oqaluttuarniarnikka	oqaluttuar+NIAR+NIQ<flertal<min<Absolut
oqaluttuarniarnanga	oqaluttuar+NIAR=NNGIT<Ledsagemåde<jeg
oqaluttuarniarnangali	oqaluttuar+NIAR=NNGIT<Ledsagemåde<jeg+LI
oqaluttuarniannginnerinuna	oqaluttuar+NIAR=NNGIT+NIQ<flertal<Relativ+UNA
oqaluttuarnianngitsoq	oqaluttuar+NIAR=NNGIT+TUQ<ental<Absolut
oqaluttuarniartut	oqaluttuar+NIAR<Participium<de
oqaluttuarniartulli	oqaluttuar+NIAR<Participium<de+LI
oqaluttuanngilasi	oqaluttuar-NNGIT<Interrogativ<I
oqaluttuanngitsungaana	oqaluttuar-NNGIT<Participium<jeg+UNA
oqaluttuanngitsuinnaanuna	oqaluttuar-NNGIT+TUQ-INNAQ<flertal<Relativ+UNA
oqaluttuanngitsunnguamukalerpit	oqaluttuar-NNGIT+TUQ-NNGUAQ<ental<Terminalis-KAR-LIR<Interrogativ<du
oqaluttuarsimasarpulli	oqaluttuar+SIMA=TAR<Indikativ<de+LI
oqaluttuarsinnaappullu	oqaluttuar+SINNAA<Indikativ<de+LU
oqaluttuarsinnaallunilu	oqaluttuar+SINNAA<Ledsagemåde<han_selv+LU
oqaluttuassagaluarpunga	oqaluttuar-SSA=GALUAR<Indikativ<jeg
oqaluttuassagaluartunga	oqaluttuar-SSA=GALUAR<Participium<jeg
oqaluttuassapput	oqaluttuar-SSA<Indikativ<de
oqaluttuassavit	oqaluttuar-SSA<Interrogativ<du
oqaluttuassavisi	oqaluttuar-SSA<Interrogativ<I
oqaluttuassalluni	oqaluttuar-SSA<Ledsagemåde<han_selv
oqaluttuartaraluarpulli	oqaluttuar+TAR=GALUAR<Indikativ<de+LI
oqaluttuartaraluarpunga	oqaluttuar+TAR=GALUAR<Indikativ<jeg
oqaluttuartumukalertut	oqaluttuar+TUQ<ental<Terminalis-KAR-LIR<Participium<de
oqaluttuartormiuusimanikka	oqaluttuar+TUQ+MIU-U+SIMA+NIQ<flertal<min<Absolut
oqaraluarnerillu	oqar+GALUAR+NIQ<flertal<Absolut+LU
oqaraluartoralu	oqar+GALUAR+TUQ<ental<min<Absolut+LU
oqaraluartulerinangaana	oqar+GALUAR+TUQ-LIRI-NNGIT<Ledsagemåde<jeg+UNA
oqaraluartuulaartui	oqar+GALUAR+TUQ-U-LAAR+TUQ<flertal<hans<Absolut
oqariartorpungalu	oqar+GIARTUR<Indikativ<jeg+LU
oqariartorpit	oqar+GIARTUR<Interrogativ<du
oqarpoq	oqar<Indikativ<han
oqarpit	oqar<Interrogativ<du
oqarpisi	oqar<Interrogativ<I
oqalaarpisi	oqar-LAAR<Interrogativ<I
oqalaarluni	oqar-LAAR<Ledsagemåde<han_selv
oqalaarlunga	oqar-LAAR<Ledsagemåde<jeg
oqalaarneralu	oqar-LAAR+NIQ<ental<min<Absolut+LU
oqalaarneriuna	oqar-LAAR+NIQ<flertal<hans<Absolut+UNA
oqalaartullu	oqar-LAAR<Participium<de+LU
oqalaartorlu	oqar-LAAR<Participium<han+LU
oqalaartarpoq	oqar-LAAR=TAR<Indikativ<han
oqalaartarpugut	oqar-LAAR=TAR<Indikativ<vi
oqalaartarpugununa	oqar-LAAR=TAR<Indikativ<vi+UNA
oqalaartarnerilli	oqar-LAAR=TAR+NIQ<flertal<Relativ+LI
oqalaartunngorsimasarpungalu	oqar-LAAR+TUQ-NNGUR+SIMA=TAR<Indikativ<jeg+LU
oqalaartoqannginnerilli	oqar-LAAR+TUQ-QAR-NNGIT+NIQ<flertal<Absolut+LI
oqarlutilli	oqar<Ledsagemåde<de_selv+LI
oqarlutinguna	oqar<Ledsagemåde<de_selv+UNA
oqarluni	oqar<Ledsagemåde<han_selv
oqalerpoq	oqar-LIR<Indikativ<han
oqalerpungaana	oqar-LIR<Indikativ<jeg+UNA
oqalerpugut	oqar-LIR<Indikativ<vi
oqalerpit	oqar-LIR<Interrogativ<du
oqalerlunga	oqar-LIR<Ledsagemåde<jeg
oqalernerinuna	oqar-LIR+NIQ<flertal<Relativ+UNA
oqalertoq	oqar-LIR<Participium<han
oqalertungalu	oqar-LIR<Participium<jeg+LU
oqalertulik	oqar-LIR+TUQ-LIK<ental<Absolut
oqarniarluni	oqar+NIAR<Ledsagemåde<han_selv
oqarnianngilagununa	oqar+NIAR=NNGIT<Indikativ<vi+UNA
oqarniarnatik	oqar+NIAR=NNGIT<Ledsagemåde<de_selv
oqarniarnani	oqar+NIAR=NNGIT<Ledsagemåde<han_selv
oqarniarnangaana	oqar+NIAR=NNGIT<Ledsagemåde<jeg+UNA
oqarniannginnikkaana	oqar+NIAR=NNGIT+NIQ<flertal<min<Absolut+UNA
oqarnikka	oqar+NIQ<flertal<min<Absolut
oqarnikkali	oqar+NIQ<flertal<min<Absolut+LI
oqanngilanga	oqar-NNGIT<Indikativ<jeg
oqanngilangaana	oqar-NNGIT<Indikativ<jeg+UNA
oqanngilagulli	oqar-NNGIT<Indikativ<vi+LI
oqanngilatit	oqar-NNGIT<Interrogativ<du
oqanngilasi	oqar-NNGIT<Interrogativ<I
oqarnatilli	oqar-NNGIT<Ledsagemåde<de_selv+LI
oqarnanilu	oqar-NNGIT<Ledsagemåde<han_selv+LU
oqarnanga	oqar-NNGIT<Ledsagemåde<jeg
oqannginneq	oqar-NNGIT+NIQ<ental<Absolut
oqannginnikka	oqar-NNGIT+NIQ<flertal<min<Absolut
oqanngitsulli	oqar-NNGIT<Participium<de+LI
oqanngitsununa	oqar-NNGIT<Participium<de+UNA
oqanngitsunga	oqar-NNGIT<Participium<jeg
oqanngitsoq	oqar-NNGIT+TUQ<ental<Absolut
oqanngitsoqarnatik	oqar-NNGIT+TUQ-QAR-NNGIT<Ledsagemåde<de_selv
oqartoq	oqar<Participium<han
oqartunga	oqar<Participium<jeg
oqarsimavit	oqar+SIMA<Interrogativ<du
oqarsimallunga	oqar+SIMA<Ledsagemåde<jeg
oqarsimasulli	oqar+SIMA<Participium<de+LI
oqarsimasarpununa	oqar+SIMA=TAR<Indikativ<de+UNA
oqarsimasarnerilli	oqar+SIMA=TAR+NIQ<flertal<Absolut+LI
oqarsimasartumi	oqar+SIMA=TAR+TUQ<ental<Lokalis
oqarsimasartorilerpiuk	oqar+SIMA=TAR+TUQ+GӘ-LIR<Interrogativ<DuHam
oqarsimasartoqalertoqassallutilli	oqar+SIMA=TAR+TUQ-QAR-LIR+TUQ-QAR-SSA<Ledsagemåde<de_selv+LI
oqarsimasormiu	oqar+SIMA+TUQ+MIU<ental<Absolut
oqarsinnaasullu	oqar+SINNAA<Participium<de+LU
oqarsinnaasoq	oqar+SINNAA<Participium<han
oqarsinnaasormiuujartorlunili	oqar+SINNAA+TUQ+MIU-U+GIARTUR<Ledsagemåde<han_selv+LI
oqassagaluarpullu	oqar-SSA=GALUAR<Indikativ<de+LU
oqassagaluarpungalu	oqar-SSA=GALUAR<Indikativ<jeg+LU
oqassagaluarpisi	oqar-SSA=GALUAR<Interrogativ<I
oqassagaluarluni	oqar-SSA=GALUAR<Ledsagemåde<han_selv
oqassagaluarneralli	oqar-SSA=GALUAR+NIQ<ental<deres+LI
oqassagaluarnikkali	oqar-SSA=GALUAR+NIQ<flertal<min<Absolut+LI
oqassagaluartunga	oqar-SSA=GALUAR<Participium<jeg
oqassagaluartoqalaartoqalaartartulerisoruna	oqar-SSA=GALUAR+TUQ-QAR-LAAR+TUQ-QAR-LAAR=TAR+TUQ-LIRI+TUQ<ental<Absolut+UNA
oqassaanga	oqar-SSA<Indikativ<jeg
oqassavit	oqar-SSA<Interrogativ<du
oqassallutilli	oqar-SSA<Ledsagemåde<de_selv+LI
oqassasunga	oqar-SSA<Participium<jeg
oqartaraluarpugut	oqar+TAR=GALUAR<Indikativ<vi
oqartaraluarlutinguna	oqar+TAR=GALUAR<Ledsagemåde<de_selv+UNA
oqartaraluarnikka	oqar+TAR=GALUAR+NIQ<flertal<min<Absolut
oqartaraluartoq	oqar+TAR=GALUAR<Participium<han
oqartarpungalu	oqar+TAR<Indikativ<jeg+LU
oqartarpisi	oqar+TAR<Interrogativ<I
oqartartunga	oqar+TAR<Participium<jeg
oqartoqalaarlunili	oqar+TUQ-QAR-LAAR<Ledsagemåde<han_selv+LI
oqartoqarsinnaasungali	oqar+TUQ-QAR+SINNAA<Participium<jeg+LI
Paamiut	Paamiut<Absolut
Paamiulli	Paamiut<Absolut+LI
Paamiullu	Paamiut<Absolut+LU
Paamiununa	Paamiut<Absolut+UNA
Paamiunik	Paamiut<Instrumentalis
Paamiunilli	Paamiut<Instrumentalis+LI
Paamiuninguna	Paamiut<Instrumentalis+UNA
Paamiuni	Paamiut<Lokalis
Paamiuniilaarpugut	Paamiut<Lokalis+IP-LAAR<Indikativ<vi
Paamiuniilaartoq	Paamiut<Lokalis+IP-LAAR<Participium<han
Paamiuniinniarnatik	Paamiut<Lokalis+IP+NIAR=NNGIT<Ledsagemåde<de_selv
Paamiuniinngitsunga	Paamiut<Lokalis+IP-NNGIT<Participium<jeg
Paamiuniissagaluarlunili	Paamiut<Lokalis+IP-SSA=GALUAR<Ledsagemåde<han_selv+LI
Paamiunili	Paamiut<Lokalis+LI
Paamiunilu	Paamiut<Lokalis+LU
Paamiormiu	Paamiut+MIU<ental<Absolut
Paamiormiumik	Paamiut+MIU<ental<Instrumentalis
Paamiormiumilli	Paamiut+MIU<ental<Instrumentalis+LI
Paamiormiumiuna	Paamiut+MIU<ental<Lokalis+UNA
Paamiormiumukalaarlunga	Paamiut+MIU<ental<Terminalis-KAR-LAAR<Ledsagemåde<jeg
Paamiormiumulli	Paamiut+MIU<ental<Terminalis+LI
Paamiormiunilu	Paamiut+MIU<flertal<Lokalis+LU
Paamiormiulerivisi	Paamiut+MIU-LIRI<Interrogativ<I
Paamiormiulerinianngitsununa	Paamiut+MIU-LIRI+NIAR=NNGIT<Participium<de+UNA
Paamiormiulerinngitsuni	Paamiut+MIU-LIRI-NNGIT+TUQ<flertal<Lokalis
Paamiormiulerisimasartumilu	Paamiut+MIU-LIRI+SIMA=TAR+TUQ<ental<Lokalis+LU
Paamiormiulerisinnaavugununa	Paamiut+MIU-LIRI+SINNAA<Indikativ<vi+UNA
Paamiormiulerisunngulaarlungaana	Paamiut+MIU-LIRI+TUQ-NNGUR-LAAR<Ledsagemåde<jeg+UNA
Paamiormiunngoriartorporlu	Paamiut+MIU-NNGUR+GIARTUR<Indikativ<han+LU
Paamiormiunngulaarneq	Paamiut+MIU-NNGUR-LAAR+NIQ<ental<Absolut
Paamiormiunngulerlutik	Paamiut+MIU-NNGUR-LIR<Ledsagemåde<de_selv
Paamiormiunngussagaluarpisi	Paamiut+MIU-NNGUR-SSA=GALUAR<Interrogativ<I
Paamiormioqarpoq	Paamiut+MIU-QAR<Indikativ<han
Paamiormioqarporlu	Paamiut+MIU-QAR<Indikativ<han+LU
Paamiormioqarporuna	Paamiut+MIU-QAR<Indikativ<han+UNA
Paamiormioqarneq	Paamiut+MIU-QAR+NIQ<ental<Absolut
Paamiormioqarnerlu	Paamiut+MIU-QAR+NIQ<ental<Absolut+LU
Paamiormioqarneruna	Paamiut+MIU-QAR+NIQ<ental<Absolut+UNA
Paamiormioqartoq	Paamiut+MIU-QAR<Participium<han
Paamiormioqartorlu	Paamiut+MIU-QAR<Participium<han+LU
Paamiormioqartoq	Paamiut+MIU-QAR+TUQ<ental<Absolut
Paamiormioqartorli	Paamiut+MIU-QAR+TUQ<ental<Absolut+LI
Paamiormiuujartornikka	Paamiut+MIU-U+GIARTUR+NIQ<flertal<min<Absolut
Paamiormiuujartortoqalertoqanngitsunga	Paamiut+MIU-U+GIARTUR+TUQ-QAR-LIR+TUQ-QAR-NNGIT<Participium<jeg
Paamiormiuujartortoqassagaluarnernik	Paamiut+MIU-U+GIARTUR+TUQ-QAR-SSA=GALUAR+NIQ<flertal<Instrumentalis
Paamiormiuulaarnerilli	Paamiut+MIU-U-LAAR+NIQ<flertal<Absolut+LI
Paamiormiuullutilli	Paamiut+MIU-U<Ledsagemåde<de_selv+LI
Paamiormiuuniarpungali	Paamiut+MIU-U+NIAR<Indikativ<jeg+LI
Paamiormiuuniarpisi	Paamiut+MIU-U+NIAR<Interrogativ<I
Paamiormiuuniarnatik	Paamiut+MIU-U+NIAR=NNGIT<Ledsagemåde<de_selv
Paamiormiuunerit	Paamiut+MIU-U+NIQ<flertal<Absolut
Paamiormiuusimappullu	Paamiut+MIU-U+SIMA<Indikativ<de+LU
Paamiormiuusimasartorlu	Paamiut+MIU-U+SIMA=TAR<Participium<han+LU
Paamiormiuusimasartunga	Paamiut+MIU-U+SIMA=TAR<Participium<jeg
Paamiormiuusinnaavugulli	Paamiut+MIU-U+SINNAA<Indikativ<vi+LI
Paamiormiuusinnaavit	Paamiut+MIU-U+SINNAA<Interrogativ<du
Paamiormiuussagaluarnikka	Paamiut+MIU-U-SSA=GALUAR+NIQ<flertal<min<Absolut
Paamiormiuussasoq	Paamiut+MIU-U-SSA<Participium<han
Paamiormiuusarlunga	Paamiut+MIU-U+TAR<Ledsagemåde<jeg
Paamiormiuusarlungali	Paamiut+MIU-U+TAR<Ledsagemåde<jeg+LI
Paamiunukalaarpugununa	Paamiut<Terminalis-KAR-LAAR<Indikativ<vi+UNA
Paamiunukalaarpit	Paamiut<Terminalis-KAR-LAAR<Interrogativ<du
Paamiunukalaarneq	Paamiut<Terminalis-KAR-LAAR+NIQ
Paamiunukalaartarluniuna	Paamiut<Terminalis-KAR-LAAR=TAR<Ledsagemåde<han_selv+UNA
Paamiunukalerlutinguna	Paamiut<Terminalis-KAR-LIR<Ledsagemåde<de_selv+UNA
Paamiunukartunga	Paamiut<Terminalis-KAR<Participium<jeg
Paamiunukarsinnaaneruna	Paamiut<Terminalis-KAR+SINNAA+NIQ+UNA
Paamiunukassagaluarnerli	Paamiut<Terminalis-KAR-SSA=GALUAR+NIQ+LI
Paamiunulli	Paamiut<Terminalis+LI
Paamiunullu	Paamiut<Terminalis+LU
Paamiunununa	Paamiut<Terminalis+UNA
piareeriartortut	piareer+GIARTUR<Participium<de
piareerpunga	piareer<Indikativ<jeg
piareerpugut	piareer<Indikativ<vi
piariilaartarlungalu	piareer-LAAR=TAR<Ledsagemåde<jeg+LU
piariilaartarnerinuna	piareer-LAAR=TAR+NIQ<flertal<Relativ+UNA
piareernianngitsullilli	piareer+NIAR=NNGIT+TUQ-LIK<flertal<Relativ+LI
piareernanga	piareer-NNGIT<Ledsagemåde<jeg
piareertut	piareer<Participium<de
piareertunga	piareer<Participium<jeg
piareersimanikkaana	piareer+SIMA+NIQ<flertal<min<Absolut+UNA
pigaluartigit	pi+GALUAR<Imperativ<ViDem
pigaluarpaat	pi+GALUAR<Indikativ<DeDem
pigaluarpakkali	pi+GALUAR<Indikativ<JegDem+LI
pigaluarpiuk	pi+GALUAR<Interrogativ<DuHam
pigaluarluginuna	pi+GALUAR<Ledsagemåde<dem+UNA
pigaluarlugu	pi+GALUAR<Ledsagemåde<ham
pigaluarlunga	pi+GALUAR<Ledsagemåde<mig
piartortigit	pi+GIARTUR<Imperativ<ViDem
piartortigilli	pi+GIARTUR<Imperativ<ViDem+LI
piartortigillu	pi+GIARTUR<Imperativ<ViDem+LU
piartorpaallu	pi+GIARTUR<Indikativ<DeDem+LU
piartorpaannga	pi+GIARTUR<Indikativ<DeMig
piartorpaanngali	pi+GIARTUR<Indikativ<DeMig+LI
piartorparsili	pi+GIARTUR<Indikativ<I_Ham+LI
piartorpagulli	pi+GIARTUR<Indikativ<ViDem+LI
piartorlugu	pi+GIARTUR<Ledsagemåde<ham
pitigit	pi<Imperativ<ViDem
pitigilli	pi<Imperativ<ViDem+LI
pitigillu	pi<Imperativ<ViDem+LU
pitiginuna	pi<Imperativ<ViDem+UNA
pivaalli	pi<Indikativ<DeDem+LI
pivaannga	pi<Indikativ<DeMig
pivaalu	pi<Indikativ<HanDem+LU
pivaa	pi<Indikativ<HanHam
pivarsi	pi<Indikativ<I_Ham
pivakka	pi<Indikativ<JegDem
pivassilu	pi<Indikativ<JegJer+LU
pivagununa	pi<Indikativ<ViDem+UNA
piviuk	pi<Interrogativ<DuHam
pilaartigit	pi-LAAR<Imperativ<ViDem
pilaartigilli	pi-LAAR<Imperativ<ViDem+LI
pilaartiginuna	pi-LAAR<Imperativ<ViDem+UNA
pilaarpaalli	pi-LAAR<Indikativ<DeDem+LI
pilaarpai	pi-LAAR<Indikativ<HanDem
pilaarpassi	pi-LAAR<Indikativ<JegJer
pilaarpiuk	pi-LAAR<Interrogativ<DuHam
pilaarlugit	pi-LAAR<Ledsagemåde<dem
pilaarlugilli	pi-LAAR<Ledsagemåde<dem+LI
pilaarluguli	pi-LAAR<Ledsagemåde<ham+LI
pilaartartigit	pi-LAAR=TAR<Imperativ<ViDem
pilaartartigillu	pi-LAAR=TAR<Imperativ<ViDem+LU
pilaartartiginuna	pi-LAAR=TAR<Imperativ<ViDem+UNA
pilaartarpaanngali	pi-LAAR=TAR<Indikativ<DeMig+LI
pilaartarpaalu	pi-LAAR=TAR<Indikativ<HanDem+LU
pilaartarpakka	pi-LAAR=TAR<Indikativ<JegDem
pilaartarpiuk	pi-LAAR=TAR<Interrogativ<DuHam
pillugit	pi<Ledsagemåde<dem
pillugillu	pi<Ledsagemåde<dem+LU
pilluginuna	pi<Ledsagemåde<dem+UNA
pillugu	pi<Ledsagemåde<ham
pilluguli	pi<Ledsagemåde<ham+LI
pilluguuna	pi<Ledsagemåde<ham+UNA
pillunga	pi<Ledsagemåde<mig
pillungali	pi<Ledsagemåde<mig+LI
pillungalu	pi<Ledsagemåde<mig+LU
pillungaana	pi<Ledsagemåde<mig+UNA
pilertigit	pi-LIR<Imperativ<ViDem
pilertigilli	pi-LIR<Imperativ<ViDem+LI
pilertiginuna	pi-LIR<Imperativ<ViDem+UNA
pilerpaat	pi-LIR<Indikativ<DeDem
pilerpakka	pi-LIR<Indikativ<JegDem
pilerpiuk	pi-LIR<Interrogativ<DuHam
pilerluguli	pi-LIR<Ledsagemåde<ham+LI
pingasuinnalerinani	pingasut-INNAQ-LIRI-NNGIT<Ledsagemåde<han_selv
pingasuinnalerisoqassaarlu	pingasut-INNAQ-LIRI+TUQ-QAR-SSA<Indikativ<han+LU
pingasunngorpit	pingasut-NNGUR<Interrogativ<du
pingasunngulaartarnikkali	pingasut-NNGUR-LAAR=TAR+NIQ<flertal<min<Absolut+LI
pingasunngunngitsutulli	pingasut-NNGUR-NNGIT+TUQ<ental<Aequalis+LI
pingasunngussagaluarpisi	pingasut-NNGUR-SSA=GALUAR<Interrogativ<I
pingasutununa	pingasut<Talord<Aequalis+UNA
pingasualli	pingasut<Talord<ental<deres+LI
piniartigit	pi+NIAR<Imperativ<ViDem
piniartigilli	pi+NIAR<Imperativ<ViDem+LI
piniartigillu	pi+NIAR<Imperativ<ViDem+LU
piniarpiuk	pi+NIAR<Interrogativ<DuHam
piniarlugilli	pi+NIAR<Ledsagemåde<dem+LI
piniarlugillu	pi+NIAR<Ledsagemåde<dem+LU
piniarlugu	pi+NIAR<Ledsagemåde<ham
piniarluguuna	pi+NIAR<Ledsagemåde<ham+UNA
piniarlunga	pi+NIAR<Ledsagemåde<mig
piniarlungaana	pi+NIAR<Ledsagemåde<mig+UNA
pinianngilagut	pi+NIAR=NNGIT<Indikativ<ViDem
pinianngiliuk	pi+NIAR=NNGIT<Interrogativ<DuHam
piniarnagillu	pi+NIAR=NNGIT<Ledsagemåde<dem+LU
piniarnagu	pi+NIAR=NNGIT<Ledsagemåde<ham
piniarnaguli	pi+NIAR=NNGIT<Ledsagemåde<ham+LI
piniarnangali	pi+NIAR=NNGIT<Ledsagemåde<mig+LI
pinngilassi	pi-NNGIT<Indikativ<JegJer
pinngilagut	pi-NNGIT<Indikativ<ViDem
pinngiliuk	pi-NNGIT<Interrogativ<DuHam
pinagillu	pi-NNGIT<Ledsagemåde<dem+LU
pinagu	pi-NNGIT<Ledsagemåde<ham
pinanga	pi-NNGIT<Ledsagemåde<mig
pisimatigit	pi+SIMA<Imperativ<ViDem
pisimatigilli	pi+SIMA<Imperativ<ViDem+LI
pisimatigillu	pi+SIMA<Imperativ<ViDem+LU
pisimatiginuna	pi+SIMA<Imperativ<ViDem+UNA
pisimavai	pi+SIMA<Indikativ<HanDem
pisimavaajuna	pi+SIMA<Indikativ<HanDem+UNA
pisimavagulli	pi+SIMA<Indikativ<ViDem+LI
pisimavagullu	pi+SIMA<Indikativ<ViDem+LU
pisimaviuk	pi+SIMA<Interrogativ<DuHam
pisimallugu	pi+SIMA<Ledsagemåde<ham
pisimallungali	pi+SIMA<Ledsagemåde<mig+LI
pisimasartigit	pi+SIMA=TAR<Imperativ<ViDem
pisimasartiginuna	pi+SIMA=TAR<Imperativ<ViDem+UNA
pisimasarpiuk	pi+SIMA=TAR<Interrogativ<DuHam
pisimasarlugit	pi+SIMA=TAR<Ledsagemåde<dem
pisimasarluginuna	pi+SIMA=TAR<Ledsagemåde<dem+UNA
pisinnaatigillu	pi+SINNAA<Imperativ<ViDem+LU
pisinnaavaannga	pi+SINNAA<Indikativ<DeMig
pisinnaavassiuna	pi+SINNAA<Indikativ<JegJer+UNA
pisinnaavagullu	pi+SINNAA<Indikativ<ViDem+LU
pisinnaaviuk	pi+SINNAA<Interrogativ<DuHam
pisinnaallungali	pi+SINNAA<Ledsagemåde<mig+LI
pissagaluartigit	pi-SSA=GALUAR<Imperativ<ViDem
pissagaluarpaa	pi-SSA=GALUAR<Indikativ<HanHam
pissagaluarpiuk	pi-SSA=GALUAR<Interrogativ<DuHam
pissagaluarlugillu	pi-SSA=GALUAR<Ledsagemåde<dem+LU
pissagaluarlugu	pi-SSA=GALUAR<Ledsagemåde<ham
pissatigilli	pi-SSA<Imperativ<ViDem+LI
pissatigillu	pi-SSA<Imperativ<ViDem+LU
pissavaa	pi-SSA<Indikativ<HanHam
pissavarsi	pi-SSA<Indikativ<I_Ham
pissavarsilu	pi-SSA<Indikativ<I_Ham+LU
pissallunga	pi-SSA<Ledsagemåde<mig
pisaraluartigilli	pi+TAR=GALUAR<Imperativ<ViDem+LI
pisaraluartiginuna	pi+TAR=GALUAR<Imperativ<ViDem+UNA
pisaraluarpaanngaana	pi+TAR=GALUAR<Indikativ<DeMig+UNA
pisaraluarparsi	pi+TAR=GALUAR<Indikativ<I_Ham
pisaraluarpakka	pi+TAR=GALUAR<Indikativ<JegDem
pisaraluarpassi	pi+TAR=GALUAR<Indikativ<JegJer
pisaraluarpagut	pi+TAR=GALUAR<Indikativ<ViDem
pisaraluarpiuk	pi+TAR=GALUAR<Interrogativ<DuHam
pisaraluarluginuna	pi+TAR=GALUAR<Ledsagemåde<dem+UNA
pisartigit	pi+TAR<Imperativ<ViDem
pisartigillu	pi+TAR<Imperativ<ViDem+LU
pisarparsi	pi+TAR<Indikativ<I_Ham
pisarpiuk	pi+TAR<Interrogativ<DuHam
pisarlunga	pi+TAR<Ledsagemåde<mig
Pituffik	Pituffik<Absolut
Pituffilli	Pituffik<Absolut+LI
Pituffillu	Pituffik<Absolut+LU
Pituffinguna	Pituffik<Absolut+UNA
Pituffimmik	Pituffik<Instrumentalis
Pituffimmilli	Pituffik<Instrumentalis+LI
Pituffimminguna	Pituffik<Instrumentalis+UNA
Pituffimmi	Pituffik<Lokalis
Pituffimmiissimasorli	Pituffik<Lokalis+IP+SIMA+TUQ+LI
Pituffimmili	Pituffik<Lokalis+LI
Pituffimmiumik	Pituffik+MIU<ental<Instrumentalis
Pituffimmiumilli	Pituffik+MIU<ental<Instrumentalis+LI
Pituffimmiumiinngilatit	Pituffik+MIU<ental<Lokalis+IP-NNGIT<Interrogativ<du
Pituffimmiumili	Pituffik+MIU<ental<Lokalis+LI
Pituffimmiumiuna	Pituffik+MIU<ental<Lokalis+UNA
Pituffimmiumukalertoqanngilarli	Pituffik+MIU<ental<Terminalis-KAR-LIR+TUQ-QAR-NNGIT<Indikativ<han+LI
Pituffimmiuni	Pituffik+MIU<flertal<Lokalis
Pituffimmiuniinniartorli	Pituffik+MIU<flertal<Lokalis+IP+NIAR+TUQ+LI
Pituffimmiulerigaluarpugut	Pituffik+MIU-LIRI+GALUAR<Indikativ<vi
Pituffimmiulerigaluarpisi	Pituffik+MIU-LIRI+GALUAR<Interrogativ<I
Pituffimmiunngorpulli	Pituffik+MIU-NNGUR<Indikativ<de+LI
Pituffimmiunngorpunga	Pituffik+MIU-NNGUR<Indikativ<jeg
Pituffimmiunngorsinnaanikka	Pituffik+MIU-NNGUR+SINNAA+NIQ<flertal<min<Absolut
Pituffimmiunngortuinnaa	Pituffik+MIU-NNGUR+TUQ-INNAQ<ental<hans<Absolut
Pituffimmioqarpoq	Pituffik+MIU-QAR<Indikativ<han
Pituffimmioqarneq	Pituffik+MIU-QAR+NIQ<ental<Absolut
Pituffimmioqarneruna	Pituffik+MIU-QAR+NIQ<ental<Absolut+UNA
Pituffimmioqartoq	Pituffik+MIU-QAR<Participium<han
Pituffimmioqartorlu	Pituffik+MIU-QAR<Participium<han+LU
Pituffimmioqartoq	Pituffik+MIU-QAR+TUQ<ental<Absolut
Pituffimmioqartorli	Pituffik+MIU-QAR+TUQ<ental<Absolut+LI
Pituffimmioqartorlu	Pituffik+MIU-QAR+TUQ<ental<Absolut+LU
Pituffimmioqartoruna	Pituffik+MIU-QAR+TUQ<ental<Absolut+UNA
Pituffimmiuujartortoqalaartarpungalu	Pituffik+MIU-U+GIARTUR+TUQ-QAR-LAAR=TAR<Indikativ<jeg+LU
Pituffimmiuuvoq	Pituffik+MIU-U<Indikativ<han
Pituffimmiuuit	Pituffik+MIU-U<Interrogativ<du
Pituffimmiuulaarpugullu	Pituffik+MIU-U-LAAR<Indikativ<vi+LU
Pituffimmiuulaartarnikka	Pituffik+MIU-U-LAAR=TAR+NIQ<flertal<min<Absolut
Pituffimmiuullunilu	Pituffik+MIU-U<Ledsagemåde<han_selv+LU
Pituffimmiuulerlutik	Pituffik+MIU-U-LIR<Ledsagemåde<de_selv
Pituffimmiuulernikkali	Pituffik+MIU-U-LIR+NIQ<flertal<min<Absolut+LI
Pituffimmiuuniartoqanngitsorli	Pituffik+MIU-U+NIAR+TUQ-QAR-NNGIT<Participium<han+LI
Pituffimmiuunikka	Pituffik+MIU-U+NIQ<flertal<min<Absolut
Pituffimmiuusimavit	Pituffik+MIU-U+SIMA<Interrogativ<du
Pituffimmiuusimasarnerat	Pituffik+MIU-U+SIMA=TAR+NIQ<ental<deres
Pituffimmiuusaraluarpunga	Pituffik+MIU-U+TAR=GALUAR<Indikativ<jeg
Pituffimmiuusaraluartunngortulli	Pituffik+MIU-U+TAR=GALUAR+TUQ-NNGUR<Participium<de+LI
Pituffimmukarpit	Pituffik<Terminalis-KAR<Interrogativ<du
Pituffimmukalerpununa	Pituffik<Terminalis-KAR-LIR<Indikativ<de+UNA
Pituffimmukalerneq	Pituffik<Terminalis-KAR-LIR+NIQ
Pituffimmulli	Pituffik<Terminalis+LI
Pituffimmullu	Pituffik<Terminalis+LU
Pituffimmununa	Pituffik<Terminalis+UNA
qaammalli	qaammat<ental<Absolut+LI
qaammallu	qaammat<ental<Absolut+LU
qaammanuna	qaammat<ental<Absolut+UNA
qaammataa	qaammat<ental<hans<Absolut
qaammammillu	qaammat<ental<Instrumentalis+LU
qaammamminguna	qaammat<ental<Instrumentalis+UNA
qaammammi	qaammat<ental<Lokalis
qaammammiippisi	qaammat<ental<Lokalis+IP<Interrogativ<I
qaammammiinngilangalu	qaammat<ental<Lokalis+IP-NNGIT<Indikativ<jeg+LU
qaammammilu	qaammat<ental<Lokalis+LU
qaammammut	qaammat<ental<Terminalis
qaammammukalaartartulli	qaammat<ental<Terminalis-KAR-LAAR=TAR<Participium<de+LI
qaammammukalertullu	qaammat<ental<Terminalis-KAR-LIR<Participium<de+LU
qaammammukanngillat	qaammat<ental<Terminalis-KAR-NNGIT<Indikativ<de
qaammammukanngilangaana	qaammat<ental<Terminalis-KAR-NNGIT<Indikativ<jeg+UNA
qaammammullu	qaammat<ental<Terminalis+LU
qaammatigiartortigillu	qaammat+GӘ+GIARTUR<Imperativ<ViDem+LU
qaammatigisimasarpiuk	qaammat+GӘ+SIMA=TAR<Interrogativ<DuHam
qaammataannaasaraluartoq	qaammat-INNAQ-U+TAR=GALUAR+TUQ<ental<Absolut
qaammatilerisinnaavoq	qaammat-LIRI+SINNAA<Indikativ<han
qaammatimiuusungali	qaammat+MIU-U<Participium<jeg+LI
qaammateqarpulli	qaammat-QAR<Indikativ<de+LI
qaammateqassagaluarpit	qaammat-QAR-SSA=GALUAR<Interrogativ<du
qaammateqassagaluarlutik	qaammat-QAR-SSA=GALUAR<Ledsagemåde<de_selv
qaammataannginnerinuna	qaammat-U-NNGIT+NIQ<flertal<Absolut+UNA
qallunaaq	qallunaaq<ental<Absolut
qallunaarli	qallunaaq<ental<Absolut+LI
qallunaarlu	qallunaaq<ental<Absolut+LU
qallunaami	qallunaaq<ental<Lokalis
qallunaa	qallunaaq<flertal<hans<Absolut
qallunaarigaluarlugit	qallunaaq+GӘ+GALUAR<Ledsagemåde<dem
qallunaaritiginuna	qallunaaq+GӘ<Imperativ<ViDem+UNA
qallunaariviuk	qallunaaq+GӘ<Interrogativ<DuHam
qallunaariniarlugu	qallunaaq+GӘ+NIAR<Ledsagemåde<ham
qallunaarissatiginuna	qallunaaq+GӘ-SSA<Imperativ<ViDem+UNA
qallunaarissaviuk	qallunaaq+GӘ-SSA<Interrogativ<DuHam
qallunaarissallugu	qallunaaq+GӘ-SSA<Ledsagemåde<ham
qallunaarisarpakka	qallunaaq+GӘ+TAR<Indikativ<JegDem
qallunaallilli	qallunaaq-LIK<flertal<Absolut+LI
qallunaallit	qallunaaq-LIK<flertal<Relativ
qallunaannguanillu	qallunaaq-NNGUAQ<flertal<Instrumentalis+LU
qallunaanngulaarporli	qallunaaq-NNGUR-LAAR<Indikativ<han+LI
qallunaanngulaartarneq	qallunaaq-NNGUR-LAAR=TAR+NIQ<ental<Absolut
qallunaanngulaartartorli	qallunaaq-NNGUR-LAAR=TAR+TUQ<ental<Absolut+LI
qallunaanngorsimasarnerlu	qallunaaq-NNGUR+SIMA=TAR+NIQ<ental<Absolut+LU
qallunaarpassuilli	qallunaaq+PASSUAQ<flertal<Absolut+LI
qallunaarpassuartulli	qallunaaq+PASSUAQ<flertal<Aequalis+LI
qallunaaqalertorli	qallunaaq-QAR-LIR+TUQ<ental<Absolut+LI
qallunaaqassagaluarpoq	qallunaaq-QAR-SSA=GALUAR<Indikativ<han
qallunaajugaluarpunga	qallunaaq-U+GALUAR<Indikativ<jeg
qallunaajusaraluarpununa	qallunaaq-U+TAR=GALUAR<Indikativ<de+UNA
qallunaajusunngui	qallunaaq-U+TUQ-NNGUAQ<flertal<hans<Absolut
qangali	qangali<Partikel
qangalili	qangali<Partikel+LI
qangalilu	qangali<Partikel+LU
qangaliuna	qangali<Partikel+UNA
qanga	qanga<Partikel
qangali	qanga<Partikel+LI
qangalu	qanga<Partikel+LU
qangaana	qanga<Partikel+UNA
Qaqortoq	Qaqortoq<Absolut
Qaqortumik	Qaqortoq<Instrumentalis
Qaqortumillu	Qaqortoq<Instrumentalis+LU
Qaqortumi	Qaqortoq<Lokalis
Qaqortumiissagaluartulli	Qaqortoq<Lokalis+IP-SSA=GALUAR<Participium<de+LI
Qaqortumiissallutik	Qaqortoq<Lokalis+IP-SSA<Ledsagemåde<de_selv
Qaqortumili	Qaqortoq<Lokalis+LI
Qaqortumiuna	Qaqortoq<Lokalis+UNA
Qaqortormiumik	Qaqortoq+MIU<ental<Instrumentalis
Qaqortormiuniinniarpit	Qaqortoq+MIU<flertal<Lokalis+IP+NIAR<Interrogativ<du
Qaqortormiunili	Qaqortoq+MIU<flertal<Lokalis+LI
Qaqortormiunilu	Qaqortoq+MIU<flertal<Lokalis+LU
Qaqortormiulerisarlunga	Qaqortoq+MIU-LIRI+TAR<Ledsagemåde<jeg
Qaqortormiulerisartut	Qaqortoq+MIU-LIRI+TAR<Participium<de
Qaqortormiunngulaarnerallu	Qaqortoq+MIU-NNGUR-LAAR+NIQ<ental<deres+LU
Qaqortormiunngulertut	Qaqortoq+MIU-NNGUR-LIR<Participium<de
Qaqortormioqarneq	Qaqortoq+MIU-QAR+NIQ<ental<Absolut
Qaqortormioqarnerli	Qaqortoq+MIU-QAR+NIQ<ental<Absolut+LI
Qaqortormioqartorlu	Qaqortoq+MIU-QAR<Participium<han+LU
Qaqortormiuujartortoq	Qaqortoq+MIU-U+GIARTUR+TUQ<ental<Absolut
Qaqortormiuuvunga	Qaqortoq+MIU-U<Indikativ<jeg
Qaqortormiuulerpugullu	Qaqortoq+MIU-U-LIR<Indikativ<vi+LU
Qaqortormiuulerlunili	Qaqortoq+MIU-U-LIR<Ledsagemåde<han_selv+LI
Qaqortormiuulertungalu	Qaqortoq+MIU-U-LIR<Participium<jeg+LU
Qaqortormiuusimanikkali	Qaqortoq+MIU-U+SIMA+NIQ<flertal<min<Absolut+LI
Qaqortormiuusaraluarpugununa	Qaqortoq+MIU-U+TAR=GALUAR<Indikativ<vi+UNA
Qaqortormiuusaraluartullu	Qaqortoq+MIU-U+TAR=GALUAR<Participium<de+LU
Qaqortormiuusarnikkalu	Qaqortoq+MIU-U+TAR+NIQ<flertal<min<Absolut+LU
Qaqortormiuusartormioqarnerlu	Qaqortoq+MIU-U+TAR+TUQ+MIU-QAR+NIQ<ental<Absolut+LU
Qaqortumukalaartoq	Qaqortoq<Terminalis-KAR-LAAR<Participium<han
Qaqortumukalaartarlutik	Qaqortoq<Terminalis-KAR-LAAR=TAR<Ledsagemåde<de_selv
Qaqortumukalertunga	Qaqortoq<Terminalis-KAR-LIR<Participium<jeg
Qaqortumukarniarpit	Qaqortoq<Terminalis-KAR+NIAR<Interrogativ<du
Qaqortumukassalluni	Qaqortoq<Terminalis-KAR-SSA<Ledsagemåde<han_selv
Qaqortumukassasunga	Qaqortoq<Terminalis-KAR-SSA<Participium<jeg
Qaqortumukartarpugulli	Qaqortoq<Terminalis-KAR+TAR<Indikativ<vi+LI
Qaqortumulli	Qaqortoq<Terminalis+LI
Qaqortumullu	Qaqortoq<Terminalis+LU
qarasaasiaq	qarasaasiaq<ental<Absolut
qarasaasiaruna	qarasaasiaq<ental<Absolut+UNA
qarasaasiatut	qarasaasiaq<ental<Aequalis
qarasaasiatulli	qarasaasiaq<ental<Aequalis+LI
qarasaasiamili	qarasaasiaq<ental<Lokalis+LI
qarasaasiara	qarasaasiaq<ental<min<Absolut
qarasaasiaa	qarasaasiaq<flertal<hans<Absolut
qarasaasiaali	qarasaasiaq<flertal<hans<Absolut+LI
qarasaasianilli	qarasaasiaq<flertal<Instrumentalis+LI
qarasaasiarigaluarlugilli	qarasaasiaq+GӘ+GALUAR<Ledsagemåde<dem+LI
qarasaasiarivaanngaana	qarasaasiaq+GӘ<Indikativ<DeMig+UNA
qarasaasiarisimasarpaanngaana	qarasaasiaq+GӘ+SIMA=TAR<Indikativ<DeMig+UNA
qarasaasiaannarmik	qarasaasiaq-INNAQ<ental<Instrumentalis
qarasaasiaannaallu	qarasaasiaq-INNAQ<flertal<Relativ+LU
qarasaasiaannaavugulli	qarasaasiaq-INNAQ-U<Indikativ<vi+LI
qarasaasiallinuna	qarasaasiaq-LIK<flertal<Relativ+UNA
qarasaasialerisunga	qarasaasiaq-LIRI<Participium<jeg
qarasaasialerisimasartoq	qarasaasiaq-LIRI+SIMA=TAR+TUQ<ental<Absolut
qarasaasiarmiuni	qarasaasiaq+MIU<flertal<Lokalis
qarasaasiarmiulerigaluarnikka	qarasaasiaq+MIU-LIRI+GALUAR+NIQ<flertal<min<Absolut
qarasaasiarmioqarnerli	qarasaasiaq+MIU-QAR+NIQ<ental<Absolut+LI
qarasaasiarmiuugaluarlunga	qarasaasiaq+MIU-U+GALUAR<Ledsagemåde<jeg
qarasaasiarmiuuppulli	qarasaasiaq+MIU-U<Indikativ<de+LI
qarasaasiarmiuusulli	qarasaasiaq+MIU-U<Participium<de+LI
qarasaasiarmiuusimavisi	qarasaasiaq+MIU-U+SIMA<Interrogativ<I
qarasaasiarmiuusimasarneq	qarasaasiaq+MIU-U+SIMA=TAR+NIQ<ental<Absolut
qarasaasianngualerivungalu	qarasaasiaq-NNGUAQ-LIRI<Indikativ<jeg+LU
qarasaasiannguugaluarluni	qarasaasiaq-NNGUAQ-U+GALUAR<Ledsagemåde<han_selv
qarasaasianngulaarlunga	qarasaasiaq-NNGUR-LAAR<Ledsagemåde<jeg
qarasaasianngortormiumukalaartartoq	qarasaasiaq-NNGUR+TUQ+MIU<ental<Terminalis-KAR-LAAR=TAR<Participium<han
qarasaasiarpassuilu	qarasaasiaq+PASSUAQ<flertal<hans<Absolut+LU
qarasaasiarpassuarnili	qarasaasiaq+PASSUAQ<flertal<Lokalis+LI
qarasaasiarpassuarnut	qarasaasiaq+PASSUAQ<flertal<Terminalis
qarasaasiaqalaartarlungalu	qarasaasiaq-QAR-LAAR=TAR<Ledsagemåde<jeg+LU
qarasaasiaassagaluarlutilli	qarasaasiaq-U-SSA=GALUAR<Ledsagemåde<de_selv+LI
Qasigiannguit	Qasigiannguit<Absolut
Qasigiannguilli	Qasigiannguit<Absolut+LI
Qasigiannguillu	Qasigiannguit<Absolut+LU
Qasigiannguinuna	Qasigiannguit<Absolut+UNA
Qasigiannguanik	Qasigiannguit<Instrumentalis
Qasigiannguanilli	Qasigiannguit<Instrumentalis+LI
Qasigiannguani	Qasigiannguit<Lokalis
Qasigiannguaniittartunga	Qasigiannguit<Lokalis+IP+TAR<Participium<jeg
Qasigiannguanilu	Qasigiannguit<Lokalis+LU
Qasigiannguarmiumukanngitsorlu	Qasigiannguit+MIU<ental<Terminalis-KAR-NNGIT+TUQ<ental<Absolut+LU
Qasigiannguarmiuni	Qasigiannguit+MIU<flertal<Lokalis
Qasigiannguarmiunili	Qasigiannguit+MIU<flertal<Lokalis+LI
Qasigiannguarmiulerissagaluarpugullu	Qasigiannguit+MIU-LIRI-SSA=GALUAR<Indikativ<vi+LU
Qasigiannguarmiunngorpunga	Qasigiannguit+MIU-NNGUR<Indikativ<jeg
Qasigiannguarmiunngorpugununa	Qasigiannguit+MIU-NNGUR<Indikativ<vi+UNA
Qasigiannguarmioqarneq	Qasigiannguit+MIU-QAR+NIQ<ental<Absolut
Qasigiannguarmioqarnerlu	Qasigiannguit+MIU-QAR+NIQ<ental<Absolut+LU
Qasigiannguarmioqartoq	Qasigiannguit+MIU-QAR<Participium<han
Qasigiannguarmioqartorlu	Qasigiannguit+MIU-QAR<Participium<han+LU
Qasigiannguarmiuusimavungalu	Qasigiannguit+MIU-U+SIMA<Indikativ<jeg+LU
Qasigiannguarmiuussagaluarluni	Qasigiannguit+MIU-U-SSA=GALUAR<Ledsagemåde<han_selv
Qasigiannguanut	Qasigiannguit<Terminalis
Qasigiannguanukalerlutinguna	Qasigiannguit<Terminalis-KAR-LIR<Ledsagemåde<de_selv+UNA
Qasigiannguanununa	Qasigiannguit<Terminalis+UNA
qatanngulli	qatanngut<ental<Absolut+LI
qatanngullu	qatanngut<ental<Absolut+LU
qatanngununa	qatanngut<ental<Absolut+UNA
qatanngummillu	qatanngut<ental<Instrumentalis+LU
qatanngumminguna	qatanngut<ental<Instrumentalis+UNA
qatanngummi	qatanngut<ental<Lokalis
qatanngummiippulli	qatanngut<ental<Lokalis+IP<Indikativ<de+LI
qatanngummiippoq	qatanngut<ental<Lokalis+IP<Indikativ<han
qatanngummiilaartarnerli	qatanngut<ental<Lokalis+IP-LAAR=TAR+NIQ+LI
qatanngummili	qatanngut<ental<Lokalis+LI
qatanngummilu	qatanngut<ental<Lokalis+LU
qatanngummut	qatanngut<ental<Terminalis
qatanngummukalaartarlungali	qatanngut<ental<Terminalis-KAR-LAAR=TAR<Ledsagemåde<jeg+LI
qatanngummukalerlutik	qatanngut<ental<Terminalis-KAR-LIR<Ledsagemåde<de_selv
qatanngummukannginneq	qatanngut<ental<Terminalis-KAR-NNGIT+NIQ<ental<Absolut
qatanngummukassagaluartunga	qatanngut<ental<Terminalis-KAR-SSA=GALUAR<Participium<jeg
qatanngummukassallungali	qatanngut<ental<Terminalis-KAR-SSA<Ledsagemåde<jeg+LI
qatanngummulli	qatanngut<ental<Terminalis+LI
qatanngummununa	qatanngut<ental<Terminalis+UNA
qatanngutai	qatanngut<flertal<hans<Absolut
qatanngutaajuna	qatanngut<flertal<hans<Absolut+UNA
qatanngutigivaallu	qatanngut+GӘ<Indikativ<DeDem+LU
qatanngutigissatigillu	qatanngut+GӘ-SSA<Imperativ<ViDem+LU
qatanngutillilli	qatanngut-LIK<flertal<Absolut+LI
qatanngutillinuna	qatanngut-LIK<flertal<Relativ+UNA
qatanngutimiuunikka	qatanngut+MIU-U+NIQ<flertal<min<Absolut
qatanngutinngua	qatanngut-NNGUAQ<ental<hans<Absolut
qatanngutinnguuvungali	qatanngut-NNGUAQ-U<Indikativ<jeg+LI
qatannguterpassuit	qatanngut+PASSUAQ<flertal<Absolut
Qeqertarsuaq	Qeqertarsuaq<Absolut
Qeqertarsuarli	Qeqertarsuaq<Absolut+LI
Qeqertarsuarlu	Qeqertarsuaq<Absolut+LU
Qeqertarsuaruna	Qeqertarsuaq<Absolut+UNA
Qeqertarsuarmik	Qeqertarsuaq<Instrumentalis
Qeqertarsuarmilli	Qeqertarsuaq<Instrumentalis+LI
Qeqertarsuarmillu	Qeqertarsuaq<Instrumentalis+LU
Qeqertarsuarminguna	Qeqertarsuaq<Instrumentalis+UNA
Qeqertarsuarmi	Qeqertarsuaq<Lokalis
Qeqertarsuarmiilerlutik	Qeqertarsuaq<Lokalis+IP-LIR<Ledsagemåde<de_selv
Qeqertarsuarmiittullu	Qeqertarsuaq<Lokalis+IP<Participium<de+LU
Qeqertarsuarmili	Qeqertarsuaq<Lokalis+LI
Qeqertarsuarmilu	Qeqertarsuaq<Lokalis+LU
Qeqertarsuarmiuna	Qeqertarsuaq<Lokalis+UNA
Qeqertarsuarmiumik	Qeqertarsuaq+MIU<ental<Instrumentalis
Qeqertarsuarmiuminguna	Qeqertarsuaq+MIU<ental<Instrumentalis+UNA
Qeqertarsuarmiumi	Qeqertarsuaq+MIU<ental<Lokalis
Qeqertarsuarmiuniikkaluartoqanngilarlu	Qeqertarsuaq+MIU<flertal<Lokalis+IP+GALUAR+TUQ-QAR-NNGIT<Indikativ<han+LU
Qeqertarsuarmiuniilaartunga	Qeqertarsuaq+MIU<flertal<Lokalis+IP-LAAR<Participium<jeg
Qeqertarsuarmiuniinnatik	Qeqertarsuaq+MIU<flertal<Lokalis+IP-NNGIT<Ledsagemåde<de_selv
Qeqertarsuarmiulerivit	Qeqertarsuaq+MIU-LIRI<Interrogativ<du
Qeqertarsuarmiulerisimasarpulli	Qeqertarsuaq+MIU-LIRI+SIMA=TAR<Indikativ<de+LI
Qeqertarsuarmiunngorpulli	Qeqertarsuaq+MIU-NNGUR<Indikativ<de+LI
Qeqertarsuarmiunngorniarpungali	Qeqertarsuaq+MIU-NNGUR+NIAR<Indikativ<jeg+LI
Qeqertarsuarmioqarnerli	Qeqertarsuaq+MIU-QAR+NIQ<ental<Absolut+LI
Qeqertarsuarmioqarneruna	Qeqertarsuaq+MIU-QAR+NIQ<ental<Absolut+UNA
Qeqertarsuarmioqartorlu	Qeqertarsuaq+MIU-QAR<Participium<han+LU
Qeqertarsuarmioqartoq	Qeqertarsuaq+MIU-QAR+TUQ<ental<Absolut
Qeqertarsuarmioqartorli	Qeqertarsuaq+MIU-QAR+TUQ<ental<Absolut+LI
Qeqertarsuarmioqartoruna	Qeqertarsuaq+MIU-QAR+TUQ<ental<Absolut+UNA
Qeqertarsuarmiuujartorluni	Qeqertarsuaq+MIU-U+GIARTUR<Ledsagemåde<han_selv
Qeqertarsuarmiuujartortoq	Qeqertarsuaq+MIU-U+GIARTUR+TUQ<ental<Absolut
Qeqertarsuarmiuuvorlu	Qeqertarsuaq+MIU-U<Indikativ<han+LU
Qeqertarsuarmiuulaarpungalu	Qeqertarsuaq+MIU-U-LAAR<Indikativ<jeg+LU
Qeqertarsuarmiuulaartarnikka	Qeqertarsuaq+MIU-U-LAAR=TAR+NIQ<flertal<min<Absolut
Qeqertarsuarmiuulluni	Qeqertarsuaq+MIU-U<Ledsagemåde<han_selv
Qeqertarsuarmiuullunilu	Qeqertarsuaq+MIU-U<Ledsagemåde<han_selv+LU
Qeqertarsuarmiuuniarnanga	Qeqertarsuaq+MIU-U+NIAR=NNGIT<Ledsagemåde<jeg
Qeqertarsuarmiuuniannginneraana	Qeqertarsuaq+MIU-U+NIAR=NNGIT+NIQ<ental<hans<Absolut+UNA
Qeqertarsuarmiuunangalu	Qeqertarsuaq+MIU-U-NNGIT<Ledsagemåde<jeg+LU
Qeqertarsuarmiuusimasarpugulli	Qeqertarsuaq+MIU-U+SIMA=TAR<Indikativ<vi+LI
Qeqertarsuarmiuusaraluarlutik	Qeqertarsuaq+MIU-U+TAR=GALUAR<Ledsagemåde<de_selv
Qeqertarsuarmiuusaraluartorali	Qeqertarsuaq+MIU-U+TAR=GALUAR+TUQ<ental<min<Absolut+LI
Qeqertarsuarmiuusartunga	Qeqertarsuaq+MIU-U+TAR<Participium<jeg
Qeqertarsuarmut	Qeqertarsuaq<Terminalis
Qeqertarsuarmukalaartorlu	Qeqertarsuaq<Terminalis-KAR-LAAR<Participium<han+LU
Qeqertarsuarmukalaartarput	Qeqertarsuaq<Terminalis-KAR-LAAR=TAR<Indikativ<de
Qeqertarsuarmukalaartarpugut	Qeqertarsuaq<Terminalis-KAR-LAAR=TAR<Indikativ<vi
Qeqertarsuarmukassagaluarpisi	Qeqertarsuaq<Terminalis-KAR-SSA=GALUAR<Interrogativ<I
Qeqertarsuarmukassagaluartut	Qeqertarsuaq<Terminalis-KAR-SSA=GALUAR<Participium<de
Qeqertarsuarmukassaanga	Qeqertarsuaq<Terminalis-KAR-SSA<Indikativ<jeg
Qeqertarsuarmukassavisi	Qeqertarsuaq<Terminalis-KAR-SSA<Interrogativ<I
Qeqertarsuarmulli	Qeqertarsuaq<Terminalis+LI
Qeqertarsuarmullu	Qeqertarsuaq<Terminalis+LU
Qeqertarsuarmununa	Qeqertarsuaq<Terminalis+UNA
sammisarigaluartigilli	sammisarә+GALUAR<Imperativ<ViDem+LI
sammisarigaluartigillu	sammisarә+GALUAR<Imperativ<ViDem+LU
sammisarigaluartiginuna	sammisarә+GALUAR<Imperativ<ViDem+UNA
sammisarigaluarpassi	sammisarә+GALUAR<Indikativ<JegJer
sammisarigaluarpiuk	sammisarә+GALUAR<Interrogativ<DuHam
sammisarigaluarlunga	sammisarә+GALUAR<Ledsagemåde<mig
sammisariartorpiuk	sammisarә+GIARTUR<Interrogativ<DuHam
sammisariartorlugu	sammisarә+GIARTUR<Ledsagemåde<ham
sammisariartorlungalu	sammisarә+GIARTUR<Ledsagemåde<mig+LU
sammisarivarsi	sammisarә<Indikativ<I_Ham
sammisarivassili	sammisarә<Indikativ<JegJer+LI
sammisariviuk	sammisarә<Interrogativ<DuHam
sammisarilaartigilli	sammisarә-LAAR<Imperativ<ViDem+LI
sammisarilaartigillu	sammisarә-LAAR<Imperativ<ViDem+LU
sammisarilaartiginuna	sammisarә-LAAR<Imperativ<ViDem+UNA
sammisarilaarpiuk	sammisarә-LAAR<Interrogativ<DuHam
sammisarilaarlunga	sammisarә-LAAR<Ledsagemåde<mig
sammisarilaartartigilli	sammisarә-LAAR=TAR<Imperativ<ViDem+LI
sammisarilaartartiginuna	sammisarә-LAAR=TAR<Imperativ<ViDem+UNA
sammisarilaartarlugu	sammisarә-LAAR=TAR<Ledsagemåde<ham
sammisarilaartarlugulu	sammisarә-LAAR=TAR<Ledsagemåde<ham+LU
sammisaralungali	sammisarә<Ledsagemåde<mig+LI
sammisaralungalu	sammisarә<Ledsagemåde<mig+LU
sammisarilerpakkaana	sammisarә-LIR<Indikativ<JegDem+UNA
sammisarilerpiuk	sammisarә-LIR<Interrogativ<DuHam
sammisariniarpassili	sammisarә+NIAR<Indikativ<JegJer+LI
sammisariniarpiuk	sammisarә+NIAR<Interrogativ<DuHam
sammisarinianngilakkaana	sammisarә+NIAR=NNGIT<Indikativ<JegDem+UNA
sammisarinianngiliuk	sammisarә+NIAR=NNGIT<Interrogativ<DuHam
sammisariniarnaginuna	sammisarә+NIAR=NNGIT<Ledsagemåde<dem+UNA
sammisariniarnagu	sammisarә+NIAR=NNGIT<Ledsagemåde<ham
sammisariniarnagulu	sammisarә+NIAR=NNGIT<Ledsagemåde<ham+LU
sammisariniarnaguuna	sammisarә+NIAR=NNGIT<Ledsagemåde<ham+UNA
sammisarinngilarsi	sammisarә-NNGIT<Indikativ<I_Ham
sammisarinnginaguuna	sammisarә-NNGIT<Ledsagemåde<ham+UNA
sammisarilara	sammisarә<Optativ<JegHam
sammisarilarali	sammisarә<Optativ<JegHam+LI
sammisarilaralu	sammisarә<Optativ<JegHam+LU
sammisarisimatigit	sammisarә+SIMA<Imperativ<ViDem
sammisarisimatigilli	sammisarә+SIMA<Imperativ<ViDem+LI
sammisarisimavakka	sammisarә+SIMA<Indikativ<JegDem
sammisarisimavagut	sammisarә+SIMA<Indikativ<ViDem
sammisarisimallugillu	sammisarә+SIMA<Ledsagemåde<dem+LU
sammisarisimallunga	sammisarә+SIMA<Ledsagemåde<mig
sammisarisimasartigilli	sammisarә+SIMA=TAR<Imperativ<ViDem+LI
sammisarisimasarpiuk	sammisarә+SIMA=TAR<Interrogativ<DuHam
sammisarisimasarlugilli	sammisarә+SIMA=TAR<Ledsagemåde<dem+LI
sammisarisimasarluguli	sammisarә+SIMA=TAR<Ledsagemåde<ham+LI
sammisarisinnaatiginuna	sammisarә+SINNAA<Imperativ<ViDem+UNA
sammisarisinnaaviuk	sammisarә+SINNAA<Interrogativ<DuHam
sammisarisinnaalluguuna	sammisarә+SINNAA<Ledsagemåde<ham+UNA
sammisarisinnaallunga	sammisarә+SINNAA<Ledsagemåde<mig
sammisarissagaluarpassi	sammisarә-SSA=GALUAR<Indikativ<JegJer
sammisarissatigit	sammisarә-SSA<Imperativ<ViDem
sammisarissatigilli	sammisarә-SSA<Imperativ<ViDem+LI
sammisarissavarsi	sammisarә-SSA<Indikativ<I_Ham
sammisarisaraluartigit	sammisarә+TAR=GALUAR<Imperativ<ViDem
sammisarisaraluarpassi	sammisarә+TAR=GALUAR<Indikativ<JegJer
sammisarisaraluarpiuk	sammisarә+TAR=GALUAR<Interrogativ<DuHam
sammisarisarpaannga	sammisarә+TAR<Indikativ<DeMig
sammisarisarpaanngali	sammisarә+TAR<Indikativ<DeMig+LI
sammisarisarpiuk	sammisarә+TAR<Interrogativ<DuHam
sammisarisarlugit	sammisarә+TAR<Ledsagemåde<dem
sammisarisassagaluarpiuk	sammisarә+TAR=SSA=GALUAR<Interrogativ<DuHam
sammisarisassagaluarluginuna	sammisarә+TAR=SSA=GALUAR<Ledsagemåde<dem+UNA
sammisarisassatigilli	sammisarә+TAR=SSA<Imperativ<ViDem+LI
sinneraluartigillu	sinner+GALUAR<Imperativ<ViDem+LU
sinneraluartiginuna	sinner+GALUAR<Imperativ<ViDem+UNA
sinnerpai	sinner<Indikativ<HanDem
sinnerpiuk	sinner<Interrogativ<DuHam
sinnilaarpaanngali	sinner-LAAR<Indikativ<DeMig+LI
sinnilaarpassi	sinner-LAAR<Indikativ<JegJer
sinnilaarlungali	sinner-LAAR<Ledsagemåde<mig+LI
sinnilaartarlungaana	sinner-LAAR=TAR<Ledsagemåde<mig+UNA
sinnilerluginuna	sinner-LIR<Ledsagemåde<dem+UNA
sinnerniartigilli	sinner+NIAR<Imperativ<ViDem+LI
sinnernianngilassi	sinner+NIAR=NNGIT<Indikativ<JegJer
sinnerniarnagu	sinner+NIAR=NNGIT<Ledsagemåde<ham
sinninngilaajuna	sinner-NNGIT<Indikativ<HanHam+UNA
sinninngilarsi	sinner-NNGIT<Indikativ<I_Ham
sinnissagaluartiginuna	sinner-SSA=GALUAR<Imperativ<ViDem+UNA
sinnissagaluarpakka	sinner-SSA=GALUAR<Indikativ<JegDem
sinnissatigillu	sinner-SSA<Imperativ<ViDem+LU
sisamaannaali	sisamat-INNAQ<flertal<hans<Absolut+LI
sisamaannarni	sisamat-INNAQ<flertal<Lokalis
sisamaannakkaana	sisamat-INNAQ<flertal<min<Absolut+UNA
sisamaannaat	sisamat-INNAQ<flertal<Relativ
sisamaannaanuna	sisamat-INNAQ<flertal<Relativ+UNA
sisamaannanngulaarpisi	sisamat-INNAQ-NNGUR-LAAR<Interrogativ<I
sisamaannanngornianngillalli	sisamat-INNAQ-NNGUR+NIAR=NNGIT<Indikativ<de+LI
sisamaannanngorsinnaasoq	sisamat-INNAQ-NNGUR+SINNAA+TUQ<ental<Absolut
sisamaannanngussasunga	sisamat-INNAQ-NNGUR-SSA<Participium<jeg
sisamanngoriartortuunanga	sisamat-NNGUR+GIARTUR+TUQ-U-NNGIT<Ledsagemåde<jeg
sisamanngulerlungalu	sisamat-NNGUR-LIR<Ledsagemåde<jeg+LU
sisamanngorsimasarpungali	sisamat-NNGUR+SIMA=TAR<Indikativ<jeg+LI
sisamaat	sisamat<Talord<ental<deres
sisamallu	sisamat<Talord<flertal<Absolut+LU
sisamani	sisamat<Talord<Lokalis
Sisimiut	Sisimiut<Absolut
Sisimiulli	Sisimiut<Absolut+LI
Sisimiullu	Sisimiut<Absolut+LU
Sisimiununa	Sisimiut<Absolut+UNA
Sisimiunik	Sisimiut<Instrumentalis
Sisimiunilli	Sisimiut<Instrumentalis+LI
Sisimiuninguna	Sisimiut<Instrumentalis+UNA
Sisimiuni	Sisimiut<Lokalis
Sisimiuniilerpugulli	Sisimiut<Lokalis+IP-LIR<Indikativ<vi+LI
Sisimiunili	Sisimiut<Lokalis+LI
Sisimiunilu	Sisimiut<Lokalis+LU
Sisimiormiu	Sisimiut+MIU<ental<Absolut
Sisimiormiuli	Sisimiut+MIU<ental<Absolut+LI
Sisimiormiumik	Sisimiut+MIU<ental<Instrumentalis
Sisimiormiumillu	Sisimiut+MIU<ental<Instrumentalis+LU
Sisimiormiumi	Sisimiut+MIU<ental<Lokalis
Sisimiormiumut	Sisimiut+MIU<ental<Terminalis
Sisimiormiumununa	Sisimiut+MIU<ental<Terminalis+UNA
Sisimiormiunilli	Sisimiut+MIU<flertal<Instrumentalis+LI
Sisimiormiuninguna	Sisimiut+MIU<flertal<Instrumentalis+UNA
Sisimiormiuni	Sisimiut+MIU<flertal<Lokalis
Sisimiormiulerigaluartungali	Sisimiut+MIU-LIRI+GALUAR<Participium<jeg+LI
Sisimiormiuleriartorpisi	Sisimiut+MIU-LIRI+GIARTUR<Interrogativ<I
Sisimiormiulerisimanikkali	Sisimiut+MIU-LIRI+SIMA+NIQ<flertal<min<Absolut+LI
Sisimiormiunngoraluarlutilli	Sisimiut+MIU-NNGUR+GALUAR<Ledsagemåde<de_selv+LI
Sisimiormiunngoriartortoq	Sisimiut+MIU-NNGUR+GIARTUR<Participium<han
Sisimiormiunngorniartullu	Sisimiut+MIU-NNGUR+NIAR<Participium<de+LU
Sisimiormiunngornanilu	Sisimiut+MIU-NNGUR-NNGIT<Ledsagemåde<han_selv+LU
Sisimiormiunngortoq	Sisimiut+MIU-NNGUR<Participium<han
Sisimiormiunngorsimasarlunga	Sisimiut+MIU-NNGUR+SIMA=TAR<Ledsagemåde<jeg
Sisimiormiunngussallunilu	Sisimiut+MIU-NNGUR-SSA<Ledsagemåde<han_selv+LU
Sisimiormiunngussasullu	Sisimiut+MIU-NNGUR-SSA<Participium<de+LU
Sisimiormiunngussasorli	Sisimiut+MIU-NNGUR-SSA<Participium<han+LI
Sisimiormioqarpoq	Sisimiut+MIU-QAR<Indikativ<han
Sisimiormioqarneq	Sisimiut+MIU-QAR+NIQ<ental<Absolut
Sisimiormioqarnerli	Sisimiut+MIU-QAR+NIQ<ental<Absolut+LI
Sisimiormioqarnerlu	Sisimiut+MIU-QAR+NIQ<ental<Absolut+LU
Sisimiormioqartoq	Sisimiut+MIU-QAR<Participium<han
Sisimiormioqartorli	Sisimiut+MIU-QAR+TUQ<ental<Absolut+LI
Sisimiormioqartorlu	Sisimiut+MIU-QAR+TUQ<ental<Absolut+LU
Sisimiormioqartoruna	Sisimiut+MIU-QAR+TUQ<ental<Absolut+UNA
Sisimiormiuugaluarnikka	Sisimiut+MIU-U+GALUAR+NIQ<flertal<min<Absolut
Sisimiormiuuit	Sisimiut+MIU-U<Interrogativ<du
Sisimiormiuulaartartorpassui	Sisimiut+MIU-U-LAAR=TAR+TUQ+PASSUAQ<flertal<hans<Absolut
Sisimiormiuullutik	Sisimiut+MIU-U<Ledsagemåde<de_selv
Sisimiormiuulerpisi	Sisimiut+MIU-U-LIR<Interrogativ<I
Sisimiormiuulerlunga	Sisimiut+MIU-U-LIR<Ledsagemåde<jeg
Sisimiormiuulernikka	Sisimiut+MIU-U-LIR+NIQ<flertal<min<Absolut
Sisimiormiuunianngilatit	Sisimiut+MIU-U+NIAR=NNGIT<Interrogativ<du
Sisimiormiuuniannginnikka	Sisimiut+MIU-U+NIAR=NNGIT+NIQ<flertal<min<Absolut
Sisimiormiuusimavunga	Sisimiut+MIU-U+SIMA<Indikativ<jeg
Sisimiormiuusimasorli	Sisimiut+MIU-U+SIMA<Participium<han+LI
Sisimiormiuusimasarlunga	Sisimiut+MIU-U+SIMA=TAR<Ledsagemåde<jeg
Sisimiormiuusimasartunga	Sisimiut+MIU-U+SIMA=TAR<Participium<jeg
Sisimiormiuussavisi	Sisimiut+MIU-U-SSA<Interrogativ<I
Sisimiormiuussalluni	Sisimiut+MIU-U-SSA<Ledsagemåde<han_selv
Sisimiormiuusaraluarlunga	Sisimiut+MIU-U+TAR=GALUAR<Ledsagemåde<jeg
Sisimiormiuusaraluarnikka	Sisimiut+MIU-U+TAR=GALUAR+NIQ<flertal<min<Absolut
Sisimiormiuusartoqassagaluartukka	Sisimiut+MIU-U+TAR+TUQ-QAR-SSA=GALUAR+TUQ<flertal<min<Absolut
Sisimiormiuusunnguiuna	Sisimiut+MIU-U+TUQ-NNGUAQ<flertal<hans<Absolut+UNA
Sisimiormiuusunngorlutinguna	Sisimiut+MIU-U+TUQ-NNGUR<Ledsagemåde<de_selv+UNA
Sisimiormiuusoqanngilanga	Sisimiut+MIU-U+TUQ-QAR-NNGIT<Indikativ<jeg
Sisimiunut	Sisimiut<Terminalis
Sisimiunukalaartarlunga	Sisimiut<Terminalis-KAR-LAAR=TAR<Ledsagemåde<jeg
Sisimiunukanngitsunga	Sisimiut<Terminalis-KAR-NNGIT<Participium<jeg
Sisimiunukassagaluarluni	Sisimiut<Terminalis-KAR-SSA=GALUAR<Ledsagemåde<han_selv
Sisimiunukassasulli	Sisimiut<Terminalis-KAR-SSA<Participium<de+LI
Sisimiunulli	Sisimiut<Terminalis+LI
Sisimiunununa	Sisimiut<Terminalis+UNA
siulleq	siulleq<ental<Absolut
siulliaana	siulleq<ental<hans<Absolut+UNA
siulliit	siulleq<flertal<Relativ
siulliilli	siulleq<flertal<Relativ+LI
siulliinnaat	siulleq-INNAQ<ental<deres<Absolut
siulliinnaauna	siulleq-INNAQ<flertal<hans<Absolut+UNA
siullillinuna	siulleq-LIK<flertal<Relativ+UNA
siullermiuunerali	siulleq+MIU-U+NIQ<ental<hans<Absolut+LI
siullinnguaminguna	siulleq-NNGUAQ<ental<Instrumentalis+UNA
siullinnguuniartulli	siulleq-NNGUAQ-U+NIAR<Participium<de+LI
siullinnguusimasarpit	siulleq-NNGUAQ-U+SIMA=TAR<Interrogativ<du
siullinnguusunngortaraluarnerillu	siulleq-NNGUAQ-U+TUQ-NNGUR+TAR=GALUAR+NIQ<flertal<Relativ+LU
siullinngulaartarput	siulleq-NNGUR-LAAR=TAR<Indikativ<de
siullinngulaartartunga	siulleq-NNGUR-LAAR=TAR<Participium<jeg
siullinngornerilu	siulleq-NNGUR+NIQ<flertal<hans<Absolut+LU
siulleqalaarpit	siulleq-QAR-LAAR<Interrogativ<du
siulleqalaartarpunga	siulleq-QAR-LAAR=TAR<Indikativ<jeg
siulleqalaartartunga	siulleq-QAR-LAAR=TAR<Participium<jeg
siulleqarlunga	siulleq-QAR<Ledsagemåde<jeg
siulleqalernikkali	siulleq-QAR-LIR+NIQ<flertal<min<Absolut+LI
siulleqassagaluarlungalu	siulleq-QAR-SSA=GALUAR<Ledsagemåde<jeg+LU
siulleqassaangalu	siulleq-QAR-SSA<Indikativ<jeg+LU
siulliusinnaasullu	siulleq-U+SINNAA<Participium<de+LU
suligaluarput	suli+GALUAR<Indikativ<de
suligaluarpisi	suli+GALUAR<Interrogativ<I
suligaluarneranuna	suli+GALUAR+NIQ<ental<deres+UNA
suligaluartunga	suli+GALUAR<Participium<jeg
suliartorporli	suli+GIARTUR<Indikativ<han+LI
suliartorlutinguna	suli+GIARTUR<Ledsagemåde<de_selv+UNA
suliartorluni	suli+GIARTUR<Ledsagemåde<han_selv
suliartornikka	suli+GIARTUR+NIQ<flertal<min<Absolut
suliartortuinnaqassaangaana	suli+GIARTUR+TUQ-INNAQ-QAR-SSA<Indikativ<jeg+UNA
suliartortuulertuuisi	suli+GIARTUR+TUQ-U-LIR+TUQ-U<Interrogativ<I
sulivunga	suli<Indikativ<jeg
sulivugut	suli<Indikativ<vi
sulivit	suli<Interrogativ<du
sulilaartarpulli	suli-LAAR=TAR<Indikativ<de+LI
sulilaartarpunga	suli-LAAR=TAR<Indikativ<jeg
sulilaartarnikkali	suli-LAAR=TAR+NIQ<flertal<min<Absolut+LI
sulilaartoqassagaluarluniuna	suli-LAAR+TUQ-QAR-SSA=GALUAR<Ledsagemåde<han_selv+UNA
sulilaartuussallunili	suli-LAAR+TUQ-U-SSA<Ledsagemåde<han_selv+LI
sulillutillu	suli<Ledsagemåde<de_selv+LU
sulilluni	suli<Ledsagemåde<han_selv
sulilerpununa	suli-LIR<Indikativ<de+UNA
sulilerpoq	suli-LIR<Indikativ<han
sulilernerit	suli-LIR+NIQ<flertal<Relativ
sulilertulli	suli-LIR<Participium<de+LI
suliniarpununa	suli+NIAR<Indikativ<de+UNA
suliniarlunga	suli+NIAR<Ledsagemåde<jeg
suliniarnertununa	suli+NIAR+NIQ<ental<Aequalis+UNA
suliniannginnerilu	suli+NIAR=NNGIT+NIQ<flertal<hans<Absolut+LU
sulinianngitsunga	suli+NIAR=NNGIT<Participium<jeg
suliniartunngui	suli+NIAR+TUQ-NNGUAQ<flertal<hans<Absolut
sulineralu	suli+NIQ<ental<hans<Absolut+LU
sulinerilu	suli+NIQ<flertal<hans<Absolut+LU
sulinikka	suli+NIQ<flertal<min<Absolut
sulinikkali	suli+NIQ<flertal<min<Absolut+LI
sulinikkalu	suli+NIQ<flertal<min<Absolut+LU
sulinatik	suli-NNGIT<Ledsagemåde<de_selv
sulinngitsoq	suli-NNGIT+TUQ<ental<Absolut
SULI	SULI<Partikel
SULIli	SULI<Partikel+LI
SULIlu	SULI<Partikel+LU
SULIuna	SULI<Partikel+UNA
sulisimavit	suli+SIMA<Interrogativ<du
sulisimasarnerilli	suli+SIMA=TAR+NIQ<flertal<Absolut+LI
sulisimasarnerinuna	suli+SIMA=TAR+NIQ<flertal<Absolut+UNA
sulisimasartoriartorpiuk	suli+SIMA=TAR+TUQ+GӘ+GIARTUR<Interrogativ<DuHam
sulisinnaavugullu	suli+SINNAA<Indikativ<vi+LU
sulissagaluarpit	suli-SSA=GALUAR<Interrogativ<du
sulissagaluarlutinguna	suli-SSA=GALUAR<Ledsagemåde<de_selv+UNA
sulissavit	suli-SSA<Interrogativ<du
sulisaraluarpunga	suli+TAR=GALUAR<Indikativ<jeg
sulisaraluarpit	suli+TAR=GALUAR<Interrogativ<du
sulisaraluartullu	suli+TAR=GALUAR<Participium<de+LU
sulisaraluartumi	suli+TAR=GALUAR+TUQ<ental<Lokalis
sulisaraluartoqassagaluartoq	suli+TAR=GALUAR+TUQ-QAR-SSA=GALUAR<Participium<han
sulisarpugulli	suli+TAR<Indikativ<vi+LI
sulisarpugullu	suli+TAR<Indikativ<vi+LU
sulisarpit	suli+TAR<Interrogativ<du
sulisarnerit	suli+TAR+NIQ<flertal<Relativ
sulisartuunianngitsoqalerpisi	suli+TAR+TUQ-U+NIAR=NNGIT+TUQ-QAR-LIR<Interrogativ<I
sulisoq	suli+TUQ<ental<Absolut
sulisullilli	suli+TUQ-LIK<flertal<Absolut+LI
sulisuleriniarnatik	suli+TUQ-LIRI+NIAR=NNGIT<Ledsagemåde<de_selv
sulisormiuninguna	suli+TUQ+MIU<flertal<Instrumentalis+UNA
sulisuugaluartua	suli+TUQ-U+GALUAR+TUQ<ental<hans<Absolut
taagaluartiginuna	taa+GALUAR<Imperativ<ViDem+UNA
taagaluarpakkali	taa+GALUAR<Indikativ<JegDem+LI
taagaluarpiuk	taa+GALUAR<Interrogativ<DuHam
taajartorpaa	taa+GIARTUR<Indikativ<HanHam
taajartorpagununa	taa+GIARTUR<Indikativ<ViDem+UNA
taaguummi	taaguut<ental<Lokalis
taaguummulli	taaguut<ental<Terminalis+LI
taavaali	taa<Indikativ<HanDem+LI
taavarsi	taa<Indikativ<I_Ham
taallugilli	taa<Ledsagemåde<dem+LI
taalertiginuna	taa-LIR<Imperativ<ViDem+UNA
taaniarpaallu	taa+NIAR<Indikativ<DeDem+LU
taaniarpiuk	taa+NIAR<Interrogativ<DuHam
taaniarlugu	taa+NIAR<Ledsagemåde<ham
taanianngilaat	taa+NIAR=NNGIT<Indikativ<DeDem
taasimatigilli	taa+SIMA<Imperativ<ViDem+LI
taasimallungali	taa+SIMA<Ledsagemåde<mig+LI
taasimasartigit	taa+SIMA=TAR<Imperativ<ViDem
taasimasartigilli	taa+SIMA=TAR<Imperativ<ViDem+LI
taasimasarpagulli	taa+SIMA=TAR<Indikativ<ViDem+LI
taasimasarpiuk	taa+SIMA=TAR<Interrogativ<DuHam
taasimasarluguuna	taa+SIMA=TAR<Ledsagemåde<ham+UNA
taasinnaavagullu	taa+SINNAA<Indikativ<ViDem+LU
taassagaluartigilli	taa-SSA=GALUAR<Imperativ<ViDem+LI
taassavaalu	taa-SSA<Indikativ<HanHam+LU
taasartigilli	taa+TAR<Imperativ<ViDem+LI
taasartigillu	taa+TAR<Imperativ<ViDem+LU
taasarparsi	taa+TAR<Indikativ<I_Ham
tallimaannaalli	tallimat-INNAQ<flertal<Absolut+LI
tallimaannarnik	tallimat-INNAQ<flertal<Instrumentalis
tallimaannakkaana	tallimat-INNAQ<flertal<min<Absolut+UNA
tallimaannaalli	tallimat-INNAQ<flertal<Relativ+LI
tallimaannanngussaarli	tallimat-INNAQ-NNGUR-SSA<Indikativ<han+LI
tallimanngoraluartoq	tallimat-NNGUR+GALUAR<Participium<han
tallimanngorlunili	tallimat-NNGUR<Ledsagemåde<han_selv+LI
tallimanngulerpungali	tallimat-NNGUR-LIR<Indikativ<jeg+LI
tallimanngorniartulli	tallimat-NNGUR+NIAR<Participium<de+LI
tallimanngunngilasi	tallimat-NNGUR-NNGIT<Interrogativ<I
tallimanngussagaluartut	tallimat-NNGUR-SSA=GALUAR<Participium<de
tallimanngussavit	tallimat-NNGUR-SSA<Interrogativ<du
tallimanngortaraluarpoq	tallimat-NNGUR+TAR=GALUAR<Indikativ<han
tallimanngortarporli	tallimat-NNGUR+TAR<Indikativ<han+LI
tallimaalli	tallimat<Talord<ental<deres+LI
tallimat	tallimat<Talord<flertal<Absolut
tallimallu	tallimat<Talord<flertal<Absolut+LU
tallimanukarpungali	tallimat<Talord<flertal<Terminalis-KAR<Indikativ<jeg+LI
tallimanik	tallimat<Talord<Instrumentalis
tallimanillu	tallimat<Talord<Instrumentalis+LU
tallimaninguna	tallimat<Talord<Instrumentalis+UNA
tallimaniissimallunga	tallimat<Talord<Lokalis+IP+SIMA<Ledsagemåde<jeg
tallimaniittoqanngilarlu	tallimat<Talord<Lokalis+IP+TUQ-QAR-NNGIT<Indikativ<han+LU
tamarmik	tamarmik<Adjektiv
tamarmilli	tamarmik<Adjektiv+LI
tamarmillu	tamarmik<Adjektiv+LU
tamarminguna	tamarmik<Adjektiv+UNA
tamatta	tamatta<Adjektiv
tamattali	tamatta<Adjektiv+LI
tamattalu	tamatta<Adjektiv+LU
Tasiilaq	Tasiilaq<Absolut
Tasiilarli	Tasiilaq<Absolut+LI
Tasiilarlu	Tasiilaq<Absolut+LU
Tasiilaruna	Tasiilaq<Absolut+UNA
Tasiilamik	Tasiilaq<Instrumentalis
Tasiilamilli	Tasiilaq<Instrumentalis+LI
Tasiilamillu	Tasiilaq<Instrumentalis+LU
Tasiilaminguna	Tasiilaq<Instrumentalis+UNA
Tasiilami	Tasiilaq<Lokalis
Tasiilamiikkiartorluni	Tasiilaq<Lokalis+IP+GIARTUR<Ledsagemåde<han_selv
Tasiilamiilluni	Tasiilaq<Lokalis+IP<Ledsagemåde<han_selv
Tasiilamiissimasarlunga	Tasiilaq<Lokalis+IP+SIMA=TAR<Ledsagemåde<jeg
Tasiilamiissagaluarpoq	Tasiilaq<Lokalis+IP-SSA=GALUAR<Indikativ<han
Tasiilamiissaaq	Tasiilaq<Lokalis+IP-SSA<Indikativ<han
Tasiilamiittarluni	Tasiilaq<Lokalis+IP+TAR<Ledsagemåde<han_selv
Tasiilamili	Tasiilaq<Lokalis+LI
Tasiilamilu	Tasiilaq<Lokalis+LU
Tasiilarmiuli	Tasiilaq+MIU<ental<Absolut+LI
Tasiilarmiumik	Tasiilaq+MIU<ental<Instrumentalis
Tasiilarmiumukanngilagununa	Tasiilaq+MIU<ental<Terminalis-KAR-NNGIT<Indikativ<vi+UNA
Tasiilarmiunik	Tasiilaq+MIU<flertal<Instrumentalis
Tasiilarmiuni	Tasiilaq+MIU<flertal<Lokalis
Tasiilarmiuniissavit	Tasiilaq+MIU<flertal<Lokalis+IP-SSA<Interrogativ<du
Tasiilarmiunili	Tasiilaq+MIU<flertal<Lokalis+LI
Tasiilarmiulerivit	Tasiilaq+MIU-LIRI<Interrogativ<du
Tasiilarmiulerinerillu	Tasiilaq+MIU-LIRI+NIQ<flertal<Relativ+LU
Tasiilarmiulerisimavunga	Tasiilaq+MIU-LIRI+SIMA<Indikativ<jeg
Tasiilarmiulerisuinnalerinnginneralu	Tasiilaq+MIU-LIRI+TUQ-INNAQ-LIRI-NNGIT+NIQ<ental<hans<Absolut+LU
Tasiilarmiulerisoqassasunga	Tasiilaq+MIU-LIRI+TUQ-QAR-SSA<Participium<jeg
Tasiilarmiunngulertoqassaanga	Tasiilaq+MIU-NNGUR-LIR+TUQ-QAR-SSA<Indikativ<jeg
Tasiilarmiunngunngitsulilerigaluartulli	Tasiilaq+MIU-NNGUR-NNGIT+TUQ-LIK-LIRI+GALUAR<Participium<de+LI
Tasiilarmiunngorsimasunga	Tasiilaq+MIU-NNGUR+SIMA<Participium<jeg
Tasiilarmiunngorsinnaasoq	Tasiilaq+MIU-NNGUR+SINNAA<Participium<han
Tasiilarmioqarpoq	Tasiilaq+MIU-QAR<Indikativ<han
Tasiilarmioqarneq	Tasiilaq+MIU-QAR+NIQ<ental<Absolut
Tasiilarmioqarnerlu	Tasiilaq+MIU-QAR+NIQ<ental<Absolut+LU
Tasiilarmioqarneruna	Tasiilaq+MIU-QAR+NIQ<ental<Absolut+UNA
Tasiilarmioqartoq	Tasiilaq+MIU-QAR<Participium<han
Tasiilarmioqartorli	Tasiilaq+MIU-QAR<Participium<han+LI
Tasiilarmioqartorlu	Tasiilaq+MIU-QAR<Participium<han+LU
Tasiilarmioqartoq	Tasiilaq+MIU-QAR+TUQ<ental<Absolut
Tasiilarmioqartorli	Tasiilaq+MIU-QAR+TUQ<ental<Absolut+LI
Tasiilarmioqartorlu	Tasiilaq+MIU-QAR+TUQ<ental<Absolut+LU
Tasiilarmiuujartorluni	Tasiilaq+MIU-U+GIARTUR<Ledsagemåde<han_selv
Tasiilarmiuujartorlunga	Tasiilaq+MIU-U+GIARTUR<Ledsagemåde<jeg
Tasiilarmiuujartortorli	Tasiilaq+MIU-U+GIARTUR<Participium<han+LI
Tasiilarmiuuit	Tasiilaq+MIU-U<Interrogativ<du
Tasiilarmiuullutik	Tasiilaq+MIU-U<Ledsagemåde<de_selv
Tasiilarmiuulluni	Tasiilaq+MIU-U<Ledsagemåde<han_selv
Tasiilarmiuunianngitsut	Tasiilaq+MIU-U+NIAR=NNGIT<Participium<de
Tasiilarmiuunianngitsorpassuilu	Tasiilaq+MIU-U+NIAR=NNGIT+TUQ+PASSUAQ<flertal<hans<Absolut+LU
Tasiilarmiuuniartungalu	Tasiilaq+MIU-U+NIAR<Participium<jeg+LU
Tasiilarmiuunnginnera	Tasiilaq+MIU-U-NNGIT+NIQ<ental<hans<Absolut
Tasiilarmiuusulli	Tasiilaq+MIU-U<Participium<de+LI
Tasiilarmiuusorli	Tasiilaq+MIU-U<Participium<han+LI
Tasiilarmiuusimavit	Tasiilaq+MIU-U+SIMA<Interrogativ<du
Tasiilarmiuusimasarluni	Tasiilaq+MIU-U+SIMA=TAR<Ledsagemåde<han_selv
Tasiilarmiuusimasoqalaartut	Tasiilaq+MIU-U+SIMA+TUQ-QAR-LAAR<Participium<de
Tasiilarmiuusinnaavungalu	Tasiilaq+MIU-U+SINNAA<Indikativ<jeg+LU
Tasiilarmiuusinnaalluni	Tasiilaq+MIU-U+SINNAA<Ledsagemåde<han_selv
Tasiilarmiuussagaluartullu	Tasiilaq+MIU-U-SSA=GALUAR<Participium<de+LU
Tasiilarmiuussallunilu	Tasiilaq+MIU-U-SSA<Ledsagemåde<han_selv+LU
Tasiilarmiuusora	Tasiilaq+MIU-U+TUQ<ental<min<Absolut
Tasiilarmiuusuili	Tasiilaq+MIU-U+TUQ<flertal<hans<Absolut+LI
Tasiilarmiuusuinnalerisimasarlunga	Tasiilaq+MIU-U+TUQ-INNAQ-LIRI+SIMA=TAR<Ledsagemåde<jeg
Tasiilarmiuusunngulerporli	Tasiilaq+MIU-U+TUQ-NNGUR-LIR<Indikativ<han+LI
Tasiilamut	Tasiilaq<Terminalis
Tasiilamukalaarneruna	Tasiilaq<Terminalis-KAR-LAAR+NIQ+UNA
Tasiilamukalaartartoqarporlu	Tasiilaq<Terminalis-KAR-LAAR=TAR+TUQ-QAR<Indikativ<han+LU
Tasiilamukalerlunga	Tasiilaq<Terminalis-KAR-LIR<Ledsagemåde<jeg
Tasiilamukalerlungali	Tasiilaq<Terminalis-KAR-LIR<Ledsagemåde<jeg+LI
Tasiilamukanngitsulli	Tasiilaq<Terminalis-KAR-NNGIT<Participium<de+LI
Tasiilamukassagaluartoqarporli	Tasiilaq<Terminalis-KAR-SSA=GALUAR+TUQ-QAR<Indikativ<han+LI
Tasiilamukassallunga	Tasiilaq<Terminalis-KAR-SSA<Ledsagemåde<jeg
Tasiilamulli	Tasiilaq<Terminalis+LI
Tasiilamullu	Tasiilaq<Terminalis+LU
Tasiilamununa	Tasiilaq<Terminalis+UNA
tassa	tassa<Partikel
tassali	tassa<Partikel+LI
tassalu	tassa<Partikel+LU
tassaana	tassa<Partikel+UNA
tutsiuteqqikkaluarpisi	tutsiuteqqip+GALUAR<Interrogativ<I
tutsiuteqqikkaluarnermulli	tutsiuteqqip+GALUAR+NIQ<ental<Terminalis+LI
tutsiuteqqikkaluartulli	tutsiuteqqip+GALUAR<Participium<de+LI
tutsiuteqqikkaluartoq	tutsiuteqqip+GALUAR<Participium<han
tutsiuteqqikkaluartunga	tutsiuteqqip+GALUAR<Participium<jeg
tutsiuteqqikkaluartuniinnginneq	tutsiuteqqip+GALUAR+TUQ<flertal<Lokalis+IP-NNGIT+NIQ<ental<Absolut
tutsiuteqqikkiartorpit	tutsiuteqqip+GIARTUR<Interrogativ<du
tutsiuteqqikkiartornikka	tutsiuteqqip+GIARTUR+NIQ<flertal<min<Absolut
tutsiuteqqikkiartortoq	tutsiuteqqip+GIARTUR+TUQ<ental<Absolut
tutsiuteqqikkiartortulinngulertut	tutsiuteqqip+GIARTUR+TUQ-LIK-NNGUR-LIR<Participium<de
tutsiuteqqippununa	tutsiuteqqip<Indikativ<de+UNA
tutsiuteqqipporli	tutsiuteqqip<Indikativ<han+LI
tutsiuteqqipporuna	tutsiuteqqip<Indikativ<han+UNA
tutsiuteqqippunga	tutsiuteqqip<Indikativ<jeg
tutsiuteqqippungali	tutsiuteqqip<Indikativ<jeg+LI
tutsiuteqqippugut	tutsiuteqqip<Indikativ<vi
tutsiuteqqippugullu	tutsiuteqqip<Indikativ<vi+LU
tutsiuteqqippugununa	tutsiuteqqip<Indikativ<vi+UNA
tutsiuteqqippit	tutsiuteqqip<Interrogativ<du
tutsiuteqqippisi	tutsiuteqqip<Interrogativ<I
tutsiuteqqilaarnertulli	tutsiuteqqip-LAAR+NIQ<ental<Aequalis+LI
tutsiuteqqilaartarluniuna	tutsiuteqqip-LAAR=TAR<Ledsagemåde<han_selv+UNA
tutsiuteqqilaartarnikka	tutsiuteqqip-LAAR=TAR+NIQ<flertal<min<Absolut
tutsiuteqqilaartartungaana	tutsiuteqqip-LAAR=TAR<Participium<jeg+UNA
tutsiuteqqillutik	tutsiuteqqip<Ledsagemåde<de_selv
tutsiuteqqillutilli	tutsiuteqqip<Ledsagemåde<de_selv+LI
tutsiuteqqillutinguna	tutsiuteqqip<Ledsagemåde<de_selv+UNA
tutsiuteqqilluni	tutsiuteqqip<Ledsagemåde<han_selv
tutsiuteqqillunili	tutsiuteqqip<Ledsagemåde<han_selv+LI
tutsiuteqqillunilu	tutsiuteqqip<Ledsagemåde<han_selv+LU
tutsiuteqqillunga	tutsiuteqqip<Ledsagemåde<jeg
tutsiuteqqillungali	tutsiuteqqip<Ledsagemåde<jeg+LI
tutsiuteqqilerpunga	tutsiuteqqip-LIR<Indikativ<jeg
tutsiuteqqinniarnerillu	tutsiuteqqip+NIAR+NIQ<flertal<Absolut+LU
tutsiuteqqinniarnikka	tutsiuteqqip+NIAR+NIQ<flertal<min<Absolut
tutsiuteqqinniarnerilli	tutsiuteqqip+NIAR+NIQ<flertal<Relativ+LI
tutsiuteqqinniarnernukalaartoqarpoq	tutsiuteqqip+NIAR+NIQ<flertal<Terminalis-KAR-LAAR+TUQ-QAR<Indikativ<han
tutsiuteqqinnianngilatit	tutsiuteqqip+NIAR=NNGIT<Interrogativ<du
tutsiuteqqinnianngilasi	tutsiuteqqip+NIAR=NNGIT<Interrogativ<I
tutsiuteqqinniarnanga	tutsiuteqqip+NIAR=NNGIT<Ledsagemåde<jeg
tutsiuteqqinniannginnikkalu	tutsiuteqqip+NIAR=NNGIT+NIQ<flertal<min<Absolut+LU
tutsiuteqqinnianngitsunnguaq	tutsiuteqqip+NIAR=NNGIT+TUQ-NNGUAQ<ental<Absolut
tutsiuteqqinniartungaana	tutsiuteqqip+NIAR<Participium<jeg+UNA
tutsiuteqqinniartorpassuarnukassavisi	tutsiuteqqip+NIAR+TUQ+PASSUAQ<flertal<Terminalis-KAR-SSA<Interrogativ<I
tutsiuteqqinnermut	tutsiuteqqip+NIQ<ental<Terminalis
tutsiuteqqinnikka	tutsiuteqqip+NIQ<flertal<min<Absolut
tutsiuteqqinngilanga	tutsiuteqqip-NNGIT<Indikativ<jeg
tutsiuteqqinngilatit	tutsiuteqqip-NNGIT<Interrogativ<du
tutsiuteqqinnginnerilli	tutsiuteqqip-NNGIT+NIQ<flertal<Absolut+LI
tutsiuteqqinngitsulli	tutsiuteqqip-NNGIT<Participium<de+LI
tutsiuteqqinngitsoraana	tutsiuteqqip-NNGIT+TUQ<ental<min<Absolut+UNA
tutsiuteqqittulli	tutsiuteqqip<Participium<de+LI
tutsiuteqqissimappulli	tutsiuteqqip+SIMA<Indikativ<de+LI
tutsiuteqqissimavunga	tutsiuteqqip+SIMA<Indikativ<jeg
tutsiuteqqissimallutik	tutsiuteqqip+SIMA<Ledsagemåde<de_selv
tutsiuteqqissimalluni	tutsiuteqqip+SIMA<Ledsagemåde<han_selv
tutsiuteqqissimanikka	tutsiuteqqip+SIMA+NIQ<flertal<min<Absolut
tutsiuteqqissimasunga	tutsiuteqqip+SIMA<Participium<jeg
tutsiuteqqissimasarpisi	tutsiuteqqip+SIMA=TAR<Interrogativ<I
tutsiuteqqissimasarlutik	tutsiuteqqip+SIMA=TAR<Ledsagemåde<de_selv
tutsiuteqqissimasarlungali	tutsiuteqqip+SIMA=TAR<Ledsagemåde<jeg+LI
tutsiuteqqissimasartorlu	tutsiuteqqip+SIMA=TAR<Participium<han+LU
tutsiuteqqissimasartunga	tutsiuteqqip+SIMA=TAR<Participium<jeg
tutsiuteqqissimasartulerivit	tutsiuteqqip+SIMA=TAR+TUQ-LIRI<Interrogativ<du
tutsiuteqqissinnaappullu	tutsiuteqqip+SINNAA<Indikativ<de+LU
tutsiuteqqissinnaavisi	tutsiuteqqip+SINNAA<Interrogativ<I
tutsiuteqqissinnaallutilli	tutsiuteqqip+SINNAA<Ledsagemåde<de_selv+LI
tutsiuteqqissinnaanertununa	tutsiuteqqip+SINNAA+NIQ<ental<Aequalis+UNA
tutsiuteqqissagaluarpisi	tutsiuteqqip-SSA=GALUAR<Interrogativ<I
tutsiuteqqissagaluarlunga	tutsiuteqqip-SSA=GALUAR<Ledsagemåde<jeg
tutsiuteqqissaaq	tutsiuteqqip-SSA<Indikativ<han
tutsiuteqqissaanga	tutsiuteqqip-SSA<Indikativ<jeg
tutsiuteqqissaagullu	tutsiuteqqip-SSA<Indikativ<vi+LU
tutsiuteqqittaraluarput	tutsiuteqqip+TAR=GALUAR<Indikativ<de
tutsiuteqqittaraluarpunga	tutsiuteqqip+TAR=GALUAR<Indikativ<jeg
tutsiuteqqittaraluarpugut	tutsiuteqqip+TAR=GALUAR<Indikativ<vi
tutsiuteqqittaraluartorali	tutsiuteqqip+TAR=GALUAR+TUQ<ental<min<Absolut+LI
tutsiuteqqittarpungali	tutsiuteqqip+TAR<Indikativ<jeg+LI
tutsiuteqqittarnikkali	tutsiuteqqip+TAR+NIQ<flertal<min<Absolut+LI
tutsiuteqqittartungali	tutsiuteqqip+TAR<Participium<jeg+LI
tutsiuteqqittumik	tutsiuteqqip+TUQ<ental<Instrumentalis
tutsiuteqqittuinnaallu	tutsiuteqqip+TUQ-INNAQ<ental<deres<Absolut+LU
tutsiuteqqittoqalerpit	tutsiuteqqip+TUQ-QAR-LIR<Interrogativ<du
tutsiuteqqittuuniarnatinguna	tutsiuteqqip+TUQ-U+NIAR=NNGIT<Ledsagemåde<de_selv+UNA
uagut	uagut<Pronomen<ental
uagulli	uagut<Pronomen<ental+LI
uagullu	uagut<Pronomen<ental+LU
uagununa	uagut<Pronomen<ental+UNA
uanga	uanga<Pronomen<ental
uangali	uanga<Pronomen<ental+LI
uangalu	uanga<Pronomen<ental+LU
ukioq	ukioq<ental<Absolut
ukiorli	ukioq<ental<Absolut+LI
ukiua	ukioq<ental<hans<Absolut
ukiuaana	ukioq<ental<hans<Absolut+UNA
ukiumilli	ukioq<ental<Instrumentalis+LI
ukiumut	ukioq<ental<Terminalis
ukiumununa	ukioq<ental<Terminalis+UNA
ukiunillu	ukioq<flertal<Instrumentalis+LU
ukiuni	ukioq<flertal<Lokalis
ukiunukanngitsoq	ukioq<flertal<Terminalis-KAR-NNGIT<Participium<han
ukiunukassagaluartungaana	ukioq<flertal<Terminalis-KAR-SSA=GALUAR<Participium<jeg+UNA
ukioritigilli	ukioq+GӘ<Imperativ<ViDem+LI
ukiorivagut	ukioq+GӘ<Indikativ<ViDem
ukioriviuk	ukioq+GӘ<Interrogativ<DuHam
ukiorilaartartigillu	ukioq+GӘ-LAAR=TAR<Imperativ<ViDem+LU
ukiorilaartarlugilli	ukioq+GӘ-LAAR=TAR<Ledsagemåde<dem+LI
ukiorilertigilli	ukioq+GӘ-LIR<Imperativ<ViDem+LI
ukiorisimatigillu	ukioq+GӘ+SIMA<Imperativ<ViDem+LU
ukiorisarlunga	ukioq+GӘ+TAR<Ledsagemåde<mig
ukiuinnaq	ukioq-INNAQ<ental<Absolut
ukiuinnaalli	ukioq-INNAQ<ental<deres<Absolut+LI
ukiuinnaa	ukioq-INNAQ<ental<hans<Absolut
ukiuinnarnukanngilatit	ukioq-INNAQ<flertal<Terminalis-KAR-NNGIT<Interrogativ<du
ukiuinnarnulli	ukioq-INNAQ<flertal<Terminalis+LI
ukiuinnaagaluarpoq	ukioq-INNAQ-U+GALUAR<Indikativ<han
ukiulillu	ukioq-LIK<ental<Absolut+LU
ukiulimmununa	ukioq-LIK<ental<Terminalis+UNA
ukiullit	ukioq-LIK<flertal<Relativ
ukiunngua	ukioq-NNGUAQ<ental<hans<Absolut
ukiunnguanilli	ukioq-NNGUAQ<flertal<Instrumentalis+LI
ukiunnguaniuna	ukioq-NNGUAQ<flertal<Lokalis+UNA
ukiunngualerinanili	ukioq-NNGUAQ-LIRI-NNGIT<Ledsagemåde<han_selv+LI
ukiunnguusaraluartulli	ukioq-NNGUAQ-U+TAR=GALUAR<Participium<de+LI
ukiunngulaarneq	ukioq-NNGUR-LAAR+NIQ<ental<Absolut
ukiunngortoq	ukioq-NNGUR<Participium<han
ukiunngorsimasarporli	ukioq-NNGUR+SIMA=TAR<Indikativ<han+LI
ukiunngorsimasartoq	ukioq-NNGUR+SIMA=TAR<Participium<han
ukiunngussagaluartorli	ukioq-NNGUR-SSA=GALUAR<Participium<han+LI
ukiunngussaaruna	ukioq-NNGUR-SSA<Indikativ<han+UNA
ukiorpassuinuna	ukioq+PASSUAQ<flertal<Absolut+UNA
ukiorpassui	ukioq+PASSUAQ<flertal<hans<Absolut
ukiorpassuili	ukioq+PASSUAQ<flertal<hans<Absolut+LI
ukiorpassuakka	ukioq+PASSUAQ<flertal<min<Absolut
ukioqalaarporli	ukioq-QAR-LAAR<Indikativ<han+LI
ukioqalaartarneruna	ukioq-QAR-LAAR=TAR+NIQ<ental<Absolut+UNA
ukioqalaartartorli	ukioq-QAR-LAAR=TAR+TUQ<ental<Absolut+LI
ukioqalaartartorlu	ukioq-QAR-LAAR=TAR+TUQ<ental<Absolut+LU
ukioqalerneruna	ukioq-QAR-LIR+NIQ<ental<Absolut+UNA
ukioqanngitsoq	ukioq-QAR-NNGIT+TUQ<ental<Absolut
ukioqanngitsorli	ukioq-QAR-NNGIT+TUQ<ental<Absolut+LI
ukioqassagaluarnerli	ukioq-QAR-SSA=GALUAR+NIQ<ental<Absolut+LI
ukioqassagaluarneruna	ukioq-QAR-SSA=GALUAR+NIQ<ental<Absolut+UNA
ukioqassaaq	ukioq-QAR-SSA<Indikativ<han
ukioqassasorli	ukioq-QAR-SSA<Participium<han+LI
ukioqartarnerli	ukioq-QAR+TAR+NIQ<ental<Absolut+LI
ukiuujartortoq	ukioq-U+GIARTUR<Participium<han
ukiuulaartormiuunermukalaarlunga	ukioq-U-LAAR+TUQ+MIU-U+NIQ<ental<Terminalis-KAR-LAAR<Ledsagemåde<jeg
ukiuunikkalu	ukioq-U+NIQ<flertal<min<Absolut+LU
ukiuusimasarpisi	ukioq-U+SIMA=TAR<Interrogativ<I
ukiuusinnaasunga	ukioq-U+SINNAA<Participium<jeg
ukiuusinnaasuugaluartunga	ukioq-U+SINNAA+TUQ-U+GALUAR<Participium<jeg
ukiuussaangalu	ukioq-U-SSA<Indikativ<jeg+LU
ukiuussavisi	ukioq-U-SSA<Interrogativ<I
ukiuusaraluarnikkalu	ukioq-U+TAR=GALUAR+NIQ<flertal<min<Absolut+LU
ulloq	ulloq<ental<Absolut
ullutullu	ulloq<ental<Aequalis+LU
ullumillu	ulloq<ental<Instrumentalis+LU
ullumi	ulloq<ental<Lokalis
ulloraana	ulloq<ental<min<Absolut+UNA
ullunilli	ulloq<flertal<Instrumentalis+LI
ulluni	ulloq<flertal<Lokalis
ulluniittarlutilli	ulloq<flertal<Lokalis+IP+TAR<Ledsagemåde<de_selv+LI
ullorillungali	ulloq+GӘ<Ledsagemåde<mig+LI
ulloriniartigit	ulloq+GӘ+NIAR<Imperativ<ViDem
ulluinnaq	ulloq-INNAQ<ental<Absolut
ulluinnaa	ulloq-INNAQ<ental<hans<Absolut
ulluinnaalli	ulloq-INNAQ<flertal<Relativ+LI
ulluinnanngussagaluarlungali	ulloq-INNAQ-NNGUR-SSA=GALUAR<Ledsagemåde<jeg+LI
ulluinnaqannginnikka	ulloq-INNAQ-QAR-NNGIT+NIQ<flertal<min<Absolut
ulluliat	ulloq-LIK<ental<deres
ullullilli	ulloq-LIK<flertal<Absolut+LI
ullulerilertunga	ulloq-LIRI-LIR<Participium<jeg
ulluleriniartunga	ulloq-LIRI+NIAR<Participium<jeg
ullulerissagaluarpit	ulloq-LIRI-SSA=GALUAR<Interrogativ<du
ullormiulerilluni	ulloq+MIU-LIRI<Ledsagemåde<han_selv
ullormiulerisaraluarpisi	ulloq+MIU-LIRI+TAR=GALUAR<Interrogativ<I
ullormioqartoq	ulloq+MIU-QAR<Participium<han
ullormioqartorlu	ulloq+MIU-QAR<Participium<han+LU
ullormioqartoq	ulloq+MIU-QAR+TUQ<ental<Absolut
ullormiuuisi	ulloq+MIU-U<Interrogativ<I
ullunngua	ulloq-NNGUAQ<ental<hans<Absolut
ullunnguamili	ulloq-NNGUAQ<ental<Lokalis+LI
ullunngoriartorpisi	ulloq-NNGUR+GIARTUR<Interrogativ<I
ullunngulertunga	ulloq-NNGUR-LIR<Participium<jeg
ullunngorsimasarporuna	ulloq-NNGUR+SIMA=TAR<Indikativ<han+UNA
ullorpassuarniissagaluarlutik	ulloq+PASSUAQ<flertal<Lokalis+IP-SSA=GALUAR<Ledsagemåde<de_selv
ulloqaraluarnikkaana	ulloq-QAR+GALUAR+NIQ<flertal<min<Absolut+UNA
ulloqalaarnernili	ulloq-QAR-LAAR+NIQ<flertal<Lokalis+LI
ulloqalaarnikka	ulloq-QAR-LAAR+NIQ<flertal<min<Absolut
ulloqalaartarlutilli	ulloq-QAR-LAAR=TAR<Ledsagemåde<de_selv+LI
ulloqalaartarnerinuna	ulloq-QAR-LAAR=TAR+NIQ<flertal<Relativ+UNA
ulloqalaartartoriartortigillu	ulloq-QAR-LAAR=TAR+TUQ+GӘ+GIARTUR<Imperativ<ViDem+LU
ulloqalaartoqalaartullilli	ulloq-QAR-LAAR+TUQ-QAR-LAAR+TUQ-LIK<flertal<Relativ+LI
ulloqalerlutillu	ulloq-QAR-LIR<Ledsagemåde<de_selv+LU
ulloqalerlunili	ulloq-QAR-LIR<Ledsagemåde<han_selv+LI
ulloqalertullu	ulloq-QAR-LIR<Participium<de+LU
ulloqalertuugaluarnikkalu	ulloq-QAR-LIR+TUQ-U+GALUAR+NIQ<flertal<min<Absolut+LU
ulloqanngitsoq	ulloq-QAR-NNGIT<Participium<han
ulloqassagaluarpit	ulloq-QAR-SSA=GALUAR<Interrogativ<du
ulloqassagaluarnera	ulloq-QAR-SSA=GALUAR+NIQ<ental<hans<Absolut
ulloqassagaluartoqanngilanga	ulloq-QAR-SSA=GALUAR+TUQ-QAR-NNGIT<Indikativ<jeg
ulluujartorlunga	ulloq-U+GIARTUR<Ledsagemåde<jeg
ulluusoqalaartarluni	ulloq-U+TUQ-QAR-LAAR=TAR<Ledsagemåde<han_selv
ullumi	ullumi<Partikel
ullumili	ullumi<Partikel+LI
ullumilu	ullumi<Partikel+LU
ullumiuna	ullumi<Partikel+UNA
Upernavik	Upernavik<Absolut
Upernavilli	Upernavik<Absolut+LI
Upernavillu	Upernavik<Absolut+LU
Upernavinguna	Upernavik<Absolut+UNA
Upernavimmik	Upernavik<Instrumentalis
Upernavimmillu	Upernavik<Instrumentalis+LU
Upernavimminguna	Upernavik<Instrumentalis+UNA
Upernavimmi	Upernavik<Lokalis
Upernavimmiissimaneruna	Upernavik<Lokalis+IP+SIMA+NIQ+UNA
Upernavimmiissavit	Upernavik<Lokalis+IP-SSA<Interrogativ<du
Upernavimmiittoqarpoq	Upernavik<Lokalis+IP+TUQ-QAR<Indikativ<han
Upernavimmiuna	Upernavik<Lokalis+UNA
Upernavimmiu	Upernavik+MIU<ental<Absolut
Upernavimmiumi	Upernavik+MIU<ental<Lokalis
Upernavimmiumiissimavunga	Upernavik+MIU<ental<Lokalis+IP+SIMA<Indikativ<jeg
Upernavimmiumununa	Upernavik+MIU<ental<Terminalis+UNA
Upernavimmiunilli	Upernavik+MIU<flertal<Instrumentalis+LI
Upernavimmiulerinikka	Upernavik+MIU-LIRI+NIQ<flertal<min<Absolut
Upernavimmiunngorpungali	Upernavik+MIU-NNGUR<Indikativ<jeg+LI
Upernavimmiunngulaarlungali	Upernavik+MIU-NNGUR-LAAR<Ledsagemåde<jeg+LI
Upernavimmiunngulaartarpisi	Upernavik+MIU-NNGUR-LAAR=TAR<Interrogativ<I
Upernavimmiunngorsimasartutununa	Upernavik+MIU-NNGUR+SIMA=TAR+TUQ<ental<Aequalis+UNA
Upernavimmiunngussagaluarnernukalaartartorli	Upernavik+MIU-NNGUR-SSA=GALUAR+NIQ<flertal<Terminalis-KAR-LAAR=TAR<Participium<han+LI
Upernavimmioqarpoq	Upernavik+MIU-QAR<Indikativ<han
Upernavimmioqarporli	Upernavik+MIU-QAR<Indikativ<han+LI
Upernavimmioqarneq	Upernavik+MIU-QAR+NIQ<ental<Absolut
Upernavimmioqarnerli	Upernavik+MIU-QAR+NIQ<ental<Absolut+LI
Upernavimmioqarnerlu	Upernavik+MIU-QAR+NIQ<ental<Absolut+LU
Upernavimmioqarneruna	Upernavik+MIU-QAR+NIQ<ental<Absolut+UNA
Upernavimmioqartoq	Upernavik+MIU-QAR+TUQ<ental<Absolut
Upernavimmiuuniartungaana	Upernavik+MIU-U+NIAR<Participium<jeg+UNA
Upernavimmiuunngitsunga	Upernavik+MIU-U-NNGIT<Participium<jeg
Upernavimmiuusinnaavungaana	Upernavik+MIU-U+SINNAA<Indikativ<jeg+UNA
Upernavimmiuussappulli	Upernavik+MIU-U-SSA<Indikativ<de+LI
Upernavimmut	Upernavik<Terminalis
Upernavimmukalaartarpit	Upernavik<Terminalis-KAR-LAAR=TAR<Interrogativ<du
Upernavimmukalerpisi	Upernavik<Terminalis-KAR-LIR<Interrogativ<I
Upernavimmulli	Upernavik<Terminalis+LI
Upernavimmullu	Upernavik<Terminalis+LU
Upernavimmununa	Upernavik<Terminalis+UNA
Uummannaq	Uummannaq<Absolut
Uummannarli	Uummannaq<Absolut+LI
Uummannarlu	Uummannaq<Absolut+LU
Uummannaruna	Uummannaq<Absolut+UNA
Uummannamik	Uummannaq<Instrumentalis
Uummannaminguna	Uummannaq<Instrumentalis+UNA
Uummannami	Uummannaq<Lokalis
Uummannamiilaartarlutik	Uummannaq<Lokalis+IP-LAAR=TAR<Ledsagemåde<de_selv
Uummannamiissalluni	Uummannaq<Lokalis+IP-SSA<Ledsagemåde<han_selv
Uummannamiissasoq	Uummannaq<Lokalis+IP-SSA<Participium<han
Uummannamili	Uummannaq<Lokalis+LI
Uummannamilu	Uummannaq<Lokalis+LU
Uummannamiuna	Uummannaq<Lokalis+UNA
Uummannarmiu	Uummannaq+MIU<ental<Absolut
Uummannarmiumillu	Uummannaq+MIU<ental<Instrumentalis+LU
Uummannarmiumi	Uummannaq+MIU<ental<Lokalis
Uummannarmiumut	Uummannaq+MIU<ental<Terminalis
Uummannarmiumullu	Uummannaq+MIU<ental<Terminalis+LU
Uummannarmiuni	Uummannaq+MIU<flertal<Lokalis
Uummannarmiuniillunilu	Uummannaq+MIU<flertal<Lokalis+IP<Ledsagemåde<han_selv+LU
Uummannarmiuniittarnerlu	Uummannaq+MIU<flertal<Lokalis+IP+TAR+NIQ+LU
Uummannarmiunilu	Uummannaq+MIU<flertal<Lokalis+LU
Uummannarmiulerigaluartungali	Uummannaq+MIU-LIRI+GALUAR<Participium<jeg+LI
Uummannarmiulerivit	Uummannaq+MIU-LIRI<Interrogativ<du
Uummannarmiulerisununa	Uummannaq+MIU-LIRI<Participium<de+UNA
Uummannarmiulerisinnaasut	Uummannaq+MIU-LIRI+SINNAA<Participium<de
Uummannarmiulerisinnaasoqalaarpununa	Uummannaq+MIU-LIRI+SINNAA+TUQ-QAR-LAAR<Indikativ<de+UNA
Uummannarmiulerisoqalaarpit	Uummannaq+MIU-LIRI+TUQ-QAR-LAAR<Interrogativ<du
Uummannarmiunngoriartorpungali	Uummannaq+MIU-NNGUR+GIARTUR<Indikativ<jeg+LI
Uummannarmiunngornertullu	Uummannaq+MIU-NNGUR+NIQ<ental<Aequalis+LU
Uummannarmioqarpoq	Uummannaq+MIU-QAR<Indikativ<han
Uummannarmioqarporli	Uummannaq+MIU-QAR<Indikativ<han+LI
Uummannarmioqarneq	Uummannaq+MIU-QAR+NIQ<ental<Absolut
Uummannarmioqarnerli	Uummannaq+MIU-QAR+NIQ<ental<Absolut+LI
Uummannarmioqarneruna	Uummannaq+MIU-QAR+NIQ<ental<Absolut+UNA
Uummannarmioqartoq	Uummannaq+MIU-QAR<Participium<han
Uummannarmioqartorli	Uummannaq+MIU-QAR<Participium<han+LI
Uummannarmioqartoruna	Uummannaq+MIU-QAR<Participium<han+UNA
Uummannarmioqartoq	Uummannaq+MIU-QAR+TUQ<ental<Absolut
Uummannarmioqartorlu	Uummannaq+MIU-QAR+TUQ<ental<Absolut+LU
Uummannarmiuuit	Uummannaq+MIU-U<Interrogativ<du
Uummannarmiuulaarnikkalu	Uummannaq+MIU-U-LAAR+NIQ<flertal<min<Absolut+LU
Uummannarmiuulaartarlungali	Uummannaq+MIU-U-LAAR=TAR<Ledsagemåde<jeg+LI
Uummannarmiuulaartumik	Uummannaq+MIU-U-LAAR+TUQ<ental<Instrumentalis
Uummannarmiuulertoqanngillanuna	Uummannaq+MIU-U-LIR+TUQ-QAR-NNGIT<Indikativ<de+UNA
Uummannarmiuuniarnikkaana	Uummannaq+MIU-U+NIAR+NIQ<flertal<min<Absolut+UNA
Uummannarmiuusimallungalu	Uummannaq+MIU-U+SIMA<Ledsagemåde<jeg+LU
Uummannarmiuusimasarporli	Uummannaq+MIU-U+SIMA=TAR<Indikativ<han+LI
Uummannarmiuusimasarnerit	Uummannaq+MIU-U+SIMA=TAR+NIQ<flertal<Relativ
Uummannarmiuussagaluartumilli	Uummannaq+MIU-U-SSA=GALUAR+TUQ<ental<Instrumentalis+LI
Uummannarmiuussagaluartorpassuit	Uummannaq+MIU-U-SSA=GALUAR+TUQ+PASSUAQ<flertal<Absolut
Uummannarmiuussaagut	Uummannaq+MIU-U-SSA<Indikativ<vi
Uummannarmiuussavit	Uummannaq+MIU-U-SSA<Interrogativ<du
Uummannarmiuusormioqarnerli	Uummannaq+MIU-U+TUQ+MIU-QAR+NIQ<ental<Absolut+LI
Uummannarmiuusoqalaartartunnguuit	Uummannaq+MIU-U+TUQ-QAR-LAAR=TAR+TUQ-NNGUAQ-U<Interrogativ<du
Uummannamut	Uummannaq<Terminalis
Uummannamukalaarluni	Uummannaq<Terminalis-KAR-LAAR<Ledsagemåde<han_selv
Uummannamukalaartullu	Uummannaq<Terminalis-KAR-LAAR<Participium<de+LU
Uummannamukanngilatit	Uummannaq<Terminalis-KAR-NNGIT<Interrogativ<du
Uummannamukannginneq	Uummannaq<Terminalis-KAR-NNGIT+NIQ<ental<Absolut
Uummannamukanngitsoq	Uummannaq<Terminalis-KAR-NNGIT+TUQ<ental<Absolut
Uummannamukassavisi	Uummannaq<Terminalis-KAR-SSA<Interrogativ<I
Uummannamulli	Uummannaq<Terminalis+LI
Uummannamullu	Uummannaq<Terminalis+LU
Uummannamununa	Uummannaq<Terminalis+UNA
