aallartikkama	aallartip<Causativ<jeg
aallartippoq	aallartip<Indikativ<han
aallartiinnarama	aallartip-INNAR<Causativ<jeg
aallartiinnarpoq	aallartip-INNAR<Indikativ<han
aallartinnikuugama	aallartip+NIKUU<Causativ<jeg
aallartinnikuuvoq	aallartip+NIKUU<Indikativ<han
aallartinnerama	aallartip+NIR<Causativ<jeg
aallartinnerugama	aallartip+NIRU<Causativ<jeg
aallartinneruvoq	aallartip+NIRU<Indikativ<han
aallarteqqaarama	aallartip-QQAAR<Causativ<jeg
aallarteqqaarpoq	aallartip-QQAAR<Indikativ<han
aallarteqqummanga	aallartip-QQU<Causativ<HanMig
aallarteqqugakku	aallartip-QQU<Causativ<JegHam
aallarteqquaa	aallartip-QQU<Indikativ<HanHam
aallarteqquaanga	aallartip-QQU<Indikativ<HanMig
aallarteqquara	aallartip-QQU<Indikativ<JegHam
aallarteriarama	aallartip-RIAR<Causativ<jeg
aallartereerama	aallartip-RIIR<Causativ<jeg
aallartereerpoq	aallartip-RIIR<Indikativ<han
aallartippallaarama	aallartip+VALLAAR<Causativ<jeg
aallartippallaarpoq	aallartip+VALLAAR<Indikativ<han
aappaq	aappaq<ental<Absolut
aappama	aappaq<ental<min<Relativ
aappani	aappaq<ental<sin<Absolut
aappariit	aappaq+GIIT<flertal<Absolut
aappassaq	aappaq-SSAQ<ental<Absolut
aappassama	aappaq-SSAQ<ental<min<Relativ
aappassani	aappaq-SSAQ<ental<sin<Absolut
affaq	affaq<ental<Absolut
affama	affaq<ental<min<Relativ
affani	affaq<ental<sin<Absolut
affariit	affaq+GIIT<flertal<Absolut
affassaq	affaq-SSAQ<ental<Absolut
affassama	affaq-SSAQ<ental<min<Relativ
affassani	affaq-SSAQ<ental<sin<Absolut
aqqanilissat	aqqanillit-SSAQ<flertal<Absolut
aqqanillit	aqqanillit<Talord<Absolut<flertal
aqqutigimmanga	aqqutigә<Causativ<HanMig
aqqutigigakku	aqqutigә<Causativ<JegHam
aqqutigivaa	aqqutigә<Indikativ<HanHam
aqqutigivaanga	aqqutigә<Indikativ<HanMig
aqqutigiinnarmanga	aqqutigә-INNAR<Causativ<HanMig
aqqutigiinnarakku	aqqutigә-INNAR<Causativ<JegHam
aqqutigiinnarpaa	aqqutigә-INNAR<Indikativ<HanHam
aqqutigiinnarpaanga	aqqutigә-INNAR<Indikativ<HanMig
aqqutigiinnarpara	aqqutigә-INNAR<Indikativ<JegHam
aqqutiginikuummanga	aqqutigә+NIKUU<Causativ<HanMig
aqqutiginikuugakku	aqqutigә+NIKUU<Causativ<JegHam
aqqutiginikuuaa	aqqutigә+NIKUU<Indikativ<HanHam
aqqutiginikuuaanga	aqqutigә+NIKUU<Indikativ<HanMig
aqqutiginikuuara	aqqutigә+NIKUU<Indikativ<JegHam
aqqutigineqarama	aqqutigә+NIQAR<Causativ<jeg
aqqutigineqarpoq	aqqutigә+NIQAR<Indikativ<han
aqqutiginermanga	aqqutigә+NIR<Causativ<HanMig
aqqutiginerakku	aqqutigә+NIR<Causativ<JegHam
aqqutiginerummanga	aqqutigә+NIRU<Causativ<HanMig
aqqutigineruaa	aqqutigә+NIRU<Indikativ<HanHam
aqqutigineruaanga	aqqutigә+NIRU<Indikativ<HanMig
aqqutigineruara	aqqutigә+NIRU<Indikativ<JegHam
aqqutigeqqaarmanga	aqqutigә-QQAAR<Causativ<HanMig
aqqutigeqqaarakku	aqqutigә-QQAAR<Causativ<JegHam
aqqutigeqqaarpaa	aqqutigә-QQAAR<Indikativ<HanHam
aqqutigeqqaarpara	aqqutigә-QQAAR<Indikativ<JegHam
aqqutigeqqummanga	aqqutigә-QQU<Causativ<HanMig
aqqutigeqqugakku	aqqutigә-QQU<Causativ<JegHam
aqqutigeriarakku	aqqutigә-RIAR<Causativ<JegHam
aqqutigereermanga	aqqutigә-RIIR<Causativ<HanMig
aqqutigereerakku	aqqutigә-RIIR<Causativ<JegHam
aqqutigereerpaa	aqqutigә-RIIR<Indikativ<HanHam
aqqutigereerpaanga	aqqutigә-RIIR<Indikativ<HanMig
aqqutigereerpara	aqqutigә-RIIR<Indikativ<JegHam
aqqutigivallaarakku	aqqutigә+VALLAAR<Causativ<JegHam
aqqutigivallaarpaa	aqqutigә+VALLAAR<Indikativ<HanHam
aqqutigivallaarpara	aqqutigә+VALLAAR<Indikativ<JegHam
ingerlaannaq	ingerlaannaq<Partikel
maani	maani<Partikel
marluliaq	marluliaq<ental<Absolut
marlulissama	marluliaq<ental<min<Relativ
marlulissani	marluliaq<ental<sin<Absolut
marluliassaq	marluliaq-SSAQ<ental<Absolut
marluliassama	marluliaq-SSAQ<ental<min<Relativ
marluliassani	marluliaq-SSAQ<ental<sin<Absolut
naammassimmanga	naammassi<Causativ<HanMig
naammassigakku	naammassi<Causativ<JegHam
naammassivaa	naammassi<Indikativ<HanHam
naammassivaanga	naammassi<Indikativ<HanMig
naammassiinnarmanga	naammassi-INNAR<Causativ<HanMig
naammassiinnarakku	naammassi-INNAR<Causativ<JegHam
naammassiinnarpaa	naammassi-INNAR<Indikativ<HanHam
naammassiinnarpara	naammassi-INNAR<Indikativ<JegHam
naammassinikuummanga	naammassi+NIKUU<Causativ<HanMig
naammassinikuuaa	naammassi+NIKUU<Indikativ<HanHam
naammassinikuuaanga	naammassi+NIKUU<Indikativ<HanMig
naammassinikuuara	naammassi+NIKUU<Indikativ<JegHam
naammassineqarama	naammassi+NIQAR<Causativ<jeg
naammassineqarpoq	naammassi+NIQAR<Indikativ<han
naammassinermanga	naammassi+NIR<Causativ<HanMig
naammassinerakku	naammassi+NIR<Causativ<JegHam
naammassinerugakku	naammassi+NIRU<Causativ<JegHam
naammassineruaa	naammassi+NIRU<Indikativ<HanHam
naammassineruara	naammassi+NIRU<Indikativ<JegHam
naammasseqqaarmanga	naammassi-QQAAR<Causativ<HanMig
naammasseqqaarakku	naammassi-QQAAR<Causativ<JegHam
naammasseqqaarpaa	naammassi-QQAAR<Indikativ<HanHam
naammasseqqaarpaanga	naammassi-QQAAR<Indikativ<HanMig
naammasseqqaarpara	naammassi-QQAAR<Indikativ<JegHam
naammasseqqummanga	naammassi-QQU<Causativ<HanMig
naammasseqqugakku	naammassi-QQU<Causativ<JegHam
naammasseqquaa	naammassi-QQU<Indikativ<HanHam
naammasseqquara	naammassi-QQU<Indikativ<JegHam
naammasseriarmanga	naammassi-RIAR<Causativ<HanMig
naammasseriarakku	naammassi-RIAR<Causativ<JegHam
naammassereermanga	naammassi-RIIR<Causativ<HanMig
naammassereerakku	naammassi-RIIR<Causativ<JegHam
naammassereerpaa	naammassi-RIIR<Indikativ<HanHam
naammassereerpaanga	naammassi-RIIR<Indikativ<HanMig
naammassereerpara	naammassi-RIIR<Indikativ<JegHam
naammassivallaarmanga	naammassi+VALLAAR<Causativ<HanMig
naammassivallaarakku	naammassi+VALLAAR<Causativ<JegHam
naammassivallaarpaa	naammassi+VALLAAR<Indikativ<HanHam
naammassivallaarpaanga	naammassi+VALLAAR<Indikativ<HanMig
naammassivallaarpara	naammassi+VALLAAR<Indikativ<JegHam
nalummanga	nalu<Causativ<HanMig
nalugakku	nalu<Causativ<JegHam
naluaanga	nalu<Indikativ<HanMig
naluara	nalu<Indikativ<JegHam
naluinnarmanga	nalu-INNAR<Causativ<HanMig
naluinnarakku	nalu-INNAR<Causativ<JegHam
naluinnarpaanga	nalu-INNAR<Indikativ<HanMig
naluinnarpara	nalu-INNAR<Indikativ<JegHam
nalunikuummanga	nalu+NIKUU<Causativ<HanMig
nalunikuugakku	nalu+NIKUU<Causativ<JegHam
nalunikuuaa	nalu+NIKUU<Indikativ<HanHam
nalunikuuaanga	nalu+NIKUU<Indikativ<HanMig
nalunikuuara	nalu+NIKUU<Indikativ<JegHam
naluneqarama	nalu+NIQAR<Causativ<jeg
naluneqarpoq	nalu+NIQAR<Indikativ<han
nalunermanga	nalu+NIR<Causativ<HanMig
nalunerummanga	nalu+NIRU<Causativ<HanMig
nalunerugakku	nalu+NIRU<Causativ<JegHam
naluneruaanga	nalu+NIRU<Indikativ<HanMig
naluneruara	nalu+NIRU<Indikativ<JegHam
naloqqaarmanga	nalu-QQAAR<Causativ<HanMig
naloqqaarakku	nalu-QQAAR<Causativ<JegHam
naloqqaarpaa	nalu-QQAAR<Indikativ<HanHam
naloqqaarpaanga	nalu-QQAAR<Indikativ<HanMig
naloqqaarpara	nalu-QQAAR<Indikativ<JegHam
naloqqummanga	nalu-QQU<Causativ<HanMig
naloqqugakku	nalu-QQU<Causativ<JegHam
naloqquaa	nalu-QQU<Indikativ<HanHam
naloqquaanga	nalu-QQU<Indikativ<HanMig
naloqquara	nalu-QQU<Indikativ<JegHam
naloriarmanga	nalu-RIAR<Causativ<HanMig
naloriarakku	nalu-RIAR<Causativ<JegHam
naloreermanga	nalu-RIIR<Causativ<HanMig
naloreerakku	nalu-RIIR<Causativ<JegHam
naloreerpaa	nalu-RIIR<Indikativ<HanHam
naloreerpaanga	nalu-RIIR<Indikativ<HanMig
naloreerpara	nalu-RIIR<Indikativ<JegHam
naluallaarmanga	nalu+VALLAAR<Causativ<HanMig
naluallaarpaanga	nalu+VALLAAR<Indikativ<HanMig
nutserisoq	nutserisoq<ental<Absolut
nutserisuma	nutserisoq<ental<min<Relativ
nutserisuni	nutserisoq<ental<sin<Absolut
nutserisoriit	nutserisoq+GIIT<flertal<Absolut
nutserisussaq	nutserisoq-SSAQ<ental<Absolut
nutserisussama	nutserisoq-SSAQ<ental<min<Relativ
nutserisussani	nutserisoq-SSAQ<ental<sin<Absolut
oqarfigimmanga	oqarfigә<Causativ<HanMig
oqarfigigakku	oqarfigә<Causativ<JegHam
oqarfigivaa	oqarfigә<Indikativ<HanHam
oqarfigivaanga	oqarfigә<Indikativ<HanMig
oqarfigivara	oqarfigә<Indikativ<JegHam
oqarfigiinnarmanga	oqarfigә-INNAR<Causativ<HanMig
oqarfigiinnarakku	oqarfigә-INNAR<Causativ<JegHam
oqarfigiinnarpaa	oqarfigә-INNAR<Indikativ<HanHam
oqarfigiinnarpaanga	oqarfigә-INNAR<Indikativ<HanMig
oqarfigiinnarpara	oqarfigә-INNAR<Indikativ<JegHam
oqarfiginikuummanga	oqarfigә+NIKUU<Causativ<HanMig
oqarfiginikuugakku	oqarfigә+NIKUU<Causativ<JegHam
oqarfiginikuuaa	oqarfigә+NIKUU<Indikativ<HanHam
oqarfiginikuuaanga	oqarfigә+NIKUU<Indikativ<HanMig
oqarfiginikuuara	oqarfigә+NIKUU<Indikativ<JegHam
oqarfigineqarama	oqarfigә+NIQAR<Causativ<jeg
oqarfigineqarpoq	oqarfigә+NIQAR<Indikativ<han
oqarfiginermanga	oqarfigә+NIR<Causativ<HanMig
oqarfiginerakku	oqarfigә+NIR<Causativ<JegHam
oqarfiginerummanga	oqarfigә+NIRU<Causativ<HanMig
oqarfiginerugakku	oqarfigә+NIRU<Causativ<JegHam
oqarfigineruaa	oqarfigә+NIRU<Indikativ<HanHam
oqarfigineruaanga	oqarfigә+NIRU<Indikativ<HanMig
oqarfigineruara	oqarfigә+NIRU<Indikativ<JegHam
oqarfigeqqaarmanga	oqarfigә-QQAAR<Causativ<HanMig
oqarfigeqqaarakku	oqarfigә-QQAAR<Causativ<JegHam
oqarfigeqqaarpaa	oqarfigә-QQAAR<Indikativ<HanHam
oqarfigeqqaarpaanga	oqarfigә-QQAAR<Indikativ<HanMig
oqarfigeqqaarpara	oqarfigә-QQAAR<Indikativ<JegHam
oqarfigeqqummanga	oqarfigә-QQU<Causativ<HanMig
oqarfigeqqugakku	oqarfigә-QQU<Causativ<JegHam
oqarfigeqquaa	oqarfigә-QQU<Indikativ<HanHam
oqarfigeqquaanga	oqarfigә-QQU<Indikativ<HanMig
oqarfigeqquara	oqarfigә-QQU<Indikativ<JegHam
oqarfigeriarmanga	oqarfigә-RIAR<Causativ<HanMig
oqarfigeriarakku	oqarfigә-RIAR<Causativ<JegHam
oqarfigereermanga	oqarfigә-RIIR<Causativ<HanMig
oqarfigereerakku	oqarfigә-RIIR<Causativ<JegHam
oqarfigereerpaa	oqarfigә-RIIR<Indikativ<HanHam
oqarfigereerpaanga	oqarfigә-RIIR<Indikativ<HanMig
oqarfigereerpara	oqarfigә-RIIR<Indikativ<JegHam
oqarfigivallaarmanga	oqarfigә+VALLAAR<Causativ<HanMig
oqarfigivallaarakku	oqarfigә+VALLAAR<Causativ<JegHam
oqarfigivallaarpaa	oqarfigә+VALLAAR<Indikativ<HanHam
oqarfigivallaarpaanga	oqarfigә+VALLAAR<Indikativ<HanMig
oqarfigivallaarpara	oqarfigә+VALLAAR<Indikativ<JegHam
paasimmanga	paasi<Causativ<HanMig
paasigakku	paasi<Causativ<JegHam
paasivaa	paasi<Indikativ<HanHam
paasivaanga	paasi<Indikativ<HanMig
paasivara	paasi<Indikativ<JegHam
paasiinnarmanga	paasi-INNAR<Causativ<HanMig
paasiinnarakku	paasi-INNAR<Causativ<JegHam
paasiinnarpaa	paasi-INNAR<Indikativ<HanHam
paasiinnarpaanga	paasi-INNAR<Indikativ<HanMig
paasiinnarpara	paasi-INNAR<Indikativ<JegHam
paasinikuummanga	paasi+NIKUU<Causativ<HanMig
paasinikuugakku	paasi+NIKUU<Causativ<JegHam
paasinikuuaa	paasi+NIKUU<Indikativ<HanHam
paasinikuuaanga	paasi+NIKUU<Indikativ<HanMig
paasinikuuara	paasi+NIKUU<Indikativ<JegHam
paasineqarama	paasi+NIQAR<Causativ<jeg
paasineqarpoq	paasi+NIQAR<Indikativ<han
paasinermanga	paasi+NIR<Causativ<HanMig
paasinerakku	paasi+NIR<Causativ<JegHam
paasinerummanga	paasi+NIRU<Causativ<HanMig
paasinerugakku	paasi+NIRU<Causativ<JegHam
paasineruaa	paasi+NIRU<Indikativ<HanHam
paasineruaanga	paasi+NIRU<Indikativ<HanMig
paasineruara	paasi+NIRU<Indikativ<JegHam
paaseqqaarmanga	paasi-QQAAR<Causativ<HanMig
paaseqqaarakku	paasi-QQAAR<Causativ<JegHam
paaseqqaarpaa	paasi-QQAAR<Indikativ<HanHam
paaseqqaarpaanga	paasi-QQAAR<Indikativ<HanMig
paaseqqaarpara	paasi-QQAAR<Indikativ<JegHam
paaseqqummanga	paasi-QQU<Causativ<HanMig
paaseqqugakku	paasi-QQU<Causativ<JegHam
paaseqquaa	paasi-QQU<Indikativ<HanHam
paaseqquaanga	paasi-QQU<Indikativ<HanMig
paaseqquara	paasi-QQU<Indikativ<JegHam
paaseriarmanga	paasi-RIAR<Causativ<HanMig
paaseriarakku	paasi-RIAR<Causativ<JegHam
paasereermanga	paasi-RIIR<Causativ<HanMig
paasereerakku	paasi-RIIR<Causativ<JegHam
paasereerpaa	paasi-RIIR<Indikativ<HanHam
paasereerpaanga	paasi-RIIR<Indikativ<HanMig
paasereerpara	paasi-RIIR<Indikativ<JegHam
paasivallaarmanga	paasi+VALLAAR<Causativ<HanMig
paasivallaarakku	paasi+VALLAAR<Causativ<JegHam
paasivallaarpaa	paasi+VALLAAR<Indikativ<HanHam
paasivallaarpaanga	paasi+VALLAAR<Indikativ<HanMig
paasivallaarpara	paasi+VALLAAR<Indikativ<JegHam
qinnut	qinnut<ental<Absolut
qinnutima	qinnut<ental<min<Relativ
qinnutini	qinnut<ental<sin<Absolut
qinnutigiit	qinnut+GIIT<flertal<Absolut
qinnutissaq	qinnut-SSAQ<ental<Absolut
qinnutissama	qinnut-SSAQ<ental<min<Relativ
qinnutissani	qinnut-SSAQ<ental<sin<Absolut
sivikikkama	sivikip<Causativ<jeg
sivikippoq	sivikip<Indikativ<han
sivikiinnarama	sivikip-INNAR<Causativ<jeg
sivikiinnarpoq	sivikip-INNAR<Indikativ<han
sivikinnikuugama	sivikip+NIKUU<Causativ<jeg
sivikinnikuuvoq	sivikip+NIKUU<Indikativ<han
sivikinnerama	sivikip+NIR<Causativ<jeg
sivikinnerugama	sivikip+NIRU<Causativ<jeg
sivikinneruvoq	sivikip+NIRU<Indikativ<han
sivikeqqaarama	sivikip-QQAAR<Causativ<jeg
sivikeqqaarpoq	sivikip-QQAAR<Indikativ<han
sivikeqqummanga	sivikip-QQU<Causativ<HanMig
sivikeqqugakku	sivikip-QQU<Causativ<JegHam
sivikeqquaa	sivikip-QQU<Indikativ<HanHam
sivikeqquaanga	sivikip-QQU<Indikativ<HanMig
sivikeqquara	sivikip-QQU<Indikativ<JegHam
sivikeriarama	sivikip-RIAR<Causativ<jeg
sivikereerama	sivikip-RIIR<Causativ<jeg
sivikereerpoq	sivikip-RIIR<Indikativ<han
sivikippallaarama	sivikip+VALLAAR<Causativ<jeg
sivikippallaarpoq	sivikip+VALLAAR<Indikativ<han
soqutigimmanga	soqutigә<Causativ<HanMig
soqutigigakku	soqutigә<Causativ<JegHam
soqutigivaa	soqutigә<Indikativ<HanHam
soqutigivaanga	soqutigә<Indikativ<HanMig
soqutigivara	soqutigә<Indikativ<JegHam
soqutigiinnarmanga	soqutigә-INNAR<Causativ<HanMig
soqutigiinnarakku	soqutigә-INNAR<Causativ<JegHam
soqutigiinnarpaa	soqutigә-INNAR<Indikativ<HanHam
soqutigiinnarpaanga	soqutigә-INNAR<Indikativ<HanMig
soqutigiinnarpara	soqutigә-INNAR<Indikativ<JegHam
soqutiginikuummanga	soqutigә+NIKUU<Causativ<HanMig
soqutiginikuugakku	soqutigә+NIKUU<Causativ<JegHam
soqutiginikuuaa	soqutigә+NIKUU<Indikativ<HanHam
soqutiginikuuaanga	soqutigә+NIKUU<Indikativ<HanMig
soqutiginikuuara	soqutigә+NIKUU<Indikativ<JegHam
soqutigineqarama	soqutigә+NIQAR<Causativ<jeg
soqutigineqarpoq	soqutigә+NIQAR<Indikativ<han
soqutiginermanga	soqutigә+NIR<Causativ<HanMig
soqutiginerakku	soqutigә+NIR<Causativ<JegHam
soqutiginerummanga	soqutigә+NIRU<Causativ<HanMig
soqutiginerugakku	soqutigә+NIRU<Causativ<JegHam
soqutigineruaanga	soqutigә+NIRU<Indikativ<HanMig
soqutigineruara	soqutigә+NIRU<Indikativ<JegHam
soqutigeqqaarmanga	soqutigә-QQAAR<Causativ<HanMig
soqutigeqqaarakku	soqutigә-QQAAR<Causativ<JegHam
soqutigeqqaarpaa	soqutigә-QQAAR<Indikativ<HanHam
soqutigeqqaarpaanga	soqutigә-QQAAR<Indikativ<HanMig
soqutigeqqaarpara	soqutigә-QQAAR<Indikativ<JegHam
soqutigeqqugakku	soqutigә-QQU<Causativ<JegHam
soqutigeqquaanga	soqutigә-QQU<Indikativ<HanMig
soqutigeqquara	soqutigә-QQU<Indikativ<JegHam
soqutigeriarmanga	soqutigә-RIAR<Causativ<HanMig
soqutigeriarakku	soqutigә-RIAR<Causativ<JegHam
soqutigereermanga	soqutigә-RIIR<Causativ<HanMig
soqutigereerakku	soqutigә-RIIR<Causativ<JegHam
soqutigereerpaanga	soqutigә-RIIR<Indikativ<HanMig
soqutigereerpara	soqutigә-RIIR<Indikativ<JegHam
soqutigivallaarmanga	soqutigә+VALLAAR<Causativ<HanMig
soqutigivallaarakku	soqutigә+VALLAAR<Causativ<JegHam
soqutigivallaarpaanga	soqutigә+VALLAAR<Indikativ<HanMig
soqutigivallaarpara	soqutigә+VALLAAR<Indikativ<JegHam
sugama	su<Causativ<jeg
suvoq	su<Indikativ<han
suinnarpoq	su-INNAR<Indikativ<han
suliffinni	suliffik<ental<sin<Absolut
suliffigiit	suliffik+GIIT<flertal<Absolut
suliffissama	suliffik-SSAQ<ental<min<Relativ
suliffissani	suliffik-SSAQ<ental<sin<Absolut
sunikuugama	su+NIKUU<Causativ<jeg
sunikuuvoq	su+NIKUU<Indikativ<han
sunerama	su+NIR<Causativ<jeg
sunerugama	su+NIRU<Causativ<jeg
suneruvoq	su+NIRU<Indikativ<han
soqqaarama	su-QQAAR<Causativ<jeg
soqqaarpoq	su-QQAAR<Indikativ<han
soqqummanga	su-QQU<Causativ<HanMig
soqqugakku	su-QQU<Causativ<JegHam
soqquaa	su-QQU<Indikativ<HanHam
soqquaanga	su-QQU<Indikativ<HanMig
soqquara	su-QQU<Indikativ<JegHam
soriarama	su-RIAR<Causativ<jeg
soreerama	su-RIIR<Causativ<jeg
soreerpoq	su-RIIR<Indikativ<han
suallaarama	su+VALLAAR<Causativ<jeg
suallaarpoq	su+VALLAAR<Indikativ<han
taamak	taamak<Partikel
tulluarama	tulluar<Causativ<jeg
tulluarpoq	tulluar<Indikativ<han
tulluaannarama	tulluar-INNAR<Causativ<jeg
tulluaannarpoq	tulluar-INNAR<Indikativ<han
tulluarnikuugama	tulluar+NIKUU<Causativ<jeg
tulluarnikuuvoq	tulluar+NIKUU<Indikativ<han
tulluarnerama	tulluar+NIR<Causativ<jeg
tulluarnerugama	tulluar+NIRU<Causativ<jeg
tulluarneruvoq	tulluar+NIRU<Indikativ<han
tulluaqqaarama	tulluar-QQAAR<Causativ<jeg
tulluaqqaarpoq	tulluar-QQAAR<Indikativ<han
tulluaqqummanga	tulluar-QQU<Causativ<HanMig
tulluaqqugakku	tulluar-QQU<Causativ<JegHam
tulluaqquaa	tulluar-QQU<Indikativ<HanHam
tulluaqquaanga	tulluar-QQU<Indikativ<HanMig
tulluaqquara	tulluar-QQU<Indikativ<JegHam
tulluariarama	tulluar-RIAR<Causativ<jeg
tulluareerama	tulluar-RIIR<Causativ<jeg
tulluareerpoq	tulluar-RIIR<Indikativ<han
tulluarpallaarama	tulluar+VALLAAR<Causativ<jeg
tulluarpallaarpoq	tulluar+VALLAAR<Indikativ<han
tusagassiortoq	tusagassiortoq<ental<Absolut
tusagassiortuma	tusagassiortoq<ental<min<Relativ
tusagassiortuni	tusagassiortoq<ental<sin<Absolut
tusagassiortoriit	tusagassiortoq+GIIT<flertal<Absolut
tusagassiortussaq	tusagassiortoq-SSAQ<ental<Absolut
tusagassiortussama	tusagassiortoq-SSAQ<ental<min<Relativ
tusagassiortussani	tusagassiortoq-SSAQ<ental<sin<Absolut
tusilarama	tusilar<Causativ<jeg
tusilarpoq	tusilar<Indikativ<han
tusilaannarama	tusilar-INNAR<Causativ<jeg
tusilaannarpoq	tusilar-INNAR<Indikativ<han
tusilarnikuugama	tusilar+NIKUU<Causativ<jeg
tusilarnikuuvoq	tusilar+NIKUU<Indikativ<han
tusilarnerama	tusilar+NIR<Causativ<jeg
tusilarnerugama	tusilar+NIRU<Causativ<jeg
tusilarneruvoq	tusilar+NIRU<Indikativ<han
tusilaqqaarama	tusilar-QQAAR<Causativ<jeg
tusilaqqaarpoq	tusilar-QQAAR<Indikativ<han
tusilaqqummanga	tusilar-QQU<Causativ<HanMig
tusilaqqugakku	tusilar-QQU<Causativ<JegHam
tusilaqquaa	tusilar-QQU<Indikativ<HanHam
tusilaqquaanga	tusilar-QQU<Indikativ<HanMig
tusilaqquara	tusilar-QQU<Indikativ<JegHam
tusilariarama	tusilar-RIAR<Causativ<jeg
tusilareerama	tusilar-RIIR<Causativ<jeg
tusilareerpoq	tusilar-RIIR<Indikativ<han
tusilarpallaarpoq	tusilar+VALLAAR<Indikativ<han
uannit	uanga<Pronomen<Ablativ<jeg
uanga	uanga<Pronomen<jeg
uannut	uanga<Pronomen<Terminalis<jeg
ukiigama	ukii<Causativ<jeg
ukiivoq	ukii<Indikativ<han
ukiiginnarama	ukii-INNAR<Causativ<jeg
ukiiginnarpoq	ukii-INNAR<Indikativ<han
ukiinikuugama	ukii+NIKUU<Causativ<jeg
ukiinikuuvoq	ukii+NIKUU<Indikativ<han
ukiinerama	ukii+NIR<Causativ<jeg
ukiinerugama	ukii+NIRU<Causativ<jeg
ukiineruvoq	ukii+NIRU<Indikativ<han
ukeeqqaarama	ukii-QQAAR<Causativ<jeg
ukeeqqaarpoq	ukii-QQAAR<Indikativ<han
ukeeqqummanga	ukii-QQU<Causativ<HanMig
ukeeqqugakku	ukii-QQU<Causativ<JegHam
ukeeqquaa	ukii-QQU<Indikativ<HanHam
ukeeqquaanga	ukii-QQU<Indikativ<HanMig
ukeeqquara	ukii-QQU<Indikativ<JegHam
ukeeriarama	ukii-RIAR<Causativ<jeg
ukeereerama	ukii-RIIR<Causativ<jeg
ukeereerpoq	ukii-RIIR<Indikativ<han
ukiivallaarama	ukii+VALLAAR<Causativ<jeg
ukiivallaarpoq	ukii+VALLAAR<Indikativ<han
unikkama	unip<Causativ<jeg
unippoq	unip<Indikativ<han
uniinnarama	unip-INNAR<Causativ<jeg
uniinnarpoq	unip-INNAR<Indikativ<han
uninnikuugama	unip+NIKUU<Causativ<jeg
uninnikuuvoq	unip+NIKUU<Indikativ<han
uninnerama	unip+NIR<Causativ<jeg
uninnerugama	unip+NIRU<Causativ<jeg
uninneruvoq	unip+NIRU<Indikativ<han
uneqqaarama	unip-QQAAR<Causativ<jeg
uneqqaarpoq	unip-QQAAR<Indikativ<han
uneqqummanga	unip-QQU<Causativ<HanMig
uneqqugakku	unip-QQU<Causativ<JegHam
uneqquaa	unip-QQU<Indikativ<HanHam
uneqquaanga	unip-QQU<Indikativ<HanMig
uneqquara	unip-QQU<Indikativ<JegHam
uneriarama	unip-RIAR<Causativ<jeg
unereerama	unip-RIIR<Causativ<jeg
unereerpoq	unip-RIIR<Indikativ<han
unippallaarama	unip+VALLAAR<Causativ<jeg
unippallaarpoq	unip+VALLAAR<Indikativ<han
