aallarniarnikkali	aallar+NIAR+NIQ<flertal<min<Absolut+LI
aallaqqaaramali	aallar-QQAAR<Causativ<jeg+LI
aamma	aamma<Partikel
aammalu	aamma<Partikel+LU
aappalerinerli	aappaq-LIRI+NIQ+LI
aapparmiuni	aappaq+MIU<flertal<Lokalis
aalli	aap<Partikel+LI
aallu	aap<Partikel+LU
Aasiaat	Aasiaat<Absolut
Aasiaalli	Aasiaat<Absolut+LI
Aasiaallu	Aasiaat<Absolut+LU
Aasiaanuna	Aasiaat<Absolut+UNA
Aasiannik	Aasiaat<Instrumentalis
Aasiannilli	Aasiaat<Instrumentalis+LI
Aasiannillu	Aasiaat<Instrumentalis+LU
Aasianninguna	Aasiaat<Instrumentalis+UNA
Aasianni	Aasiaat<Lokalis
Aasianniiginnarlutilli	Aasiaat<Lokalis+IP-INNAR<Ledsagemåde<de_selv+LI
Aasianneeqqaarpunga	Aasiaat<Lokalis+IP-QQAAR<Indikativ<jeg
Aasianneeqqaarnerlu	Aasiaat<Lokalis+IP-QQAAR+NIQ+LU
Aasianneeqqutigilli	Aasiaat<Lokalis+IP-QQU<Imperativ<ViDem+LI
Aasianneeqqutigillu	Aasiaat<Lokalis+IP-QQU<Imperativ<ViDem+LU
Aasianneeriarpit	Aasiaat<Lokalis+IP-RIAR<Interrogativ<du
Aasianneereerpit	Aasiaat<Lokalis+IP-RIIR<Interrogativ<du
Aasianniissimasartunga	Aasiaat<Lokalis+IP+SIMA=TAR<Participium<jeg
Aasianniippallaarlutinguna	Aasiaat<Lokalis+IP+VALLAAR<Ledsagemåde<de_selv+UNA
Aasiannili	Aasiaat<Lokalis+LI
Aasiannilu	Aasiaat<Lokalis+LU
Aasiammiumeereerpit	Aasiaat+MIU<ental<Lokalis+IP-RIIR<Interrogativ<du
Aasiammiunilli	Aasiaat+MIU<flertal<Instrumentalis+LI
Aasiammiuneereerneq	Aasiaat+MIU<flertal<Lokalis+IP-RIIR+NIQ
Aasiammiuniuna	Aasiaat+MIU<flertal<Lokalis+UNA
Aasiammiulerigamaana	Aasiaat+MIU-LIRI<Causativ<jeg+UNA
Aasiammiulerivit	Aasiaat+MIU-LIRI<Interrogativ<du
Aasiammiulerisoqanngilaq	Aasiaat+MIU-LIRI+TUQ-QAR-NNGIT<Indikativ<han
Aasiammiunngornerusungalu	Aasiaat+MIU-NNGUR+NIRU<Participium<jeg+LU
Aasiammiunngoqquaajuna	Aasiaat+MIU-NNGUR-QQU<Indikativ<HanDem+UNA
Aasiammiunngorsinnaasoq	Aasiaat+MIU-NNGUR+SINNAA+TUQ<ental<Absolut
Aasiammioqarporli	Aasiaat+MIU-QAR<Indikativ<han+LI
Aasiammioqarporlu	Aasiaat+MIU-QAR<Indikativ<han+LU
Aasiammioqarneq	Aasiaat+MIU-QAR+NIQ
Aasiammioqarnerli	Aasiaat+MIU-QAR+NIQ+LI
Aasiammioqarnerlu	Aasiaat+MIU-QAR+NIQ+LU
Aasiammioqarneruna	Aasiaat+MIU-QAR+NIQ+UNA
Aasiammioqartorli	Aasiaat+MIU-QAR<Participium<han+LI
Aasiammioqartorlu	Aasiaat+MIU-QAR<Participium<han+LU
Aasiammioqartoq	Aasiaat+MIU-QAR+TUQ
Aasiammioqartorli	Aasiaat+MIU-QAR+TUQ+LI
Aasiammiuugaluarpungali	Aasiaat+MIU-U+GALUAR<Indikativ<jeg+LI
Aasiammiuugaluarpit	Aasiaat+MIU-U+GALUAR<Interrogativ<du
Aasiammiooqqaartuneeriarlutik	Aasiaat+MIU-U-QQAAR+TUQ<flertal<Lokalis+IP-RIAR<Ledsagemåde<de_selv
Aasiammiooqqugakku	Aasiaat+MIU-U-QQU<Causativ<JegHam
Aasiammiooqqutigilli	Aasiaat+MIU-U-QQU<Imperativ<ViDem+LI
Aasiammiooriarluni	Aasiaat+MIU-U-RIAR<Ledsagemåde<han_selv
Aasiammiooreerlutillu	Aasiaat+MIU-U-RIIR<Ledsagemåde<de_selv+LU
Aasiammiuusimasooreertussaralu	Aasiaat+MIU-U+SIMA+TUQ-U-RIIR+TUQ-SSAQ<ental<min<Absolut+LU
Aasiammiuusaramaana	Aasiaat+MIU-U+TAR<Causativ<jeg+UNA
Aasiammiuusartunga	Aasiaat+MIU-U+TAR<Participium<jeg
Aasiammiuuallaarnikkaana	Aasiaat+MIU-U+VALLAAR+NIQ<flertal<min<Absolut+UNA
Aasiannut	Aasiaat<Terminalis
Aasiannukalaarlutinguna	Aasiaat<Terminalis-KAR-LAAR<Ledsagemåde<de_selv+UNA
Aasiannukalaartartoq	Aasiaat<Terminalis-KAR-LAAR=TAR+TUQ
Aasiannukalerpugut	Aasiaat<Terminalis-KAR-LIR<Indikativ<vi
Aasiannukanngitsunga	Aasiaat<Terminalis-KAR-NNGIT<Participium<jeg
Aasiannukaqqugakkuli	Aasiaat<Terminalis-KAR-QQU<Causativ<JegHam+LI
Aasiannulli	Aasiaat<Terminalis+LI
Aasiannullu	Aasiaat<Terminalis+LU
Aasiannununa	Aasiaat<Terminalis+UNA
affaq	affaq<ental<Absolut
affaali	affaq<ental<hans<Absolut+LI
affara	affaq<ental<min<Absolut
affariinnukalaartaramalu	affaq+GIIT<flertal<Terminalis-KAR-LAAR=TAR<Causativ<jeg+LU
affariinnguinnarpugununa	affaq+GIIT-NNGUR-INNAR<Indikativ<vi+UNA
affarereerlugillu	affaq+GӘ-RIIR<Ledsagemåde<dem+LU
affaannaa	affaq-INNAQ<flertal<hans<Absolut
affarmiuussagaluarnerili	affaq+MIU-U-SSA=GALUAR+NIQ<flertal<hans<Absolut+LI
affanngoqqaarpit	affaq-NNGUR-QQAAR<Interrogativ<du
affanngoqqaartunga	affaq-NNGUR-QQAAR<Participium<jeg
affarpassuinuna	affaq+PASSUAQ<flertal<Absolut+UNA
affarpassuili	affaq+PASSUAQ<flertal<hans<Absolut+LI
affarpassuarneereernerli	affaq+PASSUAQ<flertal<Lokalis+IP-RIIR+NIQ+LI
affaqannginnama	affaq-QAR-NNGIT<Causativ<jeg
affaqariarlunilu	affaq-QAR-RIAR<Ledsagemåde<han_selv+LU
affassaqassagaluartunga	affaq-SSAQ-QAR-SSA=GALUAR<Participium<jeg
affaassavit	affaq-U-SSA<Interrogativ<du
akisooq	akisooq<ental<Absolut
akisoorlu	akisooq<ental<Absolut+LU
akisooruna	akisooq<ental<Absolut+UNA
akisuua	akisooq<ental<hans<Absolut
akisuui	akisooq<flertal<hans<Absolut
akisooriilli	akisooq+GIIT<flertal<Absolut+LI
akisooriilerigama	akisooq+GIIT-LIRI<Causativ<jeg
akisooritigilli	akisooq+GӘ<Imperativ<ViDem+LI
akisoorilerpaangalu	akisooq+GӘ-LIR<Indikativ<HanMig+LU
akisuuinnaasorpassuili	akisooq-INNAQ-U+TUQ+PASSUAQ<flertal<hans<Absolut+LI
akisuuliallu	akisooq-LIK<ental<deres+LU
akisuullilli	akisooq-LIK<flertal<Absolut+LI
akisuunngooqqaarpit	akisooq-NNGUAQ-U-QQAAR<Interrogativ<du
akisuunngoraluartorlu	akisooq-NNGUR+GALUAR<Participium<han+LU
akisooqalertorli	akisooq-QAR-LIR<Participium<han+LI
akisooqaqqaarnerli	akisooq-QAR-QQAAR+NIQ+LI
akisooqaqqugakkuuna	akisooq-QAR-QQU<Causativ<JegHam+UNA
akisuujulaartutulli	akisooq-U-LAAR+TUQ<ental<Aequalis+LI
akisoooriartununa	akisooq-U-RIAR<Participium<de+UNA
akisuujussagaluarpununa	akisooq-U-SSA=GALUAR<Indikativ<de+UNA
aleqaa	aleqa<flertal<hans<Absolut
aleqaneeqqaarneruna	aleqa<flertal<Lokalis+IP-QQAAR+NIQ+UNA
aleqaneeqqaartunga	aleqa<flertal<Lokalis+IP-QQAAR<Participium<jeg
aleqakka	aleqa<flertal<min<Absolut
aleqagiittulli	aleqa+GIIT<flertal<Aequalis+LI
aleqagiivili	aleqa+GIIT<flertal<hans<Absolut+LI
aleqagiinninguna	aleqa+GIIT<flertal<Instrumentalis+UNA
aleqagiinneeqqaartungalu	aleqa+GIIT<flertal<Lokalis+IP-QQAAR<Participium<jeg+LU
aleqagiinnukaqqaarlutinguna	aleqa+GIIT<flertal<Terminalis-KAR-QQAAR<Ledsagemåde<de_selv+UNA
aleqagiinngoqqutigit	aleqa+GIIT-NNGUR-QQU<Imperativ<ViDem
aleqagiviuk	aleqa+GӘ<Interrogativ<du-dem
aleqagilaartigilli	aleqa+GӘ-LAAR<Imperativ<ViDem+LI
aleqagilaartarakku	aleqa+GӘ-LAAR=TAR<Causativ<JegHam
aleqaginikuuassiuna	aleqa+GӘ+NIKUU<Indikativ<JegJer+UNA
aleqaannanngoqqutiginuna	aleqa-INNAQ-NNGUR-QQU<Imperativ<ViDem+UNA
aleqaannaaniarniniuna	aleqa-INNAQ-U+NIAR+NIQ<ental<sin<Absolut+UNA
aleqalerigama	aleqa-LIRI<Causativ<jeg
aleqalerillutik	aleqa-LIRI<Ledsagemåde<de_selv
aleqalerisut	aleqa-LIRI<Participium<de
aleqalerisunga	aleqa-LIRI<Participium<jeg
aleqalerisoqanngilaruna	aleqa-LIRI+TUQ-QAR-NNGIT<Indikativ<han+UNA
aleqamiunillu	aleqa+MIU<flertal<Instrumentalis+LU
aleqamiulerisulli	aleqa+MIU-LIRI<Participium<de+LI
aleqamiunngoqqaarpit	aleqa+MIU-NNGUR-QQAAR<Interrogativ<du
aleqamiooqquiuk	aleqa+MIU-U-QQU<Interrogativ<du-dem
aleqanngua	aleqa-NNGUAQ<ental<hans<Absolut
aleqanngooqqummanga	aleqa-NNGUAQ-U-QQU<Causativ<HanMig
aleqannguinnaramalu	aleqa-NNGUR-INNAR<Causativ<jeg+LU
aleqarpassuakka	aleqa+PASSUAQ<flertal<min<Absolut
aleqarpassuarnukalaartarlutilli	aleqa+PASSUAQ<flertal<Terminalis-KAR-LAAR=TAR<Ledsagemåde<de_selv+LI
aleqassameeriarpit	aleqa-SSAQ<ental<Lokalis+IP-RIAR<Interrogativ<du
aleqassameereerpit	aleqa-SSAQ<ental<Lokalis+IP-RIIR<Interrogativ<du
aleqaaqqutigit	aleqa-U-QQU<Imperativ<ViDem
aleqaasooriaramaana	aleqa-U+TUQ-U-RIAR<Causativ<jeg+UNA
anaanagiinnukariarpit	anaana+GIIT<flertal<Terminalis-KAR-RIAR<Interrogativ<du
anaanagisaraluarakku	anaana+GӘ+TAR=GALUAR<Causativ<JegHam
anaanamioqartoruna	anaana+MIU-QAR<Participium<han+UNA
anaanassaq	anaana-SSAQ<ental<Absolut
angajunngoqqaarama	angaju-NNGUR-QQAAR<Causativ<jeg
angajoqanngilatit	angaju-QAR-NNGIT<Interrogativ<du
angajoqaqqaartulli	angaju-QAR-QQAAR<Participium<de+LI
angajooreerpunga	angaju-U-RIIR<Indikativ<jeg
angununa	angut<ental<Absolut+UNA
angummi	angut<ental<Lokalis
angummukalaartarpit	angut<ental<Terminalis-KAR-LAAR=TAR<Interrogativ<du
angutigeqqaarakkuuna	angut+GӘ-QQAAR<Causativ<JegHam+UNA
angutinngoriarama	angut-NNGUR-RIAR<Causativ<jeg
ania	ani<ental<hans<Absolut
anima	ani<ental<min>Relativ
animukalaarpit	ani<ental<Terminalis-KAR-LAAR<Interrogativ<du
anigigaluarlugit	ani+GӘ+GALUAR<Ledsagemåde<dem
anerpassui	ani+PASSUAQ<flertal<hans<Absolut
anerpassuakka	ani+PASSUAQ<flertal<min<Absolut
aneqanngilatit	ani-QAR-NNGIT<Interrogativ<du
aneqariarluni	ani-QAR-RIAR<Ledsagemåde<han_selv
aneqareernikkali	ani-QAR-RIIR+NIQ<flertal<min<Absolut+LI
aneqassagaluarnermulli	ani-QAR-SSA=GALUAR+NIQ<ental<Terminalis+LI
anissalerineruna	ani-SSAQ-LIRI+NIQ+UNA
aqqalorpassuit	aqqalu+PASSUAQ<flertal<Absolut
aqqaloqalaartarnernukaannarpit	aqqalu-QAR-LAAR=TAR+NIQ<flertal<Terminalis-KAR-INNAR<Interrogativ<du
aqqaloqariartununa	aqqalu-QAR-RIAR<Participium<de+UNA
aqqaloqassallutinguna	aqqalu-QAR-SSA<Ledsagemåde<de_selv+UNA
aqqalooqqugakkuli	aqqalu-U-QQU<Causativ<JegHam+LI
aqqaniliinnalerivorli	aqqanillit-INNAQ-LIRI<Indikativ<han+LI
aqqaniliinnanngorniarnerilli	aqqanillit-INNAQ-NNGUR+NIAR+NIQ<flertal<Absolut+LI
aqqanilinngoriarpugulli	aqqanillit-NNGUR-RIAR<Indikativ<vi+LI
aqqanillit	aqqanillit<Talord<flertal<Absolut
aqqanillillu	aqqanillit<Talord<flertal<Absolut+LU
aqqanillinuna	aqqanillit<Talord<flertal<Absolut+UNA
aqqanilinnukalaartoruna	aqqanillit<Talord<flertal<Terminalis-KAR-LAAR+TUQ+UNA
aqqutigigakku	aqqutigә<Causativ<JegHam
aqqutigiinnarlugilli	aqqutigә-INNAR<Ledsagemåde<dem+LI
aqqutiginiarnagilli	aqqutigә+NIAR=NNGIT<Ledsagemåde<dem+LI
aqqutiginiarnagu	aqqutigә+NIAR=NNGIT<Ledsagemåde<ham
aqqutiginikuummanga	aqqutigә+NIKUU<Causativ<HanMig
aqqutiginikuutigillu	aqqutigә+NIKUU<Imperativ<ViDem+LU
aqqutiginikuuiuk	aqqutigә+NIKUU<Interrogativ<du-dem
aqqutigissatigit	aqqutigә-SSA<Imperativ<ViDem
aqqutigivallaartiginuna	aqqutigә+VALLAAR<Imperativ<ViDem+UNA
arnaq	arnaq<ental<Absolut
arnarlu	arnaq<ental<Absolut+LU
arnara	arnaq<ental<min<Absolut
arnanik	arnaq<flertal<Instrumentalis
arnariinnik	arnaq+GIIT<flertal<Instrumentalis
arnarinerutigit	arnaq+GӘ+NIRU<Imperativ<ViDem
arnallillu	arnaq-LIK<flertal<Absolut+LU
arnallinuna	arnaq-LIK<flertal<Absolut+UNA
arnarmiulerivungaana	arnaq+MIU-LIRI<Indikativ<jeg+UNA
arnannguilu	arnaq-NNGUAQ<flertal<hans<Absolut+LU
arnaqaannartunga	arnaq-QAR-INNAR<Participium<jeg
arnaqanngillat	arnaq-QAR-NNGIT<Indikativ<de
arnassamullu	arnaq-SSAQ<ental<Terminalis+LU
arnaallutillu	arnaq-U<Ledsagemåde<de_selv+LU
assersuulli	assersuut<ental<Absolut+LI
assersuullu	assersuut<ental<Absolut+LU
assersuununa	assersuut<ental<Absolut+UNA
assersuummik	assersuut<ental<Instrumentalis
assersuummillu	assersuut<ental<Instrumentalis+LU
assersuumminguna	assersuut<ental<Instrumentalis+UNA
assersuummiilaartartoqarpoq	assersuut<ental<Lokalis+IP-LAAR=TAR+TUQ-QAR<Indikativ<han
assersuummeeqqaarpit	assersuut<ental<Lokalis+IP-QQAAR<Interrogativ<du
assersuummeeriarama	assersuut<ental<Lokalis+IP-RIAR<Causativ<jeg
assersuummeeriarnerli	assersuut<ental<Lokalis+IP-RIAR+NIQ+LI
assersuutimali	assersuut<ental<min>Relativ+LI
assersuummukalaartarpugulli	assersuut<ental<Terminalis-KAR-LAAR=TAR<Indikativ<vi+LI
assersuummukareerlutik	assersuut<ental<Terminalis-KAR-RIIR<Ledsagemåde<de_selv
assersuummulli	assersuut<ental<Terminalis+LI
assersuummullu	assersuut<ental<Terminalis+LU
assersuummununa	assersuut<ental<Terminalis+UNA
assersuutigisimasarpiuk	assersuut+GӘ+SIMA=TAR<Interrogativ<du-dem
assersuutigivallaarluginuna	assersuut+GӘ+VALLAAR<Ledsagemåde<dem+UNA
assersuutilikka	assersuut-LIK<flertal<min<Absolut
assersuuteqariartungaana	assersuut-QAR-RIAR<Participium<jeg+UNA
ataasiinnanngoramalu	ataaseq-INNAQ-NNGUR<Causativ<jeg+LU
ataasinngunngitsorli	ataaseq-NNGUR-NNGIT<Participium<han+LI
ataatsitulli	ataaseq<Talord<ental<Aequalis+LI
ataatsimillu	ataaseq<Talord<Instrumentalis+LU
ataatsimeeqqaarneq	ataaseq<Talord<Lokalis+IP-QQAAR+NIQ
ataatsimut	ataaseq<Talord<Terminalis
ataatsimukalaartartoruna	ataaseq<Talord<Terminalis-KAR-LAAR=TAR+TUQ+UNA
ataatsimukassagaluartununa	ataaseq<Talord<Terminalis-KAR-SSA=GALUAR<Participium<de+UNA
ataatanik	ataata<flertal<Instrumentalis
ataatagiinnut	ataata+GIIT<flertal<Terminalis
atiali	ateq<ental<hans<Absolut+LI
ateriilli	ateq+GIIT<flertal<Absolut+LI
atillit	ateq-LIK<flertal<Absolut
atilikkaana	ateq-LIK<flertal<min<Absolut+UNA
atermioqarneruna	ateq+MIU-QAR+NIQ+UNA
atissaalu	ateq-SSAQ<flertal<hans<Absolut+LU
atulaarpaa	ator-LAAR<Indikativ<HanHam
atulaartartoq	ator-LAAR=TAR<Participium<han
atulertigilli	ator-LIR<Imperativ<ViDem+LI
atoqqummanga	ator-QQU<Causativ<HanMig
atoqqugakku	ator-QQU<Causativ<JegHam
atoreertigit	ator-RIIR<Imperativ<ViDem
atuakkialerinerneeriarneq	atuakkialerineq<flertal<Lokalis+IP-RIAR+NIQ
atuakkialerininnguaneeriarpugulli	atuakkialerineq-NNGUAQ<ental<hans<Lokalis+IP-RIAR<Indikativ<vi+LI
atuarnianngitsullinuna	atuar+NIAR=NNGIT+TUQ-LIK<flertal<Absolut+UNA
atuariarlunga	atuar-RIAR<Ledsagemåde<jeg
Avanersuaq	Avanersuaq<Absolut
Avanersuarli	Avanersuaq<Absolut+LI
Avanersuarlu	Avanersuaq<Absolut+LU
Avanersuaruna	Avanersuaq<Absolut+UNA
Avanersuarmik	Avanersuaq<Instrumentalis
Avanersuarmillu	Avanersuaq<Instrumentalis+LU
Avanersuarminguna	Avanersuaq<Instrumentalis+UNA
Avanersuarmi	Avanersuaq<Lokalis
Avanersuarmiilaarlutik	Avanersuaq<Lokalis+IP-LAAR<Ledsagemåde<de_selv
Avanersuarmiilertunga	Avanersuaq<Lokalis+IP-LIR<Participium<jeg
Avanersuarmiinnginneruna	Avanersuaq<Lokalis+IP-NNGIT+NIQ+UNA
Avanersuarmeeqqaarpit	Avanersuaq<Lokalis+IP-QQAAR<Interrogativ<du
Avanersuarmeeqquaanga	Avanersuaq<Lokalis+IP-QQU<Indikativ<HanMig
Avanersuarmeeriarama	Avanersuaq<Lokalis+IP-RIAR<Causativ<jeg
Avanersuarmeeriartoq	Avanersuaq<Lokalis+IP-RIAR<Participium<han
Avanersuarmeeriartoqanngilarli	Avanersuaq<Lokalis+IP-RIAR+TUQ-QAR-NNGIT<Indikativ<han+LI
Avanersuarmeereerpit	Avanersuaq<Lokalis+IP-RIIR<Interrogativ<du
Avanersuarmili	Avanersuaq<Lokalis+LI
Avanersuarmiuna	Avanersuaq<Lokalis+UNA
Avanersuarmiumeereerlutik	Avanersuaq+MIU<ental<Lokalis+IP-RIIR<Ledsagemåde<de_selv
Avanersuarmiuniilaarpugullu	Avanersuaq+MIU<flertal<Lokalis+IP-LAAR<Indikativ<vi+LU
Avanersuarmiunili	Avanersuaq+MIU<flertal<Lokalis+LI
Avanersuarmiulerigamalu	Avanersuaq+MIU-LIRI<Causativ<jeg+LU
Avanersuarmiulerivit	Avanersuaq+MIU-LIRI<Interrogativ<du
Avanersuarmiulerisununa	Avanersuaq+MIU-LIRI<Participium<de+UNA
Avanersuarmioqarneq	Avanersuaq+MIU-QAR+NIQ
Avanersuarmioqarnerli	Avanersuaq+MIU-QAR+NIQ+LI
Avanersuarmioqartoq	Avanersuaq+MIU-QAR<Participium<han
Avanersuarmioqartorli	Avanersuaq+MIU-QAR<Participium<han+LI
Avanersuarmioqartoq	Avanersuaq+MIU-QAR+TUQ
Avanersuarmioqartorli	Avanersuaq+MIU-QAR+TUQ+LI
Avanersuarmioqartorlu	Avanersuaq+MIU-QAR+TUQ+LU
Avanersuarmiooriarama	Avanersuaq+MIU-U-RIAR<Causativ<jeg
Avanersuarmut	Avanersuaq<Terminalis
Avanersuarmukarpoq	Avanersuaq<Terminalis-KAR<Indikativ<han
Avanersuarmukaannarpugununa	Avanersuaq<Terminalis-KAR-INNAR<Indikativ<vi+UNA
Avanersuarmukaannarpit	Avanersuaq<Terminalis-KAR-INNAR<Interrogativ<du
Avanersuarmukalaartut	Avanersuaq<Terminalis-KAR-LAAR<Participium<de
Avanersuarmukalerpit	Avanersuaq<Terminalis-KAR-LIR<Interrogativ<du
Avanersuarmukareertungali	Avanersuaq<Terminalis-KAR-RIIR<Participium<jeg+LI
Avanersuarmukassagaluartunga	Avanersuaq<Terminalis-KAR-SSA=GALUAR<Participium<jeg
Avanersuarmulli	Avanersuaq<Terminalis+LI
Avanersuarmullu	Avanersuaq<Terminalis+LU
eqqaamagaluartigit	eqqaama+GALUAR<Imperativ<ViDem
eqqaamatigit	eqqaama<Imperativ<ViDem
eqqaamatiginuna	eqqaama<Imperativ<ViDem+UNA
eqqaamavaat	eqqaama<Indikativ<DeHam
eqqaamavagullu	eqqaama<Indikativ<ViDem+LU
eqqaamaannartigillu	eqqaama-INNAR<Imperativ<ViDem+LU
eqqaamalaarlugillu	eqqaama-LAAR<Ledsagemåde<dem+LU
eqqaamalaarluguli	eqqaama-LAAR<Ledsagemåde<ham+LI
eqqaamalaartartigilli	eqqaama-LAAR=TAR<Imperativ<ViDem+LI
eqqaamaniarmanga	eqqaama+NIAR<Causativ<HanMig
eqqaamaniannginnakku	eqqaama+NIAR=NNGIT<Causativ<JegHam
eqqaamanikuutiginuna	eqqaama+NIKUU<Imperativ<ViDem+UNA
eqqaamaneqarama	eqqaama+NIQAR<Causativ<jeg
eqqaamaneqarnerni	eqqaama+NIQAR+NIQ<flertal<Lokalis
eqqaamanermangaana	eqqaama+NIR<Causativ<HanMig+UNA
eqqaamanerakkuli	eqqaama+NIR<Causativ<JegHam+LI
eqqaamanerlugit	eqqaama+NIR<Ledsagemåde<dem
eqqaamanerutigit	eqqaama+NIRU<Imperativ<ViDem
eqqaamaneruaanga	eqqaama+NIRU<Indikativ<HanMig
eqqaamaneruara	eqqaama+NIRU<Indikativ<JegHam
eqqaamanagulu	eqqaama-NNGIT<Ledsagemåde<ham+LU
eqqaamaqqaarpaanga	eqqaama-QQAAR<Indikativ<HanMig
eqqaamaqquiuk	eqqaama-QQU<Interrogativ<du-dem
eqqaamariarakku	eqqaama-RIAR<Causativ<JegHam
eqqaamareermanga	eqqaama-RIIR<Causativ<HanMig
eqqaamasinnaavaallu	eqqaama+SINNAA<Indikativ<DeHam+LU
eqqaamasinnaavaanuna	eqqaama+SINNAA<Indikativ<DeHam+UNA
eqqaamasinnaallugu	eqqaama+SINNAA<Ledsagemåde<ham
eqqaamassagakkuli	eqqaama-SSA<Causativ<JegHam+LI
eqqaamassagaluartigit	eqqaama-SSA=GALUAR<Imperativ<ViDem
eqqaamassagaluarluguli	eqqaama-SSA=GALUAR<Ledsagemåde<ham+LI
eqqaamavallaarlugillu	eqqaama+VALLAAR<Ledsagemåde<dem+LU
eqqaamavallaanngimmangali	eqqaama+VALLAAR=NNGIT<Causativ<HanMig+LI
eqqaa	eqqaq<ental<hans<Absolut
eqqaali	eqqaq<ental<hans<Absolut+LI
eqqaani	eqqaq<ental<Lokalis<hans
eqqaaniilaarlutillu	eqqaq<ental<Lokalis<hans+IP-LAAR<Ledsagemåde<de_selv+LU
eqqaaniillutik	eqqaq<ental<Lokalis<hans+IP<Ledsagemåde<de_selv
eqqaaneeqqutiginuna	eqqaq<ental<Lokalis<hans+IP-QQU<Imperativ<ViDem+UNA
eqqaaneereertoq	eqqaq<ental<Lokalis<hans+IP-RIIR<Participium<han
eqqaaniuna	eqqaq<ental<Lokalis<hans+UNA
eqqara	eqqaq<ental<min<Absolut
eqqarali	eqqaq<ental<min<Absolut+LI
eqqaralu	eqqaq<ental<min<Absolut+LU
eqqaraana	eqqaq<ental<min<Absolut+UNA
eqqama	eqqaq<ental<min>Relativ
eqqamalu	eqqaq<ental<min>Relativ+LU
eqqani	eqqaq<ental<sin<Absolut
eqqanili	eqqaq<ental<sin<Absolut+LI
eqqaanukalerpungaana	eqqaq<ental<Terminalis<hans-KAR-LIR<Indikativ<jeg+UNA
eqqaanullu	eqqaq<ental<Terminalis<hans+LU
eqqannguaneereernerlu	eqqaq-NNGUAQ<ental<hans<Lokalis+IP-RIIR+NIQ+LU
eqqannguanili	eqqaq-NNGUAQ<ental<hans<Lokalis+LI
eqqanngui	eqqaq-NNGUAQ<flertal<hans<Absolut
eqqannguili	eqqaq-NNGUAQ<flertal<hans<Absolut+LI
eqqanngualerillutik	eqqaq-NNGUAQ-LIRI<Ledsagemåde<de_selv
eqqannguunerama	eqqaq-NNGUAQ-U+NIR<Causativ<jeg
eqqanngooqqaarninilu	eqqaq-NNGUAQ-U-QQAAR+NIQ<ental<sin<Absolut+LU
eqqanngooqqaartunga	eqqaq-NNGUAQ-U-QQAAR<Participium<jeg
eqqanngooqqaartoqalaartartooqqaartunngussasunga	eqqaq-NNGUAQ-U-QQAAR+TUQ-QAR-LAAR=TAR+TUQ-U-QQAAR+TUQ-NNGUR-SSA<Participium<jeg
eqqanngooqqutiginuna	eqqaq-NNGUAQ-U-QQU<Imperativ<ViDem+UNA
eqqanngooqqullugilli	eqqaq-NNGUAQ-U-QQU<Ledsagemåde<dem+LI
eqqanngooriaramali	eqqaq-NNGUAQ-U-RIAR<Causativ<jeg+LI
eqqanngooriarluni	eqqaq-NNGUAQ-U-RIAR<Ledsagemåde<han_selv
eqqanngooriarlunilu	eqqaq-NNGUAQ-U-RIAR<Ledsagemåde<han_selv+LU
eqqanngooriarlungaana	eqqaq-NNGUAQ-U-RIAR<Ledsagemåde<jeg+UNA
eqqannguusinnaavit	eqqaq-NNGUAQ-U+SINNAA<Interrogativ<du
eqqannguusaraluarnini	eqqaq-NNGUAQ-U+TAR=GALUAR+NIQ<ental<sin<Absolut
eqqannguusunngooriarluniuna	eqqaq-NNGUAQ-U+TUQ-NNGUAQ-U-RIAR<Ledsagemåde<han_selv+UNA
eqqumiitsuliortoq	eqqumiitsuliortoq<ental<Absolut
eqqumiitsuliortorli	eqqumiitsuliortoq<ental<Absolut+LI
eqqumiitsuliortualu	eqqumiitsuliortoq<ental<hans<Absolut+LU
eqqumiitsuliortora	eqqumiitsuliortoq<ental<min<Absolut
eqqumiitsuliortorali	eqqumiitsuliortoq<ental<min<Absolut+LI
eqqumiitsuliortuma	eqqumiitsuliortoq<ental<min>Relativ
eqqumiitsuliortuni	eqqumiitsuliortoq<ental<sin<Absolut
eqqumiitsuliortunik	eqqumiitsuliortoq<flertal<Instrumentalis
eqqumiitsuliortunillu	eqqumiitsuliortoq<flertal<Instrumentalis+LU
eqqumiitsuliortuneeqqaarama	eqqumiitsuliortoq<flertal<Lokalis+IP-QQAAR<Causativ<jeg
eqqumiitsuliortuneeqqaarpugununa	eqqumiitsuliortoq<flertal<Lokalis+IP-QQAAR<Indikativ<vi+UNA
eqqumiitsuliortukka	eqqumiitsuliortoq<flertal<min<Absolut
eqqumiitsuliortoriinngoqqaartulerivit	eqqumiitsuliortoq+GIIT-NNGUR-QQAAR+TUQ-LIRI<Interrogativ<du
eqqumiitsuliortorissagaluartigit	eqqumiitsuliortoq+GӘ-SSA=GALUAR<Imperativ<ViDem
eqqumiitsuliortorissatigit	eqqumiitsuliortoq+GӘ-SSA<Imperativ<ViDem
eqqumiitsuliortuinnakka	eqqumiitsuliortoq-INNAQ<flertal<min<Absolut
eqqumiitsuliortuinnakkali	eqqumiitsuliortoq-INNAQ<flertal<min<Absolut+LI
eqqumiitsuliortuinnaqalaarpit	eqqumiitsuliortoq-INNAQ-QAR-LAAR<Interrogativ<du
eqqumiitsuliortuinnaanerillu	eqqumiitsuliortoq-INNAQ-U+NIQ<flertal<Absolut+LU
eqqumiitsuliortuinnaasungali	eqqumiitsuliortoq-INNAQ-U<Participium<jeg+LI
eqqumiitsuliortulilli	eqqumiitsuliortoq-LIK<ental<Absolut+LI
eqqumiitsuliortulillu	eqqumiitsuliortoq-LIK<ental<Absolut+LU
eqqumiitsuliortulinguna	eqqumiitsuliortoq-LIK<ental<Absolut+UNA
eqqumiitsuliortulialli	eqqumiitsuliortoq-LIK<ental<deres+LI
eqqumiitsuliortuliallu	eqqumiitsuliortoq-LIK<ental<deres+LU
eqqumiitsuliortullit	eqqumiitsuliortoq-LIK<flertal<Absolut
eqqumiitsuliortullillu	eqqumiitsuliortoq-LIK<flertal<Relativ+LU
eqqumiitsuliortulerigama	eqqumiitsuliortoq-LIRI<Causativ<jeg
eqqumiitsuliortulerivunga	eqqumiitsuliortoq-LIRI<Indikativ<jeg
eqqumiitsuliortulerillutik	eqqumiitsuliortoq-LIRI<Ledsagemåde<de_selv
eqqumiitsuliortulerillutinguna	eqqumiitsuliortoq-LIRI<Ledsagemåde<de_selv+UNA
eqqumiitsuliortulerisoq	eqqumiitsuliortoq-LIRI<Participium<han
eqqumiitsuliortulerisoq	eqqumiitsuliortoq-LIRI+TUQ
eqqumiitsuliortulerisoqanngilarlu	eqqumiitsuliortoq-LIRI+TUQ-QAR-NNGIT<Indikativ<han+LU
eqqumiitsuliortormiulerivit	eqqumiitsuliortoq+MIU-LIRI<Interrogativ<du
eqqumiitsuliortormiooriarlutik	eqqumiitsuliortoq+MIU-U-RIAR<Ledsagemåde<de_selv
eqqumiitsuliortunnguamut	eqqumiitsuliortoq-NNGUAQ<ental<Terminalis
eqqumiitsuliortunngunngitsungali	eqqumiitsuliortoq-NNGUR-NNGIT<Participium<jeg+LI
eqqumiitsuliortunngoqqaartoq	eqqumiitsuliortoq-NNGUR-QQAAR<Participium<han
eqqumiitsuliortunngoreerlutillu	eqqumiitsuliortoq-NNGUR-RIIR<Ledsagemåde<de_selv+LU
eqqumiitsuliortunngussagaluarama	eqqumiitsuliortoq-NNGUR-SSA=GALUAR<Causativ<jeg
eqqumiitsuliortorpassuit	eqqumiitsuliortoq+PASSUAQ<flertal<Absolut
eqqumiitsuliortorpassui	eqqumiitsuliortoq+PASSUAQ<flertal<hans<Absolut
eqqumiitsuliortorpassuakka	eqqumiitsuliortoq+PASSUAQ<flertal<min<Absolut
eqqumiitsuliortoqaannartulli	eqqumiitsuliortoq-QAR-INNAR<Participium<de+LI
eqqumiitsuliortoqaannartumik	eqqumiitsuliortoq-QAR-INNAR+TUQ<ental<Instrumentalis
eqqumiitsuliortoqarneramaana	eqqumiitsuliortoq-QAR+NIR<Causativ<jeg+UNA
eqqumiitsuliortoqaqqaartooqqaartussaraana	eqqumiitsuliortoq-QAR-QQAAR+TUQ-U-QQAAR+TUQ-SSAQ<ental<min<Absolut+UNA
eqqumiitsuliortoqariarlungali	eqqumiitsuliortoq-QAR-RIAR<Ledsagemåde<jeg+LI
eqqumiitsuliortoqareerlutik	eqqumiitsuliortoq-QAR-RIIR<Ledsagemåde<de_selv
eqqumiitsuliortoqareerlutinguna	eqqumiitsuliortoq-QAR-RIIR<Ledsagemåde<de_selv+UNA
eqqumiitsuliortoqareernera	eqqumiitsuliortoq-QAR-RIIR+NIQ<ental<hans<Absolut
eqqumiitsuliortoqareertorlu	eqqumiitsuliortoq-QAR-RIIR<Participium<han+LU
eqqumiitsuliortoqassagaluarnikka	eqqumiitsuliortoq-QAR-SSA=GALUAR+NIQ<flertal<min<Absolut
eqqumiitsuliortussaqaqqaarnertullu	eqqumiitsuliortoq-SSAQ-QAR-QQAAR+NIQ<ental<Aequalis+LU
eqqumiitsuliortussaqariarlutilli	eqqumiitsuliortoq-SSAQ-QAR-RIAR<Ledsagemåde<de_selv+LI
eqqumiitsuliortuugama	eqqumiitsuliortoq-U<Causativ<jeg
eqqumiitsuliortuujartorninilu	eqqumiitsuliortoq-U+GIARTUR+NIQ<ental<sin<Absolut+LU
eqqumiitsuliortuuit	eqqumiitsuliortoq-U<Interrogativ<du
eqqumiitsuliortuunertut	eqqumiitsuliortoq-U+NIR<Participium<de
eqqumiitsuliortooqqaarama	eqqumiitsuliortoq-U-QQAAR<Causativ<jeg
eqqumiitsuliortooqqaarnikkalu	eqqumiitsuliortoq-U-QQAAR+NIQ<flertal<min<Absolut+LU
eqqumiitsuliortooqqaartoruna	eqqumiitsuliortoq-U-QQAAR<Participium<han+UNA
eqqumiitsuliortooqqaartormiu	eqqumiitsuliortoq-U-QQAAR+TUQ+MIU<ental<Absolut
eqqumiitsuliortooqqutigillu	eqqumiitsuliortoq-U-QQU<Imperativ<ViDem+LU
eqqumiitsuliortooqqutiginuna	eqqumiitsuliortoq-U-QQU<Imperativ<ViDem+UNA
eqqumiitsuliortooqquiuk	eqqumiitsuliortoq-U-QQU<Interrogativ<du-dem
eqqumiitsuliortooqqullugu	eqqumiitsuliortoq-U-QQU<Ledsagemåde<ham
eqqumiitsuliortooriaramali	eqqumiitsuliortoq-U-RIAR<Causativ<jeg+LI
eqqumiitsuliortooriarlunga	eqqumiitsuliortoq-U-RIAR<Ledsagemåde<jeg
eqqumiitsuliortooriartununa	eqqumiitsuliortoq-U-RIAR<Participium<de+UNA
eqqumiitsuliortooriartunga	eqqumiitsuliortoq-U-RIAR<Participium<jeg
eqqumiitsuliortooriartungali	eqqumiitsuliortoq-U-RIAR<Participium<jeg+LI
eqqumiitsuliortooreerpugulli	eqqumiitsuliortoq-U-RIIR<Indikativ<vi+LI
eqqumiitsuliortooreertoqaqquiuk	eqqumiitsuliortoq-U-RIIR+TUQ-QAR-QQU<Interrogativ<du-dem
eqqumiitsuliortuussagaluartoriittulli	eqqumiitsuliortoq-U-SSA=GALUAR+TUQ+GIIT<flertal<Aequalis+LI
Esbjerg	Esbjerg<Absolut
Esbjergili	Esbjerg<Absolut+LI
Esbjergilu	Esbjerg<Absolut+LU
Esbjergiuna	Esbjerg<Absolut+UNA
Esbjergimik	Esbjerg<Instrumentalis
Esbjergimilli	Esbjerg<Instrumentalis+LI
Esbjergimillu	Esbjerg<Instrumentalis+LU
Esbjergiminguna	Esbjerg<Instrumentalis+UNA
Esbjergimi	Esbjerg<Lokalis
Esbjergimiikkamalu	Esbjerg<Lokalis+IP<Causativ<jeg+LU
Esbjergimiilaartorlu	Esbjerg<Lokalis+IP-LAAR+TUQ+LU
Esbjergimiilerlutilli	Esbjerg<Lokalis+IP-LIR<Ledsagemåde<de_selv+LI
Esbjergimiinniarnatilli	Esbjerg<Lokalis+IP+NIAR=NNGIT<Ledsagemåde<de_selv+LI
Esbjergimiinniannginneq	Esbjerg<Lokalis+IP+NIAR=NNGIT+NIQ
Esbjergimiinnatilli	Esbjerg<Lokalis+IP-NNGIT<Ledsagemåde<de_selv+LI
Esbjergimiinnginnerlu	Esbjerg<Lokalis+IP-NNGIT+NIQ+LU
Esbjergimiittunga	Esbjerg<Lokalis+IP<Participium<jeg
Esbjergimeeqqaaramaana	Esbjerg<Lokalis+IP-QQAAR<Causativ<jeg+UNA
Esbjergimeeqqaarpungalu	Esbjerg<Lokalis+IP-QQAAR<Indikativ<jeg+LU
Esbjergimeeqqaarpugulli	Esbjerg<Lokalis+IP-QQAAR<Indikativ<vi+LI
Esbjergimeeqqaarpit	Esbjerg<Lokalis+IP-QQAAR<Interrogativ<du
Esbjergimeeqqaarneq	Esbjerg<Lokalis+IP-QQAAR+NIQ
Esbjergimeeqqugakku	Esbjerg<Lokalis+IP-QQU<Causativ<JegHam
Esbjergimeeqqugakkuli	Esbjerg<Lokalis+IP-QQU<Causativ<JegHam+LI
Esbjergimeeqqutigit	Esbjerg<Lokalis+IP-QQU<Imperativ<ViDem
Esbjergimeeqquaanngali	Esbjerg<Lokalis+IP-QQU<Indikativ<DeMig+LI
Esbjergimeeqqullugit	Esbjerg<Lokalis+IP-QQU<Ledsagemåde<dem
Esbjergimeeqqulluginuna	Esbjerg<Lokalis+IP-QQU<Ledsagemåde<dem+UNA
Esbjergimeeqqullugu	Esbjerg<Lokalis+IP-QQU<Ledsagemåde<ham
Esbjergimeeriarama	Esbjerg<Lokalis+IP-RIAR<Causativ<jeg
Esbjergimeeriaramali	Esbjerg<Lokalis+IP-RIAR<Causativ<jeg+LI
Esbjergimeeriarpoq	Esbjerg<Lokalis+IP-RIAR<Indikativ<han
Esbjergimeeriarpugut	Esbjerg<Lokalis+IP-RIAR<Indikativ<vi
Esbjergimeeriarpugununa	Esbjerg<Lokalis+IP-RIAR<Indikativ<vi+UNA
Esbjergimeeriarlutik	Esbjerg<Lokalis+IP-RIAR<Ledsagemåde<de_selv
Esbjergimeeriarneq	Esbjerg<Lokalis+IP-RIAR+NIQ
Esbjergimeeriarnerli	Esbjerg<Lokalis+IP-RIAR+NIQ+LI
Esbjergimeereerpugununa	Esbjerg<Lokalis+IP-RIIR<Indikativ<vi+UNA
Esbjergimeereerpit	Esbjerg<Lokalis+IP-RIIR<Interrogativ<du
Esbjergimeereerlutillu	Esbjerg<Lokalis+IP-RIIR<Ledsagemåde<de_selv+LU
Esbjergimeereerlutinguna	Esbjerg<Lokalis+IP-RIIR<Ledsagemåde<de_selv+UNA
Esbjergimiissimanerli	Esbjerg<Lokalis+IP+SIMA+NIQ+LI
Esbjergimiissaaruna	Esbjerg<Lokalis+IP-SSA<Indikativ<han+UNA
Esbjergimiissasungali	Esbjerg<Lokalis+IP-SSA<Participium<jeg+LI
Esbjergimili	Esbjerg<Lokalis+LI
Esbjergimiuna	Esbjerg<Lokalis+UNA
Esbjergimiuminguna	Esbjerg+MIU<ental<Instrumentalis+UNA
Esbjergimiumi	Esbjerg+MIU<ental<Lokalis
Esbjergimiumeereerpugununa	Esbjerg+MIU<ental<Lokalis+IP-RIIR<Indikativ<vi+UNA
Esbjergimiumut	Esbjerg+MIU<ental<Terminalis
Esbjergimiunik	Esbjerg+MIU<flertal<Instrumentalis
Esbjergimiunillu	Esbjerg+MIU<flertal<Instrumentalis+LU
Esbjergimiuninguna	Esbjerg+MIU<flertal<Instrumentalis+UNA
Esbjergimiuniissagama	Esbjerg+MIU<flertal<Lokalis+IP-SSA<Causativ<jeg
Esbjergimiulerillutilli	Esbjerg+MIU-LIRI<Ledsagemåde<de_selv+LI
Esbjergimiulerinerli	Esbjerg+MIU-LIRI+NIQ+LI
Esbjergimiunnguinnarpugununa	Esbjerg+MIU-NNGUR-INNAR<Indikativ<vi+UNA
Esbjergimiunnguinnarnerilu	Esbjerg+MIU-NNGUR-INNAR+NIQ<flertal<hans<Absolut+LU
Esbjergimiunngunngitsullu	Esbjerg+MIU-NNGUR-NNGIT<Participium<de+LU
Esbjergimiunngussallutik	Esbjerg+MIU-NNGUR-SSA<Ledsagemåde<de_selv
Esbjergimioqarpoq	Esbjerg+MIU-QAR<Indikativ<han
Esbjergimioqarporlu	Esbjerg+MIU-QAR<Indikativ<han+LU
Esbjergimioqarporuna	Esbjerg+MIU-QAR<Indikativ<han+UNA
Esbjergimioqarneq	Esbjerg+MIU-QAR+NIQ
Esbjergimioqarneruna	Esbjerg+MIU-QAR+NIQ+UNA
Esbjergimioqartorli	Esbjerg+MIU-QAR<Participium<han+LI
Esbjergimioqartorlu	Esbjerg+MIU-QAR<Participium<han+LU
Esbjergimioqartoq	Esbjerg+MIU-QAR+TUQ
Esbjergimiuujartorpit	Esbjerg+MIU-U+GIARTUR<Interrogativ<du
Esbjergimiuujartortukka	Esbjerg+MIU-U+GIARTUR+TUQ<flertal<min<Absolut
Esbjergimiuullutilli	Esbjerg+MIU-U<Ledsagemåde<de_selv+LI
Esbjergimiuulerlutilli	Esbjerg+MIU-U-LIR<Ledsagemåde<de_selv+LI
Esbjergimiuunerama	Esbjerg+MIU-U+NIR<Causativ<jeg
Esbjergimiuunertoq	Esbjerg+MIU-U+NIR<Participium<han
Esbjergimiuunertungali	Esbjerg+MIU-U+NIR<Participium<jeg+LI
Esbjergimiuunerusunga	Esbjerg+MIU-U+NIRU<Participium<jeg
Esbjergimiooqqaarama	Esbjerg+MIU-U-QQAAR<Causativ<jeg
Esbjergimiooqqaarlutik	Esbjerg+MIU-U-QQAAR<Ledsagemåde<de_selv
Esbjergimiooqqaarlutilli	Esbjerg+MIU-U-QQAAR<Ledsagemåde<de_selv+LI
Esbjergimiooqqaartoritigilli	Esbjerg+MIU-U-QQAAR+TUQ+GӘ<Imperativ<ViDem+LI
Esbjergimiooqquiuk	Esbjerg+MIU-U-QQU<Interrogativ<du-dem
Esbjergimiooqqullugu	Esbjerg+MIU-U-QQU<Ledsagemåde<ham
Esbjergimiooriarama	Esbjerg+MIU-U-RIAR<Causativ<jeg
Esbjergimiooriarlunga	Esbjerg+MIU-U-RIAR<Ledsagemåde<jeg
Esbjergimiooreerpungali	Esbjerg+MIU-U-RIIR<Indikativ<jeg+LI
Esbjergimiuusinnaaneri	Esbjerg+MIU-U+SINNAA+NIQ<flertal<hans<Absolut
Esbjergimiuusorigaluartigilli	Esbjerg+MIU-U+TUQ+GӘ+GALUAR<Imperativ<ViDem+LI
Esbjergimut	Esbjerg<Terminalis
Esbjergimukaannarnerlu	Esbjerg<Terminalis-KAR-INNAR+NIQ+LU
Esbjergimukalaartarporli	Esbjerg<Terminalis-KAR-LAAR=TAR<Indikativ<han+LI
Esbjergimukalaartarlutinguna	Esbjerg<Terminalis-KAR-LAAR=TAR<Ledsagemåde<de_selv+UNA
Esbjergimukaqqaarama	Esbjerg<Terminalis-KAR-QQAAR<Causativ<jeg
Esbjergimukaqqaarporlu	Esbjerg<Terminalis-KAR-QQAAR<Indikativ<han+LU
Esbjergimukaqqaartoqarpoq	Esbjerg<Terminalis-KAR-QQAAR+TUQ-QAR<Indikativ<han
Esbjergimukaqquai	Esbjerg<Terminalis-KAR-QQU<Indikativ<HanDem
Esbjergimukariarpit	Esbjerg<Terminalis-KAR-RIAR<Interrogativ<du
Esbjergimukariartunga	Esbjerg<Terminalis-KAR-RIAR<Participium<jeg
Esbjergimukareerlutik	Esbjerg<Terminalis-KAR-RIIR<Ledsagemåde<de_selv
Esbjergimukareerneq	Esbjerg<Terminalis-KAR-RIIR+NIQ
Esbjergimukareertoqarporuna	Esbjerg<Terminalis-KAR-RIIR+TUQ-QAR<Indikativ<han+UNA
Esbjergimukassagama	Esbjerg<Terminalis-KAR-SSA<Causativ<jeg
Esbjergimukassagaluarama	Esbjerg<Terminalis-KAR-SSA=GALUAR<Causativ<jeg
Esbjergimukassagaluarneq	Esbjerg<Terminalis-KAR-SSA=GALUAR+NIQ
Esbjergimukassaangali	Esbjerg<Terminalis-KAR-SSA<Indikativ<jeg+LI
Esbjergimukassasunga	Esbjerg<Terminalis-KAR-SSA<Participium<jeg
Esbjergimukarpallaanngillanuna	Esbjerg<Terminalis-KAR+VALLAAR=NNGIT<Indikativ<de+UNA
Esbjergimulli	Esbjerg<Terminalis+LI
Esbjergimullu	Esbjerg<Terminalis+LU
Esbjergimununa	Esbjerg<Terminalis+UNA
Finland	Finland<Absolut
Finlandili	Finland<Absolut+LI
Finlandilu	Finland<Absolut+LU
Finlandiuna	Finland<Absolut+UNA
Finlandimik	Finland<Instrumentalis
Finlandimilli	Finland<Instrumentalis+LI
Finlandimillu	Finland<Instrumentalis+LU
Finlandiminguna	Finland<Instrumentalis+UNA
Finlandimi	Finland<Lokalis
Finlandimeeqqaarama	Finland<Lokalis+IP-QQAAR<Causativ<jeg
Finlandimeeqqaaramali	Finland<Lokalis+IP-QQAAR<Causativ<jeg+LI
Finlandimeeqqaarpulli	Finland<Lokalis+IP-QQAAR<Indikativ<de+LI
Finlandimeeqqaarpit	Finland<Lokalis+IP-QQAAR<Interrogativ<du
Finlandimeeqqaartunga	Finland<Lokalis+IP-QQAAR<Participium<jeg
Finlandimeeqqummanga	Finland<Lokalis+IP-QQU<Causativ<HanMig
Finlandimeeqqugakkuli	Finland<Lokalis+IP-QQU<Causativ<JegHam+LI
Finlandimeeqqutigillu	Finland<Lokalis+IP-QQU<Imperativ<ViDem+LU
Finlandimeeqquara	Finland<Lokalis+IP-QQU<Indikativ<JegHam
Finlandimeeqquiuk	Finland<Lokalis+IP-QQU<Interrogativ<du-dem
Finlandimeeriarama	Finland<Lokalis+IP-RIAR<Causativ<jeg
Finlandimeeriaramali	Finland<Lokalis+IP-RIAR<Causativ<jeg+LI
Finlandimeeriarpit	Finland<Lokalis+IP-RIAR<Interrogativ<du
Finlandimeeriarlutilli	Finland<Lokalis+IP-RIAR<Ledsagemåde<de_selv+LI
Finlandimeeriarlutillu	Finland<Lokalis+IP-RIAR<Ledsagemåde<de_selv+LU
Finlandimeeriarnerli	Finland<Lokalis+IP-RIAR+NIQ+LI
Finlandimeeriartulli	Finland<Lokalis+IP-RIAR<Participium<de+LI
Finlandimeeriartoq	Finland<Lokalis+IP-RIAR<Participium<han
Finlandimeeriartorlu	Finland<Lokalis+IP-RIAR+TUQ+LU
Finlandimeereerama	Finland<Lokalis+IP-RIIR<Causativ<jeg
Finlandimeereertoqanngilarlu	Finland<Lokalis+IP-RIIR+TUQ-QAR-NNGIT<Indikativ<han+LU
Finlandimiissimavit	Finland<Lokalis+IP+SIMA<Interrogativ<du
Finlandimiissimasungalu	Finland<Lokalis+IP+SIMA<Participium<jeg+LU
Finlandimiippallaanngitsoq	Finland<Lokalis+IP+VALLAAR=NNGIT+TUQ
Finlandimili	Finland<Lokalis+LI
Finlandimilu	Finland<Lokalis+LU
Finlandimiuna	Finland<Lokalis+UNA
Finlandimiuminguna	Finland+MIU<ental<Instrumentalis+UNA
Finlandimiumeeqqaarama	Finland+MIU<ental<Lokalis+IP-QQAAR<Causativ<jeg
Finlandimiumut	Finland+MIU<ental<Terminalis
Finlandimiunik	Finland+MIU<flertal<Instrumentalis
Finlandimiunilli	Finland+MIU<flertal<Instrumentalis+LI
Finlandimiuneeqqaarneruna	Finland+MIU<flertal<Lokalis+IP-QQAAR+NIQ+UNA
Finlandimiuneeqqummangali	Finland+MIU<flertal<Lokalis+IP-QQU<Causativ<HanMig+LI
Finlandimiuneeqquaali	Finland+MIU<flertal<Lokalis+IP-QQU<Indikativ<HanDem+LI
Finlandimiuneereerama	Finland+MIU<flertal<Lokalis+IP-RIIR<Causativ<jeg
Finlandimiulerigama	Finland+MIU-LIRI<Causativ<jeg
Finlandimiulerivungali	Finland+MIU-LIRI<Indikativ<jeg+LI
Finlandimiulerivit	Finland+MIU-LIRI<Interrogativ<du
Finlandimiulerineq	Finland+MIU-LIRI+NIQ
Finlandimiulerisunga	Finland+MIU-LIRI<Participium<jeg
Finlandimiunngulertut	Finland+MIU-NNGUR-LIR<Participium<de
Finlandimiunngunngitsorpassuakkaana	Finland+MIU-NNGUR-NNGIT+TUQ+PASSUAQ<flertal<min<Absolut+UNA
Finlandimiunngoqqummanga	Finland+MIU-NNGUR-QQU<Causativ<HanMig
Finlandimiunngoreerpununa	Finland+MIU-NNGUR-RIIR<Indikativ<de+UNA
Finlandimioqarpoq	Finland+MIU-QAR<Indikativ<han
Finlandimioqarporlu	Finland+MIU-QAR<Indikativ<han+LU
Finlandimioqarneq	Finland+MIU-QAR+NIQ
Finlandimioqarnerlu	Finland+MIU-QAR+NIQ+LU
Finlandimioqartoq	Finland+MIU-QAR<Participium<han
Finlandimioqartorli	Finland+MIU-QAR<Participium<han+LI
Finlandimiuujartortoqalerlutik	Finland+MIU-U+GIARTUR+TUQ-QAR-LIR<Ledsagemåde<de_selv
Finlandimiuulaarpit	Finland+MIU-U-LAAR<Interrogativ<du
Finlandimiuunerma	Finland+MIU-U+NIQ<ental<min>Relativ
Finlandimiuunerama	Finland+MIU-U+NIR<Causativ<jeg
Finlandimiuunatik	Finland+MIU-U-NNGIT<Ledsagemåde<de_selv
Finlandimiuunngitsoq	Finland+MIU-U-NNGIT+TUQ<ental<Absolut
Finlandimiooqqaartut	Finland+MIU-U-QQAAR<Participium<de
Finlandimiooqqutigilli	Finland+MIU-U-QQU<Imperativ<ViDem+LI
Finlandimiooriartut	Finland+MIU-U-RIAR<Participium<de
Finlandimiooreernikkalu	Finland+MIU-U-RIIR+NIQ<flertal<min<Absolut+LU
Finlandimiooreertoqalerpugununa	Finland+MIU-U-RIIR+TUQ-QAR-LIR<Indikativ<vi+UNA
Finlandimiuusaraluartoruna	Finland+MIU-U+TAR=GALUAR<Participium<han+UNA
Finlandimiuusaraluartooriartungali	Finland+MIU-U+TAR=GALUAR+TUQ-U-RIAR<Participium<jeg+LI
Finlandimiuusartungaana	Finland+MIU-U+TAR<Participium<jeg+UNA
Finlandimut	Finland<Terminalis
Finlandimukaannartut	Finland<Terminalis-KAR-INNAR<Participium<de
Finlandimukaannartulli	Finland<Terminalis-KAR-INNAR<Participium<de+LI
Finlandimukaannartunga	Finland<Terminalis-KAR-INNAR<Participium<jeg
Finlandimukalaarnerlu	Finland<Terminalis-KAR-LAAR+NIQ+LU
Finlandimukalaartartunga	Finland<Terminalis-KAR-LAAR=TAR<Participium<jeg
Finlandimukalerporli	Finland<Terminalis-KAR-LIR<Indikativ<han+LI
Finlandimukaqqaartoqanngilaq	Finland<Terminalis-KAR-QQAAR+TUQ-QAR-NNGIT<Indikativ<han
Finlandimukariarlutik	Finland<Terminalis-KAR-RIAR<Ledsagemåde<de_selv
Finlandimukariarnerlu	Finland<Terminalis-KAR-RIAR+NIQ+LU
Finlandimukariartoqarpoq	Finland<Terminalis-KAR-RIAR+TUQ-QAR<Indikativ<han
Finlandimukareernerlu	Finland<Terminalis-KAR-RIIR+NIQ+LU
Finlandimukareertorli	Finland<Terminalis-KAR-RIIR+TUQ+LI
Finlandimukassagaluaramalu	Finland<Terminalis-KAR-SSA=GALUAR<Causativ<jeg+LU
Finlandimukassagaluartoqarporli	Finland<Terminalis-KAR-SSA=GALUAR+TUQ-QAR<Indikativ<han+LI
Finlandimulli	Finland<Terminalis+LI
Finlandimullu	Finland<Terminalis+LU
Finlandimununa	Finland<Terminalis+UNA
Gentofte	Gentofte<Absolut
Gentofteli	Gentofte<Absolut+LI
Gentoftelu	Gentofte<Absolut+LU
Gentofteuna	Gentofte<Absolut+UNA
Gentoftemik	Gentofte<Instrumentalis
Gentoftemilli	Gentofte<Instrumentalis+LI
Gentoftemillu	Gentofte<Instrumentalis+LU
Gentofteminguna	Gentofte<Instrumentalis+UNA
Gentoftemi	Gentofte<Lokalis
Gentoftemiiginnarlutillu	Gentofte<Lokalis+IP-INNAR<Ledsagemåde<de_selv+LU
Gentoftemiippit	Gentofte<Lokalis+IP<Interrogativ<du
Gentoftemiillutillu	Gentofte<Lokalis+IP<Ledsagemåde<de_selv+LU
Gentoftemiinngilanga	Gentofte<Lokalis+IP-NNGIT<Indikativ<jeg
Gentoftemeeqqaarpungaana	Gentofte<Lokalis+IP-QQAAR<Indikativ<jeg+UNA
Gentoftemeeqqaarlutinguna	Gentofte<Lokalis+IP-QQAAR<Ledsagemåde<de_selv+UNA
Gentoftemeeqqaarnerlu	Gentofte<Lokalis+IP-QQAAR+NIQ+LU
Gentoftemeeqquiuk	Gentofte<Lokalis+IP-QQU<Interrogativ<du-dem
Gentoftemeeriarpungalu	Gentofte<Lokalis+IP-RIAR<Indikativ<jeg+LU
Gentoftemeeriartoq	Gentofte<Lokalis+IP-RIAR<Participium<han
Gentoftemeeriartorli	Gentofte<Lokalis+IP-RIAR<Participium<han+LI
Gentoftemeeriartunga	Gentofte<Lokalis+IP-RIAR<Participium<jeg
Gentoftemeereerpit	Gentofte<Lokalis+IP-RIIR<Interrogativ<du
Gentoftemeereerlutinguna	Gentofte<Lokalis+IP-RIIR<Ledsagemåde<de_selv+UNA
Gentoftemeereertununa	Gentofte<Lokalis+IP-RIIR<Participium<de+UNA
Gentoftemeereertoq	Gentofte<Lokalis+IP-RIIR<Participium<han
Gentoftemiissinnaagama	Gentofte<Lokalis+IP+SINNAA<Causativ<jeg
Gentoftemiissinnaagamaana	Gentofte<Lokalis+IP+SINNAA<Causativ<jeg+UNA
Gentoftemiissasunga	Gentofte<Lokalis+IP-SSA<Participium<jeg
Gentoftemili	Gentofte<Lokalis+LI
Gentoftemiuna	Gentofte<Lokalis+UNA
Gentoftemiu	Gentofte+MIU<ental<Absolut
Gentoftemiutununa	Gentofte+MIU<ental<Aequalis+UNA
Gentoftemiua	Gentofte+MIU<ental<hans<Absolut
Gentoftemiuali	Gentofte+MIU<ental<hans<Absolut+LI
Gentoftemiui	Gentofte+MIU<flertal<hans<Absolut
Gentoftemiuili	Gentofte+MIU<flertal<hans<Absolut+LI
Gentoftemiukka	Gentofte+MIU<flertal<min<Absolut
Gentoftemiulerigama	Gentofte+MIU-LIRI<Causativ<jeg
Gentoftemiulerippununa	Gentofte+MIU-LIRI<Indikativ<de+UNA
Gentoftemiulerillutilli	Gentofte+MIU-LIRI<Ledsagemåde<de_selv+LI
Gentoftemiulerillutillu	Gentofte+MIU-LIRI<Ledsagemåde<de_selv+LU
Gentoftemiunngulaarnini	Gentofte+MIU-NNGUR-LAAR+NIQ<ental<sin<Absolut
Gentoftemiunngulaartarama	Gentofte+MIU-NNGUR-LAAR=TAR<Causativ<jeg
Gentoftemiunngornerama	Gentofte+MIU-NNGUR+NIR<Causativ<jeg
Gentoftemiunngunngitsormiunngulaartarpungali	Gentofte+MIU-NNGUR-NNGIT+TUQ+MIU-NNGUR-LAAR=TAR<Indikativ<jeg+LI
Gentoftemiunngorsinnaasoq	Gentofte+MIU-NNGUR+SINNAA<Participium<han
Gentoftemiunngussagaluarama	Gentofte+MIU-NNGUR-SSA=GALUAR<Causativ<jeg
Gentoftemioqaannarneranuna	Gentofte+MIU-QAR-INNAR+NIQ<ental<deres+UNA
Gentoftemioqalaartungali	Gentofte+MIU-QAR-LAAR<Participium<jeg+LI
Gentoftemioqalaartarlutilli	Gentofte+MIU-QAR-LAAR=TAR<Ledsagemåde<de_selv+LI
Gentoftemioqalaartartuneeqqaarpununa	Gentofte+MIU-QAR-LAAR=TAR+TUQ<flertal<Lokalis+IP-QQAAR<Indikativ<de+UNA
Gentoftemioqannginnama	Gentofte+MIU-QAR-NNGIT<Causativ<jeg
Gentoftemioqaqqaarama	Gentofte+MIU-QAR-QQAAR<Causativ<jeg
Gentoftemioqaqqaarpunga	Gentofte+MIU-QAR-QQAAR<Indikativ<jeg
Gentoftemioqaqqaarlutik	Gentofte+MIU-QAR-QQAAR<Ledsagemåde<de_selv
Gentoftemioqaqqaartualu	Gentofte+MIU-QAR-QQAAR+TUQ<ental<hans<Absolut+LU
Gentoftemioqariarlungali	Gentofte+MIU-QAR-RIAR<Ledsagemåde<jeg+LI
Gentoftemioqareernerilli	Gentofte+MIU-QAR-RIIR+NIQ<flertal<Relativ+LI
Gentoftemioqareertoq	Gentofte+MIU-QAR-RIIR+TUQ<ental<Absolut
Gentoftemioqareertunngua	Gentofte+MIU-QAR-RIIR+TUQ-NNGUAQ<ental<hans<Absolut
Gentoftemioqassagaluartulli	Gentofte+MIU-QAR-SSA=GALUAR<Participium<de+LI
Gentoftemioqartuusoqalaartarnini	Gentofte+MIU-QAR+TUQ-U+TUQ-QAR-LAAR=TAR+NIQ<ental<sin<Absolut
Gentoftemiuuniarnatinguna	Gentofte+MIU-U+NIAR=NNGIT<Ledsagemåde<de_selv+UNA
Gentoftemiuunikuugamalu	Gentofte+MIU-U+NIKUU<Causativ<jeg+LU
Gentoftemiuunnginnama	Gentofte+MIU-U-NNGIT<Causativ<jeg
Gentoftemiooqqaarama	Gentofte+MIU-U-QQAAR<Causativ<jeg
Gentoftemiooqqaarpit	Gentofte+MIU-U-QQAAR<Interrogativ<du
Gentoftemiooqqaartuinnarnullu	Gentofte+MIU-U-QQAAR+TUQ-INNAQ<flertal<Terminalis+LU
Gentoftemiooriarlunilu	Gentofte+MIU-U-RIAR<Ledsagemåde<han_selv+LU
Gentoftemiooriarlunga	Gentofte+MIU-U-RIAR<Ledsagemåde<jeg
Gentoftemiooriartullu	Gentofte+MIU-U-RIAR<Participium<de+LU
Gentoftemiooreertulli	Gentofte+MIU-U-RIIR<Participium<de+LI
Gentoftemiooreertooriartoq	Gentofte+MIU-U-RIIR+TUQ-U-RIAR<Participium<han
Gentoftemiuussagaluarpit	Gentofte+MIU-U-SSA=GALUAR<Interrogativ<du
Gentoftemut	Gentofte<Terminalis
Gentoftemukalaarporlu	Gentofte<Terminalis-KAR-LAAR<Indikativ<han+LU
Gentoftemukalaarneruna	Gentofte<Terminalis-KAR-LAAR+NIQ+UNA
Gentoftemukalaartaramali	Gentofte<Terminalis-KAR-LAAR=TAR<Causativ<jeg+LI
Gentoftemukalaartoqanngilaq	Gentofte<Terminalis-KAR-LAAR+TUQ-QAR-NNGIT<Indikativ<han
Gentoftemukalerama	Gentofte<Terminalis-KAR-LIR<Causativ<jeg
Gentoftemukalerlutinguna	Gentofte<Terminalis-KAR-LIR<Ledsagemåde<de_selv+UNA
Gentoftemukarnikuusunga	Gentofte<Terminalis-KAR+NIKUU<Participium<jeg
Gentoftemukanngilagullu	Gentofte<Terminalis-KAR-NNGIT<Indikativ<vi+LU
Gentoftemukaqqaarpit	Gentofte<Terminalis-KAR-QQAAR<Interrogativ<du
Gentoftemukaqqugakku	Gentofte<Terminalis-KAR-QQU<Causativ<JegHam
Gentoftemukaqqugakkulu	Gentofte<Terminalis-KAR-QQU<Causativ<JegHam+LU
Gentoftemukaqquassi	Gentofte<Terminalis-KAR-QQU<Indikativ<JegJer
Gentoftemukaqqullugu	Gentofte<Terminalis-KAR-QQU<Ledsagemåde<ham
Gentoftemukassagaluarlutillu	Gentofte<Terminalis-KAR-SSA=GALUAR<Ledsagemåde<de_selv+LU
Gentoftemukassagaluarlutinguna	Gentofte<Terminalis-KAR-SSA=GALUAR<Ledsagemåde<de_selv+UNA
Gentoftemukassagaluarnerlu	Gentofte<Terminalis-KAR-SSA=GALUAR+NIQ+LU
Gentoftemukassavit	Gentofte<Terminalis-KAR-SSA<Interrogativ<du
Gentoftemukassallutik	Gentofte<Terminalis-KAR-SSA<Ledsagemåde<de_selv
Gentoftemukassallutilli	Gentofte<Terminalis-KAR-SSA<Ledsagemåde<de_selv+LI
Gentoftemukassasunga	Gentofte<Terminalis-KAR-SSA<Participium<jeg
Gentoftemukarpallaartoqanngilaruna	Gentofte<Terminalis-KAR+VALLAAR+TUQ-QAR-NNGIT<Indikativ<han+UNA
Gentoftemulli	Gentofte<Terminalis+LI
Gentoftemullu	Gentofte<Terminalis+LU
Gentoftemununa	Gentofte<Terminalis+UNA
ilaminguna	ila<ental<Instrumentalis+UNA
ilani	ila<ental<sin<Absolut
ilamukariarlutik	ila<ental<Terminalis-KAR-RIAR<Ledsagemåde<de_selv
ilagiittut	ila+GIIT<flertal<Aequalis
ilaginerummanga	ila+GӘ+NIRU<Causativ<HanMig
ilaannarniissagaluartunga	ila-INNAQ<flertal<Lokalis+IP-SSA=GALUAR<Participium<jeg
ilamiuuinnartut	ila+MIU-U-INNAR<Participium<de
ilanngooreernikka	ila-NNGUAQ-U-RIIR+NIQ<flertal<min<Absolut
ilanngoriartorpulli	ila-NNGUR+GIARTUR<Indikativ<de+LI
ilanngoriarlunga	ila-NNGUR-RIAR<Ledsagemåde<jeg
ilarpassuilli	ila+PASSUAQ<flertal<Absolut+LI
ilaqassagamali	ila-QAR-SSA<Causativ<jeg+LI
ilaqutariippassuit	ilaqutariit+PASSUAQ<flertal<Absolut
ilaqutariissaqanngilarlu	ilaqutariit-SSAQ-QAR-NNGIT<Indikativ<han+LU
ilassaniippallaannginnamalu	ila-SSAQ<flertal<Lokalis+IP+VALLAAR=NNGIT<Causativ<jeg+LU
ilassaasooreerpunga	ila-SSAQ-U+TUQ-U-RIIR<Indikativ<jeg
ilaajartorlutilli	ila-U+GIARTUR<Ledsagemåde<de_selv+LI
ilaasoqaqqaartormiooriartunga	ila-U+TUQ-QAR-QQAAR+TUQ+MIU-U-RIAR<Participium<jeg
ilinniaraluarpit	ilinniar+GALUAR<Interrogativ<du
ilinniarpunga	ilinniar<Indikativ<jeg
ilinniaannarpugut	ilinniar-INNAR<Indikativ<vi
ilinniaannarpit	ilinniar-INNAR<Interrogativ<du
ilinniarnianngitsungaana	ilinniar+NIAR=NNGIT<Participium<jeg+UNA
ilinniarnikuuit	ilinniar+NIKUU<Interrogativ<du
ilinniarnerusuinnanngoqquiuk	ilinniar+NIRU+TUQ-INNAQ-NNGUR-QQU<Interrogativ<du-dem
ilinniarnatillu	ilinniar-NNGIT<Ledsagemåde<de_selv+LU
ilinnianngitsulli	ilinniar-NNGIT<Participium<de+LI
ilinniaqqaarnerali	ilinniar-QQAAR+NIQ<ental<hans<Absolut+LI
ilinniaqqummangalu	ilinniar-QQU<Causativ<HanMig+LU
ilinniaqqutigilli	ilinniar-QQU<Imperativ<ViDem+LI
ilinniariartullu	ilinniar-RIAR<Participium<de+LU
ilinniarsimavit	ilinniar+SIMA<Interrogativ<du
ilinniassasoq	ilinniar-SSA<Participium<han
ilinniartippallaarlugu	ilinniartip+VALLAAR<Ledsagemåde<ham
ilinniarpallaanngitsut	ilinniar+VALLAAR=NNGIT<Participium<de
Ilisimatusarfilli	Ilisimatusarfik<ental<Absolut+LI
Ilisimatusarfimmeeqqaarlutinguna	Ilisimatusarfik<ental<Lokalis+IP-QQAAR<Ledsagemåde<de_selv+UNA
Ilisimatusarfinni	Ilisimatusarfik<flertal<Lokalis
Ilisimatusarfigiivi	Ilisimatusarfik+GIIT<flertal<hans<Absolut
Ilisimatusarfigiinnilli	Ilisimatusarfik+GIIT<flertal<Instrumentalis+LI
Ilisimatusarfigiinngoqqullugilli	Ilisimatusarfik+GIIT-NNGUR-QQU<Ledsagemåde<dem+LI
Ilisimatusarfigereerpiuk	Ilisimatusarfik+GӘ-RIIR<Interrogativ<du-dem
Ilisimatusarfiinnalerisoq	Ilisimatusarfik-INNAQ-LIRI+TUQ
Ilisimatusarfimmioqarneq	Ilisimatusarfik+MIU-QAR+NIQ
Ilisimatusarfippassuartulli	Ilisimatusarfik+PASSUAQ<flertal<Aequalis+LI
Ilisimatusarfippassuilu	Ilisimatusarfik+PASSUAQ<flertal<hans<Absolut+LU
Ilisimatusarfippassuarnik	Ilisimatusarfik+PASSUAQ<flertal<Instrumentalis
Ilisimatusarfippassuarnukassagaluarnerli	Ilisimatusarfik+PASSUAQ<flertal<Terminalis-KAR-SSA=GALUAR+NIQ+LI
Ilisimatusarfeqaannarporli	Ilisimatusarfik-QAR-INNAR<Indikativ<han+LI
Ilisimatusarfeqaannarporuna	Ilisimatusarfik-QAR-INNAR<Indikativ<han+UNA
Ilisimatusarfeqalaarneruna	Ilisimatusarfik-QAR-LAAR+NIQ+UNA
Ilisimatusarfeqalaartartoq	Ilisimatusarfik-QAR-LAAR=TAR+TUQ
Ilisimatusarfeqalaartoq	Ilisimatusarfik-QAR-LAAR+TUQ
Ilisimatusarfeqalerneq	Ilisimatusarfik-QAR-LIR+NIQ
Ilisimatusarfeqalertoq	Ilisimatusarfik-QAR-LIR+TUQ
Ilisimatusarfeqalertorli	Ilisimatusarfik-QAR-LIR+TUQ+LI
Ilisimatusarfeqalertorlu	Ilisimatusarfik-QAR-LIR+TUQ+LU
Ilisimatusarfeqarnertungalu	Ilisimatusarfik-QAR+NIR<Participium<jeg+LU
Ilisimatusarfeqanngitsoq	Ilisimatusarfik-QAR-NNGIT+TUQ
Ilisimatusarfeqaqqulluguli	Ilisimatusarfik-QAR-QQU<Ledsagemåde<ham+LI
Ilisimatusarfeqariarpoq	Ilisimatusarfik-QAR-RIAR<Indikativ<han
Ilisimatusarfeqariartorli	Ilisimatusarfik-QAR-RIAR<Participium<han+LI
Ilisimatusarfeqassagaluarpoq	Ilisimatusarfik-QAR-SSA=GALUAR<Indikativ<han
Ilisimatusarfeqassasoq	Ilisimatusarfik-QAR-SSA<Participium<han
Ilisimatusarfeqartarneq	Ilisimatusarfik-QAR+TAR+NIQ
Illoqqortoormiut	Illoqqortoormiut<Absolut
Illoqqortoormiulli	Illoqqortoormiut<Absolut+LI
Illoqqortoormiullu	Illoqqortoormiut<Absolut+LU
Illoqqortoormiununa	Illoqqortoormiut<Absolut+UNA
Illoqqortoormiunik	Illoqqortoormiut<Instrumentalis
Illoqqortoormiuninguna	Illoqqortoormiut<Instrumentalis+UNA
Illoqqortoormiuni	Illoqqortoormiut<Lokalis
Illoqqortoormiuneeqqaarama	Illoqqortoormiut<Lokalis+IP-QQAAR<Causativ<jeg
Illoqqortoormiuneeqqaarlutik	Illoqqortoormiut<Lokalis+IP-QQAAR<Ledsagemåde<de_selv
Illoqqortoormiuneeqquiuk	Illoqqortoormiut<Lokalis+IP-QQU<Interrogativ<du-dem
Illoqqortoormiuneeriarnerlu	Illoqqortoormiut<Lokalis+IP-RIAR+NIQ+LU
Illoqqortoormiuneereertorli	Illoqqortoormiut<Lokalis+IP-RIIR+TUQ+LI
Illoqqortoormiormiulu	Illoqqortoormiut+MIU<ental<Absolut+LU
Illoqqortoormiormiumilli	Illoqqortoormiut+MIU<ental<Instrumentalis+LI
Illoqqortoormiormiumi	Illoqqortoormiut+MIU<ental<Lokalis
Illoqqortoormiormiunilli	Illoqqortoormiut+MIU<flertal<Instrumentalis+LI
Illoqqortoormiormiuneereerpungali	Illoqqortoormiut+MIU<flertal<Lokalis+IP-RIIR<Indikativ<jeg+LI
Illoqqortoormiormiulerisorlu	Illoqqortoormiut+MIU-LIRI+TUQ+LU
Illoqqortoormiormiulerisoqarpoq	Illoqqortoormiut+MIU-LIRI+TUQ-QAR<Indikativ<han
Illoqqortoormiormiunngoreertulik	Illoqqortoormiut+MIU-NNGUR-RIIR+TUQ-LIK<ental<Absolut
Illoqqortoormiormioqarneq	Illoqqortoormiut+MIU-QAR+NIQ
Illoqqortoormiormioqartoq	Illoqqortoormiut+MIU-QAR<Participium<han
Illoqqortoormiormioqartoq	Illoqqortoormiut+MIU-QAR+TUQ
Illoqqortoormiormiuujartornerinuna	Illoqqortoormiut+MIU-U+GIARTUR+NIQ<flertal<Absolut+UNA
Illoqqortoormiormiuujartortungaana	Illoqqortoormiut+MIU-U+GIARTUR<Participium<jeg+UNA
Illoqqortoormiormiuunertoruna	Illoqqortoormiut+MIU-U+NIR<Participium<han+UNA
Illoqqortoormiormiooqqaarpit	Illoqqortoormiut+MIU-U-QQAAR<Interrogativ<du
Illoqqortoormiormiooqqaarlutinguna	Illoqqortoormiut+MIU-U-QQAAR<Ledsagemåde<de_selv+UNA
Illoqqortoormiormiooreerlutik	Illoqqortoormiut+MIU-U-RIIR<Ledsagemåde<de_selv
Illoqqortoormiormiooreertoq	Illoqqortoormiut+MIU-U-RIIR<Participium<han
Illoqqortoormiunut	Illoqqortoormiut<Terminalis
Illoqqortoormiunukalaarama	Illoqqortoormiut<Terminalis-KAR-LAAR<Causativ<jeg
illuminguna	illu<ental<Instrumentalis+UNA
illugiittununa	illu+GIIT<flertal<Aequalis+UNA
illugiinneeriarlutillu	illu+GIIT<flertal<Lokalis+IP-RIAR<Ledsagemåde<de_selv+LU
illugilaartarluginuna	illu+GӘ-LAAR=TAR<Ledsagemåde<dem+UNA
illullit	illu-LIK<flertal<Absolut
illulerivit	illu-LIRI<Interrogativ<du
illumiuussallutik	illu+MIU-U-SSA<Ledsagemåde<de_selv
illunngoqqulluginuna	illu-NNGUR-QQU<Ledsagemåde<dem+UNA
illorpassuarninguna	illu+PASSUAQ<flertal<Instrumentalis+UNA
illussanngunnginnerit	illu-SSAQ-NNGUR-NNGIT+NIQ<flertal<Absolut
illooriarluni	illu-U-RIAR<Ledsagemåde<han_selv
illooriartulli	illu-U-RIAR<Participium<de+LI
illooreertorlu	illu-U-RIIR<Participium<han+LU
illooreertoq	illu-U-RIIR+TUQ<ental<Absolut
Ilulissat	Ilulissat<Absolut
Ilulissanuna	Ilulissat<Absolut+UNA
Ilulissanilli	Ilulissat<Instrumentalis+LI
Ilulissaniillutik	Ilulissat<Lokalis+IP<Ledsagemåde<de_selv
Ilulissaneeqqaartoqanngilaq	Ilulissat<Lokalis+IP-QQAAR+TUQ-QAR-NNGIT<Indikativ<han
Ilulissaneeqqummanga	Ilulissat<Lokalis+IP-QQU<Causativ<HanMig
Ilulissaneeqqulluginuna	Ilulissat<Lokalis+IP-QQU<Ledsagemåde<dem+UNA
Ilulissanilu	Ilulissat<Lokalis+LU
Iluliarmiuminguna	Ilulissat+MIU<ental<Instrumentalis+UNA
Iluliarmiuninguna	Ilulissat+MIU<flertal<Instrumentalis+UNA
Iluliarmiuneeqqummanga	Ilulissat+MIU<flertal<Lokalis+IP-QQU<Causativ<HanMig
Iluliarmiuneereerlutinguna	Ilulissat+MIU<flertal<Lokalis+IP-RIIR<Ledsagemåde<de_selv+UNA
Iluliarmiulerivoq	Ilulissat+MIU-LIRI<Indikativ<han
Iluliarmiunnguinnartua	Ilulissat+MIU-NNGUR-INNAR+TUQ<ental<hans<Absolut
Iluliarmioqarporuna	Ilulissat+MIU-QAR<Indikativ<han+UNA
Iluliarmioqartoq	Ilulissat+MIU-QAR+TUQ
Iluliarmioqartorli	Ilulissat+MIU-QAR+TUQ+LI
Iluliarmiuunikuusuinnaagaluarnini	Ilulissat+MIU-U+NIKUU+TUQ-INNAQ-U+GALUAR+NIQ<ental<sin<Absolut
Iluliarmiooqqaartunga	Ilulissat+MIU-U-QQAAR<Participium<jeg
Iluliarmiooreernera	Ilulissat+MIU-U-RIIR+NIQ<ental<hans<Absolut
Iluliarmiooreertut	Ilulissat+MIU-U-RIIR<Participium<de
Iluliarmiuussappulli	Ilulissat+MIU-U-SSA<Indikativ<de+LI
Ilulissanut	Ilulissat<Terminalis
Ilulissanukalaartunga	Ilulissat<Terminalis-KAR-LAAR<Participium<jeg
Ilulissanukarnatillu	Ilulissat<Terminalis-KAR-NNGIT<Ledsagemåde<de_selv+LU
Ilulissanulli	Ilulissat<Terminalis+LI
imaakkama	imaap<Causativ<jeg
imaakkiartorput	imaap+GIARTUR<Indikativ<de
imaakkiartortulerisut	imaap+GIARTUR+TUQ-LIRI<Participium<de
imaakkiartortooreertoq	imaap+GIARTUR+TUQ-U-RIIR<Participium<han
imaalaartarneq	imaap-LAAR=TAR+NIQ<ental<Absolut
imaalaartartuujartorpit	imaap-LAAR=TAR+TUQ-U+GIARTUR<Interrogativ<du
imaallutik	imaap<Ledsagemåde<de_selv
imaallutinguna	imaap<Ledsagemåde<de_selv+UNA
imaalertooreeramaana	imaap-LIR+TUQ-U-RIIR<Causativ<jeg+UNA
imaanniarpunga	imaap+NIAR<Indikativ<jeg
imaanniarpugut	imaap+NIAR<Indikativ<vi
imaanniarpit	imaap+NIAR<Interrogativ<du
imaanniarnatik	imaap+NIAR=NNGIT<Ledsagemåde<de_selv
imaattunga	imaap<Participium<jeg
imaariartunga	imaap-RIAR<Participium<jeg
imaassimagama	imaap+SIMA<Causativ<jeg
imaassimasartut	imaap+SIMA=TAR<Participium<de
imaassimasartunga	imaap+SIMA=TAR<Participium<jeg
imaassimasuunikuugama	imaap+SIMA+TUQ-U+NIKUU<Causativ<jeg
imaattaraluarpungali	imaap+TAR=GALUAR<Indikativ<jeg+LI
imaattaraluarpungalu	imaap+TAR=GALUAR<Indikativ<jeg+LU
imaattaraluarpit	imaap+TAR=GALUAR<Interrogativ<du
imaattuinnaqalaartarama	imaap+TUQ-INNAQ-QAR-LAAR=TAR<Causativ<jeg
imaattoqaqquara	imaap+TUQ-QAR-QQU<Indikativ<JegHam
imaappallaarama	imaap+VALLAAR<Causativ<jeg
imaappallaanngilanga	imaap+VALLAAR=NNGIT<Indikativ<jeg
imaappallaannginnera	imaap+VALLAAR=NNGIT+NIQ<ental<hans<Absolut
imaappallaannginnikkaana	imaap+VALLAAR=NNGIT+NIQ<flertal<min<Absolut+UNA
immikkoortorinikuutigillu	immikkoortoq+GӘ+NIKUU<Imperativ<ViDem+LU
immikkoortuinnanngulaartartulimmukarsinnaagamali	immikkoortoq-INNAQ-NNGUR-LAAR=TAR+TUQ-LIK<ental<Terminalis-KAR+SINNAA<Causativ<jeg+LI
immikkoortorpassuakka	immikkoortoq+PASSUAQ<flertal<min<Absolut
immikkoortoqaannartunga	immikkoortoq-QAR-INNAR<Participium<jeg
immikkoortussaq	immikkoortoq-SSAQ<ental<Absolut
immikkut	immikkut<Partikel
immikkulli	immikkut<Partikel+LI
immikkullu	immikkut<Partikel+LU
immikkununa	immikkut<Partikel+UNA
immiussigama	immiussi<Causativ<jeg
immiusseqqaarpunga	immiussi-QQAAR<Indikativ<jeg
immiusseqqaartulli	immiussi-QQAAR<Participium<de+LI
immiusseqquassi	immiussi-QQU<Indikativ<JegJer
immiussereerpunga	immiussi-RIIR<Indikativ<jeg
immiussereerpit	immiussi-RIIR<Interrogativ<du
ingerlaannaq	ingerlaannaq<Partikel
ingerlaannarli	ingerlaannaq<Partikel+LI
ingerlaannaruna	ingerlaannaq<Partikel+UNA
inuk	inuk<ental<Absolut
inulli	inuk<ental<Absolut+LI
inullu	inuk<ental<Absolut+LU
inunninguna	inuk<flertal<Instrumentalis+UNA
inunni	inuk<flertal<Lokalis
inunneeqqaarlutillu	inuk<flertal<Lokalis+IP-QQAAR<Ledsagemåde<de_selv+LU
inunneeqqummangalu	inuk<flertal<Lokalis+IP-QQU<Causativ<HanMig+LU
inugiiviuna	inuk+GIIT<flertal<hans<Absolut+UNA
inugeriarmanga	inuk+GӘ-RIAR<Causativ<HanMig
inugereerpaanga	inuk+GӘ-RIIR<Indikativ<HanMig
inuinnanngulaarpunga	inuk-INNAQ-NNGUR-LAAR<Indikativ<jeg
inulerigama	inuk-LIRI<Causativ<jeg
inummiooriarlunili	inuk+MIU-U-RIAR<Ledsagemåde<han_selv+LI
inuppassuartut	inuk+PASSUAQ<flertal<Aequalis
inuppassui	inuk+PASSUAQ<flertal<hans<Absolut
inoqariartortoruna	inuk-QAR+GIARTUR<Participium<han+UNA
inoqaannarporli	inuk-QAR-INNAR<Indikativ<han+LI
inoqaannartoq	inuk-QAR-INNAR+TUQ
inoqalaarneq	inuk-QAR-LAAR+NIQ
inoqalerpoq	inuk-QAR-LIR<Indikativ<han
inoqalertoq	inuk-QAR-LIR+TUQ
inoqarnertungali	inuk-QAR+NIR<Participium<jeg+LI
inoqariarporli	inuk-QAR-RIAR<Indikativ<han+LI
inoqareernerlu	inuk-QAR-RIIR+NIQ+LU
inoqassaaq	inuk-QAR-SSA<Indikativ<han
inooqqaarneq	inuk-U-QQAAR+NIQ
inooqqaartoq	inuk-U-QQAAR+TUQ
inooqqutigit	inuk-U-QQU<Imperativ<ViDem
inooqquara	inuk-U-QQU<Indikativ<JegHam
inooqquassilu	inuk-U-QQU<Indikativ<JegJer+LU
inooriarneq	inuk-U-RIAR+NIQ
inooriarnerli	inuk-U-RIAR+NIQ+LI
inooreernerli	inuk-U-RIIR+NIQ+LI
isumaauna	isuma<flertal<hans<Absolut+UNA
isumanik	isuma<flertal<Instrumentalis
isumanilli	isuma<flertal<Instrumentalis+LI
isumani	isuma<flertal<Lokalis
isumaniuna	isuma<flertal<Lokalis+UNA
isumakka	isuma<flertal<min<Absolut
isumagiit	isuma+GIIT<flertal<Absolut
isumagiinnillu	isuma+GIIT<flertal<Instrumentalis+LU
isumagiikka	isuma+GIIT<flertal<min<Absolut
isumagiilerivoq	isuma+GIIT-LIRI<Indikativ<han
isumagiinngussaaq	isuma+GIIT-NNGUR-SSA<Indikativ<han
isumagalugilli	isuma+GӘ<Ledsagemåde<dem+LI
isumagaluginuna	isuma+GӘ<Ledsagemåde<dem+UNA
isumaginiartigilli	isuma+GӘ+NIAR<Imperativ<ViDem+LI
isumageriarakku	isuma+GӘ-RIAR<Causativ<JegHam
isumageriarlugillu	isuma+GӘ-RIAR<Ledsagemåde<dem+LU
isumagivallaarluginuna	isuma+GӘ+VALLAAR<Ledsagemåde<dem+UNA
isumaannaq	isuma-INNAQ<ental<Absolut
isumaannarnilu	isuma-INNAQ<flertal<Lokalis+LU
isumaannakka	isuma-INNAQ<flertal<min<Absolut
isumaannaainnarpugut	isuma-INNAQ-U-INNAR<Indikativ<vi
isumaannaasimasartormioqartoq	isuma-INNAQ-U+SIMA=TAR+TUQ+MIU-QAR+TUQ
isumaliat	isuma-LIK<ental<deres
isumallilli	isuma-LIK<flertal<Absolut+LI
isumalikka	isuma-LIK<flertal<min<Absolut
isumallit	isuma-LIK<flertal<Relativ
isumallinuna	isuma-LIK<flertal<Relativ+UNA
isumalinnguinnartoq	isuma-LIK-NNGUR-INNAR<Participium<han
isumalerigama	isuma-LIRI<Causativ<jeg
isumalerigamali	isuma-LIRI<Causativ<jeg+LI
isumalerivugununa	isuma-LIRI<Indikativ<vi+UNA
isumamiooreertussarali	isuma+MIU-U-RIIR+TUQ-SSAQ<ental<min<Absolut+LI
isumamiuuallaarnikkali	isuma+MIU-U+VALLAAR+NIQ<flertal<min<Absolut+LI
isumanngua	isuma-NNGUAQ<ental<hans<Absolut
isumanngui	isuma-NNGUAQ<flertal<hans<Absolut
isumannguanngorniarporlu	isuma-NNGUAQ-NNGUR+NIAR<Indikativ<han+LU
isumanngooqqaarama	isuma-NNGUAQ-U-QQAAR<Causativ<jeg
isumanngooriartunga	isuma-NNGUAQ-U-RIAR<Participium<jeg
isumannguinnarnerilu	isuma-NNGUR-INNAR+NIQ<flertal<hans<Absolut+LU
isumanngornikuusungaana	isuma-NNGUR+NIKUU<Participium<jeg+UNA
isumanngoriarlutik	isuma-NNGUR-RIAR<Ledsagemåde<de_selv
isumanngussagaluarlutinguna	isuma-NNGUR-SSA=GALUAR<Ledsagemåde<de_selv+UNA
isumarpassuit	isuma+PASSUAQ<flertal<Absolut
isumarpassui	isuma+PASSUAQ<flertal<hans<Absolut
isumarpassuarnillu	isuma+PASSUAQ<flertal<Instrumentalis+LU
isumaqalaarpugulli	isuma-QAR-LAAR<Indikativ<vi+LI
isumaqalaarlutillu	isuma-QAR-LAAR<Ledsagemåde<de_selv+LU
isumaqarnertoq	isumaqar+NIR<Participium<han
isumaqannginnama	isuma-QAR-NNGIT<Causativ<jeg
isumaqartooriarlungali	isumaqar+TUQ-U-RIAR<Ledsagemåde<jeg+LI
isumassamali	isuma-SSAQ<ental<min>Relativ+LI
isumassanngulaarpit	isuma-SSAQ-NNGUR-LAAR<Interrogativ<du
isumassanngoriarluni	isuma-SSAQ-NNGUR-RIAR<Ledsagemåde<han_selv
isumaalaarporlu	isuma-U-LAAR<Indikativ<han+LU
isumaaniartullu	isuma-U+NIAR<Participium<de+LU
isumaaqquassiuna	isuma-U-QQU<Indikativ<JegJer+UNA
isumaareerpit	isuma-U-RIIR<Interrogativ<du
Ivittuut	Ivittuut<Absolut
Ivittuulli	Ivittuut<Absolut+LI
Ivittuullu	Ivittuut<Absolut+LU
Ivittuununa	Ivittuut<Absolut+UNA
Ivittuunik	Ivittuut<Instrumentalis
Ivittuunilli	Ivittuut<Instrumentalis+LI
Ivittuunillu	Ivittuut<Instrumentalis+LU
Ivittuuninguna	Ivittuut<Instrumentalis+UNA
Ivittuuni	Ivittuut<Lokalis
Ivittuuneeqqaarpoq	Ivittuut<Lokalis+IP-QQAAR<Indikativ<han
Ivittuuneeqqaartoqarporlu	Ivittuut<Lokalis+IP-QQAAR+TUQ-QAR<Indikativ<han+LU
Ivittuuneeqqutigit	Ivittuut<Lokalis+IP-QQU<Imperativ<ViDem
Ivittuuneeqquiuk	Ivittuut<Lokalis+IP-QQU<Interrogativ<du-dem
Ivittuuneeqqulluguuna	Ivittuut<Lokalis+IP-QQU<Ledsagemåde<ham+UNA
Ivittuuneeriarpit	Ivittuut<Lokalis+IP-RIAR<Interrogativ<du
Ivittuuneeriartunga	Ivittuut<Lokalis+IP-RIAR<Participium<jeg
Ivittuunilu	Ivittuut<Lokalis+LU
Ivittuuniuna	Ivittuut<Lokalis+UNA
Ivittoormiu	Ivittuut+MIU<ental<Absolut
Ivittoormiulu	Ivittuut+MIU<ental<Absolut+LU
Ivittoormiumi	Ivittuut+MIU<ental<Lokalis
Ivittoormiumeeqqaarpununa	Ivittuut+MIU<ental<Lokalis+IP-QQAAR<Indikativ<de+UNA
Ivittoormiumulli	Ivittuut+MIU<ental<Terminalis+LI
Ivittoormiuninguna	Ivittuut+MIU<flertal<Instrumentalis+UNA
Ivittoormiuni	Ivittuut+MIU<flertal<Lokalis
Ivittoormiuniilaartarneq	Ivittuut+MIU<flertal<Lokalis+IP-LAAR=TAR+NIQ
Ivittoormiuneereerama	Ivittuut+MIU<flertal<Lokalis+IP-RIIR<Causativ<jeg
Ivittoormiulerivorli	Ivittuut+MIU-LIRI<Indikativ<han+LI
Ivittoormiulerivugut	Ivittuut+MIU-LIRI<Indikativ<vi
Ivittoormiulerisoqanngilaq	Ivittuut+MIU-LIRI+TUQ-QAR-NNGIT<Indikativ<han
Ivittoormiunngoqqutiginuna	Ivittuut+MIU-NNGUR-QQU<Imperativ<ViDem+UNA
Ivittoormioqarpoq	Ivittuut+MIU-QAR<Indikativ<han
Ivittoormioqarporli	Ivittuut+MIU-QAR<Indikativ<han+LI
Ivittoormioqarporlu	Ivittuut+MIU-QAR<Indikativ<han+LU
Ivittoormioqarporuna	Ivittuut+MIU-QAR<Indikativ<han+UNA
Ivittoormioqarneq	Ivittuut+MIU-QAR+NIQ
Ivittoormioqarnerli	Ivittuut+MIU-QAR+NIQ+LI
Ivittoormioqarnerlu	Ivittuut+MIU-QAR+NIQ+LU
Ivittoormioqarneruna	Ivittuut+MIU-QAR+NIQ+UNA
Ivittoormioqartoq	Ivittuut+MIU-QAR<Participium<han
Ivittoormioqartorli	Ivittuut+MIU-QAR<Participium<han+LI
Ivittoormioqartorlu	Ivittuut+MIU-QAR<Participium<han+LU
Ivittoormioqartoq	Ivittuut+MIU-QAR+TUQ
Ivittoormiuunertullu	Ivittuut+MIU-U+NIR<Participium<de+LU
Ivittoormiuunerusoruna	Ivittuut+MIU-U+NIRU<Participium<han+UNA
Ivittoormiuusulli	Ivittuut+MIU-U<Participium<de+LI
Ivittoormiooqqaartoq	Ivittuut+MIU-U-QQAAR<Participium<han
Ivittoormiooqqaartuinnaq	Ivittuut+MIU-U-QQAAR+TUQ-INNAQ<ental<Absolut
Ivittoormiooqqugakkuuna	Ivittuut+MIU-U-QQU<Causativ<JegHam+UNA
Ivittoormiooriarluni	Ivittuut+MIU-U-RIAR<Ledsagemåde<han_selv
Ivittoormiooriarlungali	Ivittuut+MIU-U-RIAR<Ledsagemåde<jeg+LI
Ivittoormiooriartut	Ivittuut+MIU-U-RIAR<Participium<de
Ivittoormiooreeramaana	Ivittuut+MIU-U-RIIR<Causativ<jeg+UNA
Ivittoormiooreerpulli	Ivittuut+MIU-U-RIIR<Indikativ<de+LI
Ivittoormiooreerpit	Ivittuut+MIU-U-RIIR<Interrogativ<du
Ivittoormiooreerlutinguna	Ivittuut+MIU-U-RIIR<Ledsagemåde<de_selv+UNA
Ivittoormiuuallaanngilarli	Ivittuut+MIU-U+VALLAAR=NNGIT<Indikativ<han+LI
Ivittuunut	Ivittuut<Terminalis
Ivittuunukalaaramaana	Ivittuut<Terminalis-KAR-LAAR<Causativ<jeg+UNA
Ivittuunukalaarpunga	Ivittuut<Terminalis-KAR-LAAR<Indikativ<jeg
Ivittuunukaleramalu	Ivittuut<Terminalis-KAR-LIR<Causativ<jeg+LU
Ivittuunukalertoqarporuna	Ivittuut<Terminalis-KAR-LIR+TUQ-QAR<Indikativ<han+UNA
Ivittuunukaqqaarpugut	Ivittuut<Terminalis-KAR-QQAAR<Indikativ<vi
Ivittuunukareerpugununa	Ivittuut<Terminalis-KAR-RIIR<Indikativ<vi+UNA
Ivittuunukassagamali	Ivittuut<Terminalis-KAR-SSA<Causativ<jeg+LI
kalaaleq	kalaaleq<ental<Absolut
kalaalerli	kalaaleq<ental<Absolut+LI
kalaalerlu	kalaaleq<ental<Absolut+LU
kalaaleruna	kalaaleq<ental<Absolut+UNA
kalaallimik	kalaaleq<ental<Instrumentalis
kalaallimilli	kalaaleq<ental<Instrumentalis+LI
kalaallimillu	kalaaleq<ental<Instrumentalis+LU
kalaalliminguna	kalaaleq<ental<Instrumentalis+UNA
kalaallimi	kalaaleq<ental<Lokalis
kalaallimeeqqaarlutilli	kalaaleq<ental<Lokalis+IP-QQAAR<Ledsagemåde<de_selv+LI
kalaallimeeriarama	kalaaleq<ental<Lokalis+IP-RIAR<Causativ<jeg
kalaallimeeriarpit	kalaaleq<ental<Lokalis+IP-RIAR<Interrogativ<du
kalaallimut	kalaaleq<ental<Terminalis
kalaallimukariarneq	kalaaleq<ental<Terminalis-KAR-RIAR+NIQ
kalaallimulli	kalaaleq<ental<Terminalis+LI
kalaallinik	kalaaleq<flertal<Instrumentalis
kalaallinilli	kalaaleq<flertal<Instrumentalis+LI
kalaallini	kalaaleq<flertal<Lokalis
kalaalliniissagaluarpit	kalaaleq<flertal<Lokalis+IP-SSA=GALUAR<Interrogativ<du
kalaaleriilerippulli	kalaaleq+GIIT-LIRI<Indikativ<de+LI
kalaalerisimaviuk	kalaaleq+GӘ+SIMA<Interrogativ<du-dem
kalaaliinnarmeeqqummangali	kalaaleq-INNAQ<ental<Lokalis+IP-QQU<Causativ<HanMig+LI
kalaaliinnakkaana	kalaaleq-INNAQ<flertal<min<Absolut+UNA
kalaaliinnanngulertoralu	kalaaleq-INNAQ-NNGUR-LIR+TUQ<ental<min<Absolut+LU
kalaalillit	kalaaleq-LIK<flertal<Absolut
kalaalillilli	kalaaleq-LIK<flertal<Absolut+LI
kalaalilii	kalaaleq-LIK<flertal<hans<Absolut
kalaalillillu	kalaaleq-LIK<flertal<Relativ+LU
kalaalilinngussagaluarlutik	kalaaleq-LIK-NNGUR-SSA=GALUAR<Ledsagemåde<de_selv
kalaalilinngussagaluartooqqaarpugulli	kalaaleq-LIK-NNGUR-SSA=GALUAR+TUQ-U-QQAAR<Indikativ<vi+LI
kalaalinnguuneramali	kalaaleq-NNGUAQ-U+NIR<Causativ<jeg+LI
kalaalinngooqqullugilli	kalaaleq-NNGUAQ-U-QQU<Ledsagemåde<dem+LI
kalaalinngooriarlunga	kalaaleq-NNGUAQ-U-RIAR<Ledsagemåde<jeg
kalaalinngooriarlungalu	kalaaleq-NNGUAQ-U-RIAR<Ledsagemåde<jeg+LU
kalaalinngooreerpunga	kalaaleq-NNGUAQ-U-RIIR<Indikativ<jeg
kalaalinngooreerlutilli	kalaaleq-NNGUAQ-U-RIIR<Ledsagemåde<de_selv+LI
kalaalinnguusaraluarpit	kalaaleq-NNGUAQ-U+TAR=GALUAR<Interrogativ<du
kalaalinngornikuusuunikka	kalaaleq-NNGUR+NIKUU+TUQ-U+NIQ<flertal<min<Absolut
kalaalinngoqquaalu	kalaaleq-NNGUR-QQU<Indikativ<HanHam+LU
kalaalinngoreernerneeriarlutik	kalaaleq-NNGUR-RIIR+NIQ<flertal<Lokalis+IP-RIAR<Ledsagemåde<de_selv
kalaalinngussagaluartungali	kalaaleq-NNGUR-SSA=GALUAR<Participium<jeg+LI
kalaalinngussaagununa	kalaaleq-NNGUR-SSA<Indikativ<vi+UNA
kalaaleqaannartorli	kalaaleq-QAR-INNAR<Participium<han+LI
kalaaleqalertoruna	kalaaleq-QAR-LIR<Participium<han+UNA
kalaaleqalertoq	kalaaleq-QAR-LIR+TUQ
kalaaleqaqqutigilli	kalaaleq-QAR-QQU<Imperativ<ViDem+LI
kalaaleqassaarlu	kalaaleq-QAR-SSA<Indikativ<han+LU
kalaalissarali	kalaaleq-SSAQ<ental<min<Absolut+LI
kalaalissaqaannarporlu	kalaaleq-SSAQ-QAR-INNAR<Indikativ<han+LU
kalaallisut	kalaallisut<Partikel
kalaallisulli	kalaallisut<Partikel+LI
kalaallisullu	kalaallisut<Partikel+LU
kalaallisununa	kalaallisut<Partikel+UNA
Kangaatsiaq	Kangaatsiaq<Absolut
Kangaatsiarli	Kangaatsiaq<Absolut+LI
Kangaatsiarlu	Kangaatsiaq<Absolut+LU
Kangaatsiaruna	Kangaatsiaq<Absolut+UNA
Kangaatsiamik	Kangaatsiaq<Instrumentalis
Kangaatsiamilli	Kangaatsiaq<Instrumentalis+LI
Kangaatsiamillu	Kangaatsiaq<Instrumentalis+LU
Kangaatsiami	Kangaatsiaq<Lokalis
Kangaatsiameeqqaarama	Kangaatsiaq<Lokalis+IP-QQAAR<Causativ<jeg
Kangaatsiameeqquassili	Kangaatsiaq<Lokalis+IP-QQU<Indikativ<JegJer+LI
Kangaatsiameeriarpit	Kangaatsiaq<Lokalis+IP-RIAR<Interrogativ<du
Kangaatsiarmiuneeqqulluginuna	Kangaatsiaq+MIU<flertal<Lokalis+IP-QQU<Ledsagemåde<dem+UNA
Kangaatsiarmiulerisoq	Kangaatsiaq+MIU-LIRI+TUQ
Kangaatsiarmiunngoqqaarpit	Kangaatsiaq+MIU-NNGUR-QQAAR<Interrogativ<du
Kangaatsiarmioqarneq	Kangaatsiaq+MIU-QAR+NIQ
Kangaatsiarmioqartoq	Kangaatsiaq+MIU-QAR+TUQ
Kangaatsiarmioqartoruna	Kangaatsiaq+MIU-QAR+TUQ+UNA
Kangaatsiarmiuunerlutinguna	Kangaatsiaq+MIU-U+NIR<Ledsagemåde<de_selv+UNA
Kangaatsiarmiooqqutigit	Kangaatsiaq+MIU-U-QQU<Imperativ<ViDem
Kangaatsiarmiooqqullugit	Kangaatsiaq+MIU-U-QQU<Ledsagemåde<dem
Kangaatsiarmiooriarama	Kangaatsiaq+MIU-U-RIAR<Causativ<jeg
Kangaatsiarmiooreerpunga	Kangaatsiaq+MIU-U-RIIR<Indikativ<jeg
Kangaatsiarmiooreerlutik	Kangaatsiaq+MIU-U-RIIR<Ledsagemåde<de_selv
Kangaatsiarmiuusussaqaannarpugullu	Kangaatsiaq+MIU-U+TUQ-SSAQ-QAR-INNAR<Indikativ<vi+LU
Kangaatsiamukalaartarpugut	Kangaatsiaq<Terminalis-KAR-LAAR=TAR<Indikativ<vi
Kangaatsiamukalaartarneq	Kangaatsiaq<Terminalis-KAR-LAAR=TAR+NIQ
Kangaatsiamullu	Kangaatsiaq<Terminalis+LU
Kangaatsiamununa	Kangaatsiaq<Terminalis+UNA
Kangerlussuaq	Kangerlussuaq<Absolut
Kangerlussuarli	Kangerlussuaq<Absolut+LI
Kangerlussuarlu	Kangerlussuaq<Absolut+LU
Kangerlussuarmik	Kangerlussuaq<Instrumentalis
Kangerlussuarmilli	Kangerlussuaq<Instrumentalis+LI
Kangerlussuarmillu	Kangerlussuaq<Instrumentalis+LU
Kangerlussuarminguna	Kangerlussuaq<Instrumentalis+UNA
Kangerlussuarmi	Kangerlussuaq<Lokalis
Kangerlussuarmiikkiartortorlu	Kangerlussuaq<Lokalis+IP+GIARTUR<Participium<han+LU
Kangerlussuarmeeqqaaramali	Kangerlussuaq<Lokalis+IP-QQAAR<Causativ<jeg+LI
Kangerlussuarmeeqqaarlutik	Kangerlussuaq<Lokalis+IP-QQAAR<Ledsagemåde<de_selv
Kangerlussuarmeeqqaarneq	Kangerlussuaq<Lokalis+IP-QQAAR+NIQ
Kangerlussuarmeeqqutiginuna	Kangerlussuaq<Lokalis+IP-QQU<Imperativ<ViDem+UNA
Kangerlussuarmeeqqullugilli	Kangerlussuaq<Lokalis+IP-QQU<Ledsagemåde<dem+LI
Kangerlussuarmeeqqullugu	Kangerlussuaq<Lokalis+IP-QQU<Ledsagemåde<ham
Kangerlussuarmeeriartunga	Kangerlussuaq<Lokalis+IP-RIAR<Participium<jeg
Kangerlussuarmiissagama	Kangerlussuaq<Lokalis+IP-SSA<Causativ<jeg
Kangerlussuarmilu	Kangerlussuaq<Lokalis+LU
Kangerlussuarmiuna	Kangerlussuaq<Lokalis+UNA
Kangerlussuarmiumeeriarpugulli	Kangerlussuaq+MIU<ental<Lokalis+IP-RIAR<Indikativ<vi+LI
Kangerlussuarmiuniillutilli	Kangerlussuaq+MIU<flertal<Lokalis+IP<Ledsagemåde<de_selv+LI
Kangerlussuarmiuneereerneruna	Kangerlussuaq+MIU<flertal<Lokalis+IP-RIIR+NIQ+UNA
Kangerlussuarmiunngulaartarlutik	Kangerlussuaq+MIU-NNGUR-LAAR=TAR<Ledsagemåde<de_selv
Kangerlussuarmiuuallaarpit	Kangerlussuaq+MIU-U+VALLAAR<Interrogativ<du
Kangerlussuarmukaannarporli	Kangerlussuaq<Terminalis-KAR-INNAR<Indikativ<han+LI
Kangerlussuarmukalaartarlutik	Kangerlussuaq<Terminalis-KAR-LAAR=TAR<Ledsagemåde<de_selv
Kangerlussuarmukalertorli	Kangerlussuaq<Terminalis-KAR-LIR<Participium<han+LI
Kangerlussuarmukannginnama	Kangerlussuaq<Terminalis-KAR-NNGIT<Causativ<jeg
Kangerlussuarmukariarlutik	Kangerlussuaq<Terminalis-KAR-RIAR<Ledsagemåde<de_selv
Kangerlussuarmukassagama	Kangerlussuaq<Terminalis-KAR-SSA<Causativ<jeg
Kangerlussuarmulli	Kangerlussuaq<Terminalis+LI
kiisa	kiisa<Partikel
kiisaana	kiisa<Partikel+UNA
kingullernilu	kingulleq<flertal<Lokalis+LU
kingullerinianngiliuk	kingulleq+GӘ+NIAR=NNGIT<Interrogativ<du-dem
kingullermiooqqullugu	kingulleq+MIU-U-QQU<Ledsagemåde<ham
kingullinnguarali	kingulleq-NNGUAQ<ental<min<Absolut+LI
kingullinngulaarnerilli	kingulleq-NNGUR-LAAR+NIQ<flertal<Relativ+LI
kingullinngunngitsuuit	kingulleq-NNGUR-NNGIT+TUQ-U<Interrogativ<du
kingullinngussavit	kingulleq-NNGUR-SSA<Interrogativ<du
kingullerpassuilli	kingulleq+PASSUAQ<flertal<Absolut+LI
kingullerpassuiuna	kingulleq+PASSUAQ<flertal<hans<Absolut+UNA
kingulleqalaartaramaana	kingulleq-QAR-LAAR=TAR<Causativ<jeg+UNA
kingulleqalaartarninili	kingulleq-QAR-LAAR=TAR+NIQ<ental<sin<Absolut+LI
kingulleqalerpunga	kingulleq-QAR-LIR<Indikativ<jeg
kingulleqarsimasarlutinguna	kingulleq-QAR+SIMA=TAR<Ledsagemåde<de_selv+UNA
kingulleqassappununa	kingulleq-QAR-SSA<Indikativ<de+UNA
kisimi	kisimi<Adjektiv
kisimili	kisimi<Adjektiv+LI
kisimiuna	kisimi<Adjektiv+UNA
kitaa	kitә<ental<hans<Absolut
kitaani	kitә<ental<Lokalis<hans
kitiga	kitә<ental<min<Absolut
kitigali	kitә<ental<min<Absolut+LI
kitima	kitә<ental<min>Relativ
kitaanut	kitә<ental<Terminalis<hans
kitinnguaq	kitә-NNGUAQ<ental<Absolut
kitinnguaneeqqaarama	kitә-NNGUAQ<ental<hans<Lokalis+IP-QQAAR<Causativ<jeg
kitinnguanilu	kitә-NNGUAQ<ental<hans<Lokalis+LU
kitinnguulaartarporli	kitә-NNGUAQ-U-LAAR=TAR<Indikativ<han+LI
kitinnguusununa	kitә-NNGUAQ-U<Participium<de+UNA
kitissarlu	kitә-SSAQ<ental<Absolut+LU
kitissaminguna	kitә-SSAQ<ental<Instrumentalis+UNA
kitissara	kitә-SSAQ<ental<min<Absolut
kitissama	kitә-SSAQ<ental<min>Relativ
kitissalerivit	kitә-SSAQ-LIRI<Interrogativ<du
kitissanngoqqaarama	kitә-SSAQ-NNGUR-QQAAR<Causativ<jeg
kitissaqalerlutinguna	kitә-SSAQ-QAR-LIR<Ledsagemåde<de_selv+UNA
kitissaqannginnerilli	kitә-SSAQ-QAR-NNGIT+NIQ<flertal<Relativ+LI
kitissaaniarpit	kitә-SSAQ-U+NIAR<Interrogativ<du
kunngili	kunngi<ental<Absolut+LI
kunngitut	kunngi<ental<Aequalis
kunngia	kunngi<ental<hans<Absolut
kunngiga	kunngi<ental<min<Absolut
kunngikka	kunngi<flertal<min<Absolut
kunngigiinnut	kunngi+GIIT<flertal<Terminalis
kunngigereerlugu	kunngi+GӘ-RIIR<Ledsagemåde<ham
kunngigisinnaatigit	kunngi+GӘ+SINNAA<Imperativ<ViDem
kunngigisaraluarluginuna	kunngi+GӘ+TAR=GALUAR<Ledsagemåde<dem+UNA
kunngiinnaalli	kunngi-INNAQ<flertal<Relativ+LI
kunngiinnalerippullu	kunngi-INNAQ-LIRI<Indikativ<de+LU
kunngiinnalerillutillu	kunngi-INNAQ-LIRI<Ledsagemåde<de_selv+LU
kunngiinnanngoqqaartoq	kunngi-INNAQ-NNGUR-QQAAR<Participium<han
kunngiinnaqareeramalu	kunngi-INNAQ-QAR-RIIR<Causativ<jeg+LU
kunngilittulli	kunngi-LIK<ental<Aequalis+LI
kunngillit	kunngi-LIK<flertal<Absolut
kunngillinuna	kunngi-LIK<flertal<Absolut+UNA
kunngillit	kunngi-LIK<flertal<Relativ
kunngillillu	kunngi-LIK<flertal<Relativ+LU
kunngilerivugut	kunngi-LIRI<Indikativ<vi
kunngilerillutillu	kunngi-LIRI<Ledsagemåde<de_selv+LU
kunngilerisungaana	kunngi-LIRI<Participium<jeg+UNA
kunngilerisoqanngilaq	kunngi-LIRI+TUQ-QAR-NNGIT<Indikativ<han
kunnginngulaarniniuna	kunngi-NNGUR-LAAR+NIQ<ental<sin<Absolut+UNA
kunnginngulaartarnerma	kunngi-NNGUR-LAAR=TAR+NIQ<ental<min>Relativ
kunngerpassuit	kunngi+PASSUAQ<flertal<Absolut
kunngerpassuilli	kunngi+PASSUAQ<flertal<Absolut+LI
kunngerpassuillu	kunngi+PASSUAQ<flertal<Absolut+LU
kunngerpassuinuna	kunngi+PASSUAQ<flertal<Absolut+UNA
kunngerpassui	kunngi+PASSUAQ<flertal<hans<Absolut
kunngerpassuili	kunngi+PASSUAQ<flertal<hans<Absolut+LI
kunngerpassuarninguna	kunngi+PASSUAQ<flertal<Instrumentalis+UNA
kunngerpassuarni	kunngi+PASSUAQ<flertal<Lokalis
kunngerpassuakka	kunngi+PASSUAQ<flertal<min<Absolut
kunngerpassuarnulli	kunngi+PASSUAQ<flertal<Terminalis+LI
kunngeqaannarlutinguna	kunngi-QAR-INNAR<Ledsagemåde<de_selv+UNA
kunngeqalaarpununa	kunngi-QAR-LAAR<Indikativ<de+UNA
kunngeqalaartarpit	kunngi-QAR-LAAR=TAR<Interrogativ<du
kunngeqalaartartuinnanngoreertulli	kunngi-QAR-LAAR=TAR+TUQ-INNAQ-NNGUR-RIIR<Participium<de+LI
kunngeqalerlutilli	kunngi-QAR-LIR<Ledsagemåde<de_selv+LI
kunngeqalertunngornerama	kunngi-QAR-LIR+TUQ-NNGUR+NIR<Causativ<jeg
kunngeqaqqaarninilu	kunngi-QAR-QQAAR+NIQ<ental<sin<Absolut+LU
kunngeqaqqugakku	kunngi-QAR-QQU<Causativ<JegHam
kunngeqaqqutigit	kunngi-QAR-QQU<Imperativ<ViDem
kunngeqaqquiuk	kunngi-QAR-QQU<Interrogativ<du-dem
kunngeqareerpit	kunngi-QAR-RIIR<Interrogativ<du
kunngeqassagaluarnerinuna	kunngi-QAR-SSA=GALUAR+NIQ<flertal<Absolut+UNA
kunngeqassagaluartullillu	kunngi-QAR-SSA=GALUAR+TUQ-LIK<flertal<Absolut+LU
kunngeqassasullu	kunngi-QAR-SSA<Participium<de+LU
kunngeqassasununa	kunngi-QAR-SSA<Participium<de+UNA
kunngissarali	kunngi-SSAQ<ental<min<Absolut+LI
kunngioreerlutik	kunngi-U-RIIR<Ledsagemåde<de_selv
kunngiusimasarpugununa	kunngi-U+SIMA=TAR<Indikativ<vi+UNA
maani	maani<Partikel
maanili	maani<Partikel+LI
maanilu	maani<Partikel+LU
maaniuna	maani<Partikel+UNA
makku	makku<Pronomen<flertal<Absolut
makkuli	makku<Pronomen<flertal<Absolut+LI
makkulu	makku<Pronomen<flertal<Absolut+LU
makkunani	makku<Pronomen<flertal<Lokalis
makkunaniikkaluartoqarpoq	makku<Pronomen<flertal<Lokalis+IP+GALUAR+TUQ-QAR<Indikativ<han
makkunaneeqquassiuna	makku<Pronomen<flertal<Lokalis+IP-QQU<Indikativ<JegJer+UNA
makkunanili	makku<Pronomen<flertal<Lokalis+LI
makkunanilu	makku<Pronomen<flertal<Lokalis+LU
Maniitsoq	Maniitsoq<Absolut
Maniitsorli	Maniitsoq<Absolut+LI
Maniitsorlu	Maniitsoq<Absolut+LU
Maniitsoruna	Maniitsoq<Absolut+UNA
Maniitsumik	Maniitsoq<Instrumentalis
Maniitsumilli	Maniitsoq<Instrumentalis+LI
Maniitsumillu	Maniitsoq<Instrumentalis+LU
Maniitsuminguna	Maniitsoq<Instrumentalis+UNA
Maniitsumi	Maniitsoq<Lokalis
Maniitsumiiginnarpugulli	Maniitsoq<Lokalis+IP-INNAR<Indikativ<vi+LI
Maniitsumiilaartarneruna	Maniitsoq<Lokalis+IP-LAAR=TAR+NIQ+UNA
Maniitsumiilerama	Maniitsoq<Lokalis+IP-LIR<Causativ<jeg
Maniitsumeeqqaarama	Maniitsoq<Lokalis+IP-QQAAR<Causativ<jeg
Maniitsumeeqqaarpit	Maniitsoq<Lokalis+IP-QQAAR<Interrogativ<du
Maniitsumeeqqaarlutillu	Maniitsoq<Lokalis+IP-QQAAR<Ledsagemåde<de_selv+LU
Maniitsumeeqqaartunga	Maniitsoq<Lokalis+IP-QQAAR<Participium<jeg
Maniitsumeeqqaartoqarporlu	Maniitsoq<Lokalis+IP-QQAAR+TUQ-QAR<Indikativ<han+LU
Maniitsumeeqqummanga	Maniitsoq<Lokalis+IP-QQU<Causativ<HanMig
Maniitsumeeqqutigilli	Maniitsoq<Lokalis+IP-QQU<Imperativ<ViDem+LI
Maniitsumeeqqutiginuna	Maniitsoq<Lokalis+IP-QQU<Imperativ<ViDem+UNA
Maniitsumeeqquakka	Maniitsoq<Lokalis+IP-QQU<Indikativ<JegDem
Maniitsumeeqquiuk	Maniitsoq<Lokalis+IP-QQU<Interrogativ<du-dem
Maniitsumeeqqullugu	Maniitsoq<Lokalis+IP-QQU<Ledsagemåde<ham
Maniitsumeeqqullugulu	Maniitsoq<Lokalis+IP-QQU<Ledsagemåde<ham+LU
Maniitsumeeriarama	Maniitsoq<Lokalis+IP-RIAR<Causativ<jeg
Maniitsumeeriaramali	Maniitsoq<Lokalis+IP-RIAR<Causativ<jeg+LI
Maniitsumeeriaramalu	Maniitsoq<Lokalis+IP-RIAR<Causativ<jeg+LU
Maniitsumeeriarporli	Maniitsoq<Lokalis+IP-RIAR<Indikativ<han+LI
Maniitsumeeriarlutik	Maniitsoq<Lokalis+IP-RIAR<Ledsagemåde<de_selv
Maniitsumeeriarneq	Maniitsoq<Lokalis+IP-RIAR+NIQ
Maniitsumeeriarnerli	Maniitsoq<Lokalis+IP-RIAR+NIQ+LI
Maniitsumeeriartorli	Maniitsoq<Lokalis+IP-RIAR<Participium<han+LI
Maniitsumeeriartoq	Maniitsoq<Lokalis+IP-RIAR+TUQ
Maniitsumeeriartoruna	Maniitsoq<Lokalis+IP-RIAR+TUQ+UNA
Maniitsumeereeramali	Maniitsoq<Lokalis+IP-RIIR<Causativ<jeg+LI
Maniitsumeereerneq	Maniitsoq<Lokalis+IP-RIIR+NIQ
Maniitsumeereertoq	Maniitsoq<Lokalis+IP-RIIR+TUQ
Maniitsumeereertoqarporlu	Maniitsoq<Lokalis+IP-RIIR+TUQ-QAR<Indikativ<han+LU
Maniitsumiippallaaramali	Maniitsoq<Lokalis+IP+VALLAAR<Causativ<jeg+LI
Maniitsumili	Maniitsoq<Lokalis+LI
Maniitsumilu	Maniitsoq<Lokalis+LU
Maniitsumiuna	Maniitsoq<Lokalis+UNA
Maniitsormiumulli	Maniitsoq+MIU<ental<Terminalis+LI
Maniitsormiuni	Maniitsoq+MIU<flertal<Lokalis
Maniitsormiuneeqqaartulli	Maniitsoq+MIU<flertal<Lokalis+IP-QQAAR<Participium<de+LI
Maniitsormiuneereerneq	Maniitsoq+MIU<flertal<Lokalis+IP-RIIR+NIQ
Maniitsormiulerivit	Maniitsoq+MIU-LIRI<Interrogativ<du
Maniitsormiulerillutilli	Maniitsoq+MIU-LIRI<Ledsagemåde<de_selv+LI
Maniitsormiulerillutillu	Maniitsoq+MIU-LIRI<Ledsagemåde<de_selv+LU
Maniitsormiulerisullu	Maniitsoq+MIU-LIRI<Participium<de+LU
Maniitsormiulerisungali	Maniitsoq+MIU-LIRI<Participium<jeg+LI
Maniitsormiulerisungaana	Maniitsoq+MIU-LIRI<Participium<jeg+UNA
Maniitsormiulerisoqarpoq	Maniitsoq+MIU-LIRI+TUQ-QAR<Indikativ<han
Maniitsormiunngoqqaartuuniarlutik	Maniitsoq+MIU-NNGUR-QQAAR+TUQ-U+NIAR<Ledsagemåde<de_selv
Maniitsormiunngoriaramali	Maniitsoq+MIU-NNGUR-RIAR<Causativ<jeg+LI
Maniitsormiunngussaanga	Maniitsoq+MIU-NNGUR-SSA<Indikativ<jeg
Maniitsormioqarpoq	Maniitsoq+MIU-QAR<Indikativ<han
Maniitsormioqarporli	Maniitsoq+MIU-QAR<Indikativ<han+LI
Maniitsormioqarneq	Maniitsoq+MIU-QAR+NIQ
Maniitsormioqartoq	Maniitsoq+MIU-QAR<Participium<han
Maniitsormioqartorli	Maniitsoq+MIU-QAR<Participium<han+LI
Maniitsormioqartoruna	Maniitsoq+MIU-QAR<Participium<han+UNA
Maniitsormioqartoq	Maniitsoq+MIU-QAR+TUQ
Maniitsormiuulaarlutinguna	Maniitsoq+MIU-U-LAAR<Ledsagemåde<de_selv+UNA
Maniitsormiuulaartartulli	Maniitsoq+MIU-U-LAAR=TAR<Participium<de+LI
Maniitsormiuunikkaana	Maniitsoq+MIU-U+NIQ<flertal<min<Absolut+UNA
Maniitsormiuunngitsunga	Maniitsoq+MIU-U-NNGIT<Participium<jeg
Maniitsormiooqqaarama	Maniitsoq+MIU-U-QQAAR<Causativ<jeg
Maniitsormiooqqullugu	Maniitsoq+MIU-U-QQU<Ledsagemåde<ham
Maniitsormiooriarlunili	Maniitsoq+MIU-U-RIAR<Ledsagemåde<han_selv+LI
Maniitsormiooreernini	Maniitsoq+MIU-U-RIIR+NIQ<ental<sin<Absolut
Maniitsormiuusimasartoqaannarama	Maniitsoq+MIU-U+SIMA=TAR+TUQ-QAR-INNAR<Causativ<jeg
Maniitsormiuusinnaasoq	Maniitsoq+MIU-U+SINNAA+TUQ<ental<Absolut
Maniitsormiuussagama	Maniitsoq+MIU-U-SSA<Causativ<jeg
Maniitsormiuussagaluartungali	Maniitsoq+MIU-U-SSA=GALUAR<Participium<jeg+LI
Maniitsumut	Maniitsoq<Terminalis
Maniitsumukaraluartorli	Maniitsoq<Terminalis-KAR+GALUAR+TUQ+LI
Maniitsumukaannarpit	Maniitsoq<Terminalis-KAR-INNAR<Interrogativ<du
Maniitsumukaannartorli	Maniitsoq<Terminalis-KAR-INNAR<Participium<han+LI
Maniitsumukalaarama	Maniitsoq<Terminalis-KAR-LAAR<Causativ<jeg
Maniitsumukalaartarpulli	Maniitsoq<Terminalis-KAR-LAAR=TAR<Indikativ<de+LI
Maniitsumukalaartartoqanngilarli	Maniitsoq<Terminalis-KAR-LAAR=TAR+TUQ-QAR-NNGIT<Indikativ<han+LI
Maniitsumukalerama	Maniitsoq<Terminalis-KAR-LIR<Causativ<jeg
Maniitsumukaleramali	Maniitsoq<Terminalis-KAR-LIR<Causativ<jeg+LI
Maniitsumukannginneq	Maniitsoq<Terminalis-KAR-NNGIT+NIQ
Maniitsumukaqqaarama	Maniitsoq<Terminalis-KAR-QQAAR<Causativ<jeg
Maniitsumukariarporlu	Maniitsoq<Terminalis-KAR-RIAR<Indikativ<han+LU
Maniitsumukariarneq	Maniitsoq<Terminalis-KAR-RIAR+NIQ
Maniitsumukariartoq	Maniitsoq<Terminalis-KAR-RIAR<Participium<han
Maniitsumukariartungali	Maniitsoq<Terminalis-KAR-RIAR<Participium<jeg+LI
Maniitsumukariartorli	Maniitsoq<Terminalis-KAR-RIAR+TUQ+LI
Maniitsumukassallutinguna	Maniitsoq<Terminalis-KAR-SSA<Ledsagemåde<de_selv+UNA
Maniitsumukassasorlu	Maniitsoq<Terminalis-KAR-SSA<Participium<han+LU
Maniitsumulli	Maniitsoq<Terminalis+LI
Maniitsumullu	Maniitsoq<Terminalis+LU
Maniitsumununa	Maniitsoq<Terminalis+UNA
manna	manna<Pronomen<ental
mannali	manna<Pronomen<ental+LI
mannalu	manna<Pronomen<ental+LU
mannaana	manna<Pronomen<ental+UNA
marluinnanngulaaramali	marluk-INNAQ-NNGUR-LAAR<Causativ<jeg+LI
marlussanngorpugut	marluk-SSAQ-NNGUR<Indikativ<vi
marlutullu	marluk<Talord<Aequalis+LU
marluk	marluk<Talord<flertal<Absolut
marlulli	marluk<Talord<flertal<Absolut+LI
marlullu	marluk<Talord<flertal<Absolut+LU
marlunguna	marluk<Talord<flertal<Absolut+UNA
marluniilerpit	marluk<Talord<Lokalis+IP-LIR<Interrogativ<du
marlulissamik	marluliaq<ental<Instrumentalis
marlulissami	marluliaq<ental<Lokalis
marlulissakka	marluliaq<flertal<min<Absolut
marlulissakkaana	marluliaq<flertal<min<Absolut+UNA
marluliariivi	marluliaq+GIIT<flertal<hans<Absolut
marlulialimmulli	marluliaq-LIK<ental<Terminalis+LI
marluliassaauna	marluliaq-SSAQ<flertal<hans<Absolut+UNA
massakkut	massakkut<Partikel
massakkulli	massakkut<Partikel+LI
massakkullu	massakkut<Partikel+LU
massakkununa	massakkut<Partikel+UNA
meeraq	meeraq<ental<Absolut
meeraruna	meeraq<ental<Absolut+UNA
meeqqatulli	meeraq<ental<Aequalis+LI
meeqqatullu	meeraq<ental<Aequalis+LU
meeqqatununa	meeraq<ental<Aequalis+UNA
meeraana	meeraq<ental<hans<Absolut+UNA
meerara	meeraq<ental<min<Absolut
meeqqani	meeraq<ental<sin<Absolut
meeqqanilu	meeraq<ental<sin<Absolut+LU
meeqqaniuna	meeraq<ental<sin<Absolut+UNA
meeqqamut	meeraq<ental<Terminalis
meeqqamukalaartungali	meeraq<ental<Terminalis-KAR-LAAR<Participium<jeg+LI
meeqqamukaqqummangalu	meeraq<ental<Terminalis-KAR-QQU<Causativ<HanMig+LU
meeqqamullu	meeraq<ental<Terminalis+LU
meeqqamununa	meeraq<ental<Terminalis+UNA
meeraa	meeraq<flertal<hans<Absolut
meeraalu	meeraq<flertal<hans<Absolut+LU
meeqqanik	meeraq<flertal<Instrumentalis
meeqqanilli	meeraq<flertal<Instrumentalis+LI
meeqqaninguna	meeraq<flertal<Instrumentalis+UNA
meeqqani	meeraq<flertal<Lokalis
meeqqaneeqqaarama	meeraq<flertal<Lokalis+IP-QQAAR<Causativ<jeg
meeqqaniissasullu	meeraq<flertal<Lokalis+IP-SSA<Participium<de+LU
meeqqaniittarama	meeraq<flertal<Lokalis+IP+TAR<Causativ<jeg
meeqqakka	meeraq<flertal<min<Absolut
meeqqakkalu	meeraq<flertal<min<Absolut+LU
meeqqanukaannartoq	meeraq<flertal<Terminalis-KAR-INNAR<Participium<han
meeqqanukassagamaana	meeraq<flertal<Terminalis-KAR-SSA<Causativ<jeg+UNA
meeqqanukassavit	meeraq<flertal<Terminalis-KAR-SSA<Interrogativ<du
meeqqanullu	meeraq<flertal<Terminalis+LU
meeqqanununa	meeraq<flertal<Terminalis+UNA
meerariinnununa	meeraq+GIIT<flertal<Terminalis+UNA
meerarartorpassili	meeraq+GӘ+GIARTUR<Indikativ<JegJer+LI
meerariviuk	meeraq+GӘ<Interrogativ<du-dem
meeraannanngoqqaartooriarlutinguna	meeraq-INNAQ-NNGUR-QQAAR+TUQ-U-RIAR<Ledsagemåde<de_selv+UNA
meeraannanngortorinerulluguli	meeraq-INNAQ-NNGUR+TUQ+GӘ+NIRU<Ledsagemåde<ham+LI
meeraannaqassallutik	meeraq-INNAQ-QAR-SSA<Ledsagemåde<de_selv
meeralittut	meeraq-LIK<ental<Aequalis
meeralikka	meeraq-LIK<flertal<min<Absolut
meerallinuna	meeraq-LIK<flertal<Relativ+UNA
meeralinngorsinnaasulinneereerpit	meeraq-LIK-NNGUR+SINNAA+TUQ-LIK<flertal<Lokalis+IP-RIIR<Interrogativ<du
meeralerisoq	meeraq-LIRI<Participium<han
meeralerisungali	meeraq-LIRI<Participium<jeg+LI
meeralerisoqarporuna	meeraq-LIRI+TUQ-QAR<Indikativ<han+UNA
meerarmiumiinnerpugulli	meeraq+MIU<ental<Lokalis+IP+NIR<Indikativ<vi+LI
meeranngooqqutigilli	meeraq-NNGUAQ-U-QQU<Imperativ<ViDem+LI
meerarpassuarneeqqaarpit	meeraq+PASSUAQ<flertal<Lokalis+IP-QQAAR<Interrogativ<du
mittarfilli	mittarfik<ental<Absolut+LI
mittarfittut	mittarfik<ental<Aequalis
mittarfittullu	mittarfik<ental<Aequalis+LU
mittarfittununa	mittarfik<ental<Aequalis+UNA
mittarfia	mittarfik<ental<hans<Absolut
mittarfimmi	mittarfik<ental<Lokalis
mittarfimmeereernerli	mittarfik<ental<Lokalis+IP-RIIR+NIQ+LI
mittarfinnilu	mittarfik<ental<sin<Absolut+LU
mittarfinneeqqullugulu	mittarfik<flertal<Lokalis+IP-QQU<Ledsagemåde<ham+LU
mittarfiit	mittarfik<flertal<Relativ
mittarfiilli	mittarfik<flertal<Relativ+LI
mittarfinnukaannarpunga	mittarfik<flertal<Terminalis-KAR-INNAR<Indikativ<jeg
mittarfigiit	mittarfik+GIIT<flertal<Absolut
mittarfigiittut	mittarfik+GIIT<flertal<Aequalis
mittarfigiilerillutik	mittarfik+GIIT-LIRI<Ledsagemåde<de_selv
mittarfigiilerisungali	mittarfik+GIIT-LIRI<Participium<jeg+LI
mittarfigiilerisoq	mittarfik+GIIT-LIRI+TUQ
mittarfiginngilakkalu	mittarfik+GӘ-NNGIT<Indikativ<JegDem+LU
mittarfigereerluguuna	mittarfik+GӘ-RIIR<Ledsagemåde<ham+UNA
mittarfigissatigit	mittarfik+GӘ-SSA<Imperativ<ViDem
mittarfilik	mittarfik-LIK<ental<Absolut
mittarfilinngulaaramali	mittarfik-LIK-NNGUR-LAAR<Causativ<jeg+LI
mittarfimmiuminguna	mittarfik+MIU<ental<Instrumentalis+UNA
mittarfimmiooqqaartussakkali	mittarfik+MIU-U-QQAAR+TUQ-SSAQ<flertal<min<Absolut+LI
mittarfimmiooriarama	mittarfik+MIU-U-RIAR<Causativ<jeg
mittarfinngoqqutiginuna	mittarfik-NNGUR-QQU<Imperativ<ViDem+UNA
mittarfippassuit	mittarfik+PASSUAQ<flertal<Absolut
mittarfippassui	mittarfik+PASSUAQ<flertal<hans<Absolut
mittarfippassuarniinnikuuvunga	mittarfik+PASSUAQ<flertal<Lokalis+IP+NIKUU<Indikativ<jeg
mittarfippassuakka	mittarfik+PASSUAQ<flertal<min<Absolut
mittarfippassuakkali	mittarfik+PASSUAQ<flertal<min<Absolut+LI
mittarfippassuakkaana	mittarfik+PASSUAQ<flertal<min<Absolut+UNA
mittarfeqaannarama	mittarfik-QAR-INNAR<Causativ<jeg
mittarfeqaannarpoq	mittarfik-QAR-INNAR<Indikativ<han
mittarfeqaannartulli	mittarfik-QAR-INNAR<Participium<de+LI
mittarfeqalaaramali	mittarfik-QAR-LAAR<Causativ<jeg+LI
mittarfeqalaaramalu	mittarfik-QAR-LAAR<Causativ<jeg+LU
mittarfeqalaarpit	mittarfik-QAR-LAAR<Interrogativ<du
mittarfeqalaartarama	mittarfik-QAR-LAAR=TAR<Causativ<jeg
mittarfeqalaartarpit	mittarfik-QAR-LAAR=TAR<Interrogativ<du
mittarfeqalaartarnerinuna	mittarfik-QAR-LAAR=TAR+NIQ<flertal<Absolut+UNA
mittarfeqalerama	mittarfik-QAR-LIR<Causativ<jeg
mittarfeqalerpugullu	mittarfik-QAR-LIR<Indikativ<vi+LU
mittarfeqalerpit	mittarfik-QAR-LIR<Interrogativ<du
mittarfeqalerlutik	mittarfik-QAR-LIR<Ledsagemåde<de_selv
mittarfeqalertoq	mittarfik-QAR-LIR<Participium<han
mittarfeqarnertut	mittarfik-QAR+NIR<Participium<de
mittarfeqannginnamalu	mittarfik-QAR-NNGIT<Causativ<jeg+LU
mittarfeqanngillanuna	mittarfik-QAR-NNGIT<Indikativ<de+UNA
mittarfeqannginnerit	mittarfik-QAR-NNGIT+NIQ<flertal<Relativ
mittarfeqanngitsoqalerninili	mittarfik-QAR-NNGIT+TUQ-QAR-LIR+NIQ<ental<sin<Absolut+LI
mittarfeqanngitsooqquiuk	mittarfik-QAR-NNGIT+TUQ-U-QQU<Interrogativ<du-dem
mittarfeqaqqaarpunga	mittarfik-QAR-QQAAR<Indikativ<jeg
mittarfeqaqqaarlutik	mittarfik-QAR-QQAAR<Ledsagemåde<de_selv
mittarfeqaqqaarnera	mittarfik-QAR-QQAAR+NIQ<ental<min<Absolut
mittarfeqaqqaarnikkali	mittarfik-QAR-QQAAR+NIQ<flertal<min<Absolut+LI
mittarfeqaqqaartulli	mittarfik-QAR-QQAAR<Participium<de+LI
mittarfeqaqqugakkuli	mittarfik-QAR-QQU<Causativ<JegHam+LI
mittarfeqaqquaa	mittarfik-QAR-QQU<Indikativ<HanHam
mittarfeqaqqullugillu	mittarfik-QAR-QQU<Ledsagemåde<dem+LU
mittarfeqariarama	mittarfik-QAR-RIAR<Causativ<jeg
mittarfeqariaramali	mittarfik-QAR-RIAR<Causativ<jeg+LI
mittarfeqariarlunili	mittarfik-QAR-RIAR<Ledsagemåde<han_selv+LI
mittarfeqareertuniilerpit	mittarfik-QAR-RIIR+TUQ<flertal<Lokalis+IP-LIR<Interrogativ<du
mittarfeqareertunngooriartununa	mittarfik-QAR-RIIR+TUQ-NNGUAQ-U-RIAR<Participium<de+UNA
mittarfeqarsinnaavunga	mittarfik-QAR+SINNAA<Indikativ<jeg
mittarfeqassagaluarnernik	mittarfik-QAR-SSA=GALUAR+NIQ<flertal<Instrumentalis
mittarfeqassaagut	mittarfik-QAR-SSA<Indikativ<vi
mittarfeqassavit	mittarfik-QAR-SSA<Interrogativ<du
mittarfeqassallutilli	mittarfik-QAR-SSA<Ledsagemåde<de_selv+LI
mittarfeqassasungalu	mittarfik-QAR-SSA<Participium<jeg+LU
mittarfissaa	mittarfik-SSAQ<flertal<hans<Absolut
naammassinikuullugu	naammassi+NIKUU<Ledsagemåde<ham
naammassineqarnerit	naammassi+NIQAR+NIQ<flertal<Relativ
naammasseqqaarpassiuna	naammassi-QQAAR<Indikativ<JegJer+UNA
naammasseqqummangaana	naammassi-QQU<Causativ<HanMig+UNA
naammasseqqugakku	naammassi-QQU<Causativ<JegHam
naammasseqqutigit	naammassi-QQU<Imperativ<ViDem
naammasseqqulluginuna	naammassi-QQU<Ledsagemåde<dem+UNA
naammasseriarakku	naammassi-RIAR<Causativ<JegHam
naammasseriarlunga	naammassi-RIAR<Ledsagemåde<mig
naammassisimasarlugu	naammassi+SIMA=TAR<Ledsagemåde<ham
naammassisinnaallugillu	naammassi+SINNAA<Ledsagemåde<dem+LU
naammassisinnaallugu	naammassi+SINNAA<Ledsagemåde<ham
naammassisinnaalluguuna	naammassi+SINNAA<Ledsagemåde<ham+UNA
naammassissagaluarlugu	naammassi-SSA=GALUAR<Ledsagemåde<ham
naammassivallaarpaanuna	naammassi+VALLAAR<Indikativ<DeHam+UNA
najaauna	naja<flertal<hans<Absolut+UNA
najaginerutigillu	naja+GӘ+NIRU<Imperativ<ViDem+LU
najalilli	naja-LIK<ental<Absolut+LI
najalia	naja-LIK<ental<hans<Absolut
najallilli	naja-LIK<flertal<Absolut+LI
najallit	naja-LIK<flertal<Relativ
najallilli	naja-LIK<flertal<Relativ+LI
najamioqarneq	naja+MIU-QAR+NIQ
najamioqarnerli	naja+MIU-QAR+NIQ+LI
najamioqartoq	naja+MIU-QAR<Participium<han
najanngooreerpugulli	naja-NNGUAQ-U-RIIR<Indikativ<vi+LI
najarpassuinuna	naja+PASSUAQ<flertal<Absolut+UNA
najaqassagama	naja-QAR-SSA<Causativ<jeg
najassaasunga	naja-SSAQ-U<Participium<jeg
najugaqarpungaana	najugaqar<Indikativ<jeg+UNA
najugaq	najugaq<ental<Absolut
najugarli	najugaq<ental<Absolut+LI
najukkami	najugaq<ental<Lokalis
najukkaneereertungali	najugaq<flertal<Lokalis+IP-RIIR<Participium<jeg+LI
najugarisaraluartigilli	najugaq+GӘ+TAR=GALUAR<Imperativ<ViDem+LI
najuganngulaartunngulaarpulli	najugaq-NNGUR-LAAR+TUQ-NNGUR-LAAR<Indikativ<de+LI
najuganngoqquiuk	najugaq-NNGUR-QQU<Interrogativ<du-dem
najugarpassuakka	najugaq+PASSUAQ<flertal<min<Absolut
nalugaluarlugu	nalu+GALUAR<Ledsagemåde<ham
nalunermangaana	nalu+NIR<Causativ<HanMig+UNA
naloqqaarmangali	nalu-QQAAR<Causativ<HanMig+LI
naloqqaartigilli	nalu-QQAAR<Imperativ<ViDem+LI
naloqqaarpaanngaana	nalu-QQAAR<Indikativ<DeMig+UNA
naloqqaarpiuk	nalu-QQAAR<Interrogativ<du-dem
naloqqummanga	nalu-QQU<Causativ<HanMig
naloriarlunga	nalu-RIAR<Ledsagemåde<mig
naloriarlungaana	nalu-RIAR<Ledsagemåde<mig+UNA
naloreerlugit	nalu-RIIR<Ledsagemåde<dem
nalusinnaammangalu	nalu+SINNAA<Causativ<HanMig+LU
nalussagaluarpaalli	nalu-SSA=GALUAR<Indikativ<DeHam+LI
nalussavassi	nalu-SSA<Indikativ<JegJer
nalusaraluarpassiuna	nalu+TAR=GALUAR<Indikativ<JegJer+UNA
naluallaanngiliuk	nalu+VALLAAR=NNGIT<Interrogativ<du-dem
nammineq	nammineq<Adjektiv
namminerli	nammineq<Adjektiv+LI
namminerlu	nammineq<Adjektiv+LU
nammineruna	nammineq<Adjektiv+UNA
Nanortalik	Nanortalik<Absolut
Nanortalilli	Nanortalik<Absolut+LI
Nanortalillu	Nanortalik<Absolut+LU
Nanortalinguna	Nanortalik<Absolut+UNA
Nanortalimmik	Nanortalik<Instrumentalis
Nanortalimmilli	Nanortalik<Instrumentalis+LI
Nanortalimmillu	Nanortalik<Instrumentalis+LU
Nanortalimminguna	Nanortalik<Instrumentalis+UNA
Nanortalimmi	Nanortalik<Lokalis
Nanortalimmiinniarlutik	Nanortalik<Lokalis+IP+NIAR<Ledsagemåde<de_selv
Nanortalimmeeqqaarlutik	Nanortalik<Lokalis+IP-QQAAR<Ledsagemåde<de_selv
Nanortalimmeeqqugakkuli	Nanortalik<Lokalis+IP-QQU<Causativ<JegHam+LI
Nanortalimmeereerlutinguna	Nanortalik<Lokalis+IP-RIIR<Ledsagemåde<de_selv+UNA
Nanortalimmeereertorli	Nanortalik<Lokalis+IP-RIIR<Participium<han+LI
Nanortalimmiunik	Nanortalik+MIU<flertal<Instrumentalis
Nanortalimmiunilli	Nanortalik+MIU<flertal<Instrumentalis+LI
Nanortalimmiunngoreertunngooqquakka	Nanortalik+MIU-NNGUR-RIIR+TUQ-NNGUAQ-U-QQU<Indikativ<JegDem
Nanortalimmioqarpoq	Nanortalik+MIU-QAR<Indikativ<han
Nanortalimmioqarporuna	Nanortalik+MIU-QAR<Indikativ<han+UNA
Nanortalimmioqarneq	Nanortalik+MIU-QAR+NIQ
Nanortalimmioqarnerlu	Nanortalik+MIU-QAR+NIQ+LU
Nanortalimmioqartoq	Nanortalik+MIU-QAR<Participium<han
Nanortalimmiooqqaarpunga	Nanortalik+MIU-U-QQAAR<Indikativ<jeg
Nanortalimmut	Nanortalik<Terminalis
Nanortalimmukaannarama	Nanortalik<Terminalis-KAR-INNAR<Causativ<jeg
Nanortalimmukaannarpulli	Nanortalik<Terminalis-KAR-INNAR<Indikativ<de+LI
Nanortalimmukaannarpit	Nanortalik<Terminalis-KAR-INNAR<Interrogativ<du
Nanortalimmukartulli	Nanortalik<Terminalis-KAR<Participium<de+LI
Nanortalimmukariartungali	Nanortalik<Terminalis-KAR-RIAR<Participium<jeg+LI
Nanortalimmullu	Nanortalik<Terminalis+LU
Nanortalimmununa	Nanortalik<Terminalis+UNA
Narsaq	Narsaq<Absolut
Narsarli	Narsaq<Absolut+LI
Narsarlu	Narsaq<Absolut+LU
Narsaruna	Narsaq<Absolut+UNA
Narsamik	Narsaq<Instrumentalis
Narsamilli	Narsaq<Instrumentalis+LI
Narsami	Narsaq<Lokalis
Narsameereertunga	Narsaq<Lokalis+IP-RIIR<Participium<jeg
Narsamiittarneq	Narsaq<Lokalis+IP+TAR+NIQ
Narsamilu	Narsaq<Lokalis+LU
Narsarmiuni	Narsaq+MIU<flertal<Lokalis
Narsarmiunngulaarnerma	Narsaq+MIU-NNGUR-LAAR+NIQ<ental<min>Relativ
Narsarmiunngussagaluarlutinguna	Narsaq+MIU-NNGUR-SSA=GALUAR<Ledsagemåde<de_selv+UNA
Narsarmioqarporlu	Narsaq+MIU-QAR<Indikativ<han+LU
Narsarmiooreerlutinguna	Narsaq+MIU-U-RIIR<Ledsagemåde<de_selv+UNA
Narsamut	Narsaq<Terminalis
Narsamukaannarnerli	Narsaq<Terminalis-KAR-INNAR+NIQ+LI
Narsamukassaanga	Narsaq<Terminalis-KAR-SSA<Indikativ<jeg
Narsamukarpallaarneq	Narsaq<Terminalis-KAR+VALLAAR+NIQ
Narsamulli	Narsaq<Terminalis+LI
Narsarsuarlu	Narsarsuaq<Absolut+LU
Narsarsuarmillu	Narsarsuaq<Instrumentalis+LU
Narsarsuarmi	Narsarsuaq<Lokalis
Narsarsuarmeeqqaarlutik	Narsarsuaq<Lokalis+IP-QQAAR<Ledsagemåde<de_selv
Narsarsuarmeeqqutigilli	Narsarsuaq<Lokalis+IP-QQU<Imperativ<ViDem+LI
Narsarsuarmeeriarneruna	Narsarsuaq<Lokalis+IP-RIAR+NIQ+UNA
Narsarsuarmiuneeqqaartut	Narsarsuaq+MIU<flertal<Lokalis+IP-QQAAR<Participium<de
Narsarsuarmiulerisunga	Narsarsuaq+MIU-LIRI<Participium<jeg
Narsarsuarmiunngorsimasartut	Narsarsuaq+MIU-NNGUR+SIMA=TAR<Participium<de
Narsarsuarmioqarporlu	Narsarsuaq+MIU-QAR<Indikativ<han+LU
Narsarsuarmiuusarporuna	Narsarsuaq+MIU-U+TAR<Indikativ<han+UNA
nukaga	nuka<ental<min<Absolut
nukagiilerineq	nuka+GIIT-LIRI+NIQ
nukagiinngorniarpugut	nuka+GIIT-NNGUR+NIAR<Indikativ<vi
nukaginerullugulu	nuka+GӘ+NIRU<Ledsagemåde<ham+LU
nukagivallaarmangalu	nuka+GӘ+VALLAAR<Causativ<HanMig+LU
nukaannaa	nuka-INNAQ<flertal<hans<Absolut
nukaannarneeriarlutinguna	nuka-INNAQ<flertal<Lokalis+IP-RIAR<Ledsagemåde<de_selv+UNA
nukallilli	nuka-LIK<flertal<Absolut+LI
nukallillu	nuka-LIK<flertal<Relativ+LU
nukalerivit	nuka-LIRI<Interrogativ<du
nukarpassuillu	nuka+PASSUAQ<flertal<Absolut+LU
nukarpassui	nuka+PASSUAQ<flertal<hans<Absolut
nukaqariarluni	nuka-QAR-RIAR<Ledsagemåde<han_selv
nukaqassallutik	nuka-QAR-SSA<Ledsagemåde<de_selv
nukarlinngooqquaali	nukarleq-NNGUAQ-U-QQU<Indikativ<HanHam+LI
nuliaq	nuliaq<ental<Absolut
nuliatulli	nuliaq<ental<Aequalis+LI
nuliara	nuliaq<ental<min<Absolut
nulianeeriartoq	nuliaq<flertal<Lokalis+IP-RIAR+TUQ
nuliaritigilli	nuliaq+GӘ<Imperativ<ViDem+LI
nuliaannalerivit	nuliaq-INNAQ-LIRI<Interrogativ<du
nuliaannanngussasorli	nuliaq-INNAQ-NNGUR-SSA<Participium<han+LI
nulialerillutinguna	nuliaq-LIRI<Ledsagemåde<de_selv+UNA
nuliarmiulerineq	nuliaq+MIU-LIRI+NIQ
nuliarmiooqqaarlutillu	nuliaq+MIU-U-QQAAR<Ledsagemåde<de_selv+LU
nulianngorsimasartuinnalerineq	nuliaq-NNGUR+SIMA=TAR+TUQ-INNAQ-LIRI+NIQ
nuliarpassuinuna	nuliaq+PASSUAQ<flertal<Absolut+UNA
nuliarpassuarnukaannarlutinguna	nuliaq+PASSUAQ<flertal<Terminalis-KAR-INNAR<Ledsagemåde<de_selv+UNA
nuliassaavallaannginnerali	nuliaq-SSAQ-U+VALLAAR=NNGIT+NIQ<ental<hans<Absolut+LI
nunalu	nuna<ental<Absolut+LU
nunagalu	nuna<ental<min<Absolut+LU
nunakka	nuna<flertal<min<Absolut
nunallinuna	nuna-LIK<flertal<Absolut+UNA
nunannguiuna	nuna-NNGUAQ<flertal<hans<Absolut+UNA
nunanngooreeramaana	nuna-NNGUAQ-U-RIIR<Causativ<jeg+UNA
nunaqariartorput	nuna-QAR+GIARTUR<Indikativ<de
nunaqassagaluarnerat	nuna-QAR-SSA=GALUAR+NIQ<ental<deres
nunassaavungalu	nuna-SSAQ-U<Indikativ<jeg+LU
nunaagaluarama	nuna-U+GALUAR<Causativ<jeg
nunaalertullu	nuna-U-LIR<Participium<de+LU
nutserisoq	nutserisoq<ental<Absolut
nutserisua	nutserisoq<ental<hans<Absolut
nutserisuni	nutserisoq<flertal<Lokalis
nutserisorinngilaalu	nutserisoq+GӘ-NNGIT<Indikativ<HanHam+LU
nutserisuinnalerineruna	nutserisoq-INNAQ-LIRI+NIQ+UNA
nutserisulerineq	nutserisoq-LIRI+NIQ
nutserisulerisorlu	nutserisoq-LIRI+TUQ+LU
nutserisormioqarneq	nutserisoq+MIU-QAR+NIQ
nutserisunnguugaluarama	nutserisoq-NNGUAQ-U+GALUAR<Causativ<jeg
nutserisunngooriartorli	nutserisoq-NNGUAQ-U-RIAR<Participium<han+LI
nutserisunngulaartarlutilli	nutserisoq-NNGUR-LAAR=TAR<Ledsagemåde<de_selv+LI
nutserisoqaqqaartuinnaqassagaluartungalu	nutserisoq-QAR-QQAAR+TUQ-INNAQ-QAR-SSA=GALUAR<Participium<jeg+LU
nutserisoqariarlutillu	nutserisoq-QAR-RIAR<Ledsagemåde<de_selv+LU
nutserisuugaluartullu	nutserisoq-U+GALUAR<Participium<de+LU
nutserisooqqaarpit	nutserisoq-U-QQAAR<Interrogativ<du
nutserisooreertut	nutserisoq-U-RIIR<Participium<de
Nuuk	Nuuk<Absolut
Nuulli	Nuuk<Absolut+LI
Nuullu	Nuuk<Absolut+LU
Nuunguna	Nuuk<Absolut+UNA
Nuummik	Nuuk<Instrumentalis
Nuummilli	Nuuk<Instrumentalis+LI
Nuummillu	Nuuk<Instrumentalis+LU
Nuumminguna	Nuuk<Instrumentalis+UNA
Nuummi	Nuuk<Lokalis
Nuummiiginnarama	Nuuk<Lokalis+IP-INNAR<Causativ<jeg
Nuummiilaarlutik	Nuuk<Lokalis+IP-LAAR<Ledsagemåde<de_selv
Nuummiilaarlutinguna	Nuuk<Lokalis+IP-LAAR<Ledsagemåde<de_selv+UNA
Nuummiilerpulli	Nuuk<Lokalis+IP-LIR<Indikativ<de+LI
Nuummiilerpit	Nuuk<Lokalis+IP-LIR<Interrogativ<du
Nuummiinnernerli	Nuuk<Lokalis+IP+NIR+NIQ+LI
Nuummiinnginnama	Nuuk<Lokalis+IP-NNGIT<Causativ<jeg
Nuummeeqqaarput	Nuuk<Lokalis+IP-QQAAR<Indikativ<de
Nuummeeqqaartoq	Nuuk<Lokalis+IP-QQAAR+TUQ
Nuummeeqqugakkuuna	Nuuk<Lokalis+IP-QQU<Causativ<JegHam+UNA
Nuummeeriarpungaana	Nuuk<Lokalis+IP-RIAR<Indikativ<jeg+UNA
Nuummeeriarlutik	Nuuk<Lokalis+IP-RIAR<Ledsagemåde<de_selv
Nuummeereeramali	Nuuk<Lokalis+IP-RIIR<Causativ<jeg+LI
Nuummeereernerli	Nuuk<Lokalis+IP-RIIR+NIQ+LI
Nuummili	Nuuk<Lokalis+LI
Nuummiumeereernerlu	Nuuk+MIU<ental<Lokalis+IP-RIIR+NIQ+LU
Nuummiumukalaartartoqarpoq	Nuuk+MIU<ental<Terminalis-KAR-LAAR=TAR+TUQ-QAR<Indikativ<han
Nuummiuneeqqugakku	Nuuk+MIU<flertal<Lokalis+IP-QQU<Causativ<JegHam
Nuummioqarpoq	Nuuk+MIU-QAR<Indikativ<han
Nuummioqarporli	Nuuk+MIU-QAR<Indikativ<han+LI
Nuummioqarneq	Nuuk+MIU-QAR+NIQ
Nuummioqarnerli	Nuuk+MIU-QAR+NIQ+LI
Nuummioqarneruna	Nuuk+MIU-QAR+NIQ+UNA
Nuummioqartoq	Nuuk+MIU-QAR+TUQ
Nuummioqartorlu	Nuuk+MIU-QAR+TUQ+LU
Nuummiuuit	Nuuk+MIU-U<Interrogativ<du
Nuummiuuneruvungalu	Nuuk+MIU-U+NIRU<Indikativ<jeg+LU
Nuummiooqqaarlutik	Nuuk+MIU-U-QQAAR<Ledsagemåde<de_selv
Nuummiooriaramali	Nuuk+MIU-U-RIAR<Causativ<jeg+LI
Nuummiooriartulli	Nuuk+MIU-U-RIAR<Participium<de+LI
Nuummiooreernini	Nuuk+MIU-U-RIIR+NIQ<ental<sin<Absolut
Nuummiooreertorli	Nuuk+MIU-U-RIIR<Participium<han+LI
Nuummut	Nuuk<Terminalis
Nuummukaannarneruna	Nuuk<Terminalis-KAR-INNAR+NIQ+UNA
Nuummukarlutillu	Nuuk<Terminalis-KAR<Ledsagemåde<de_selv+LU
Nuummukarsimallutillu	Nuuk<Terminalis-KAR+SIMA<Ledsagemåde<de_selv+LU
Nuummulli	Nuuk<Terminalis+LI
Nuummununa	Nuuk<Terminalis+UNA
nuukkama	nuup<Causativ<jeg
nuukkaluarpugununa	nuup+GALUAR<Indikativ<vi+UNA
nuukkiartoramalu	nuup+GIARTUR<Causativ<jeg+LU
nuukkiartortoq	nuup+GIARTUR+TUQ<ental<Absolut
nuulaartaramalu	nuup-LAAR=TAR<Causativ<jeg+LU
nuullutik	nuup<Ledsagemåde<de_selv
nuullutilli	nuup<Ledsagemåde<de_selv+LI
nuullutinguna	nuup<Ledsagemåde<de_selv+UNA
nuulerpugut	nuup-LIR<Indikativ<vi
nuulertoqalerpit	nuup-LIR+TUQ-QAR-LIR<Interrogativ<du
nuunniarlutinguna	nuup+NIAR<Ledsagemåde<de_selv+UNA
nuunnerlungali	nuup+NIR<Ledsagemåde<jeg+LI
nuunnginneri	nuup-NNGIT+NIQ<flertal<hans<Absolut
nuuttoq	nuup<Participium<han
nooqqaarput	nuup-QQAAR<Indikativ<de
nooqqaarpoq	nuup-QQAAR<Indikativ<han
nooqqaarpungalu	nuup-QQAAR<Indikativ<jeg+LU
nooqqaarpugulli	nuup-QQAAR<Indikativ<vi+LI
nooqqaarlutik	nuup-QQAAR<Ledsagemåde<de_selv
nooqqaarlutinguna	nuup-QQAAR<Ledsagemåde<de_selv+UNA
nooqqaarnerillu	nuup-QQAAR+NIQ<flertal<Relativ+LU
nooqqaartoq	nuup-QQAAR<Participium<han
nooqqaartoqalaartarama	nuup-QQAAR+TUQ-QAR-LAAR=TAR<Causativ<jeg
nooqqaartoqaqquaanga	nuup-QQAAR+TUQ-QAR-QQU<Indikativ<HanMig
nooqqaartooriarlungalu	nuup-QQAAR+TUQ-U-RIAR<Ledsagemåde<jeg+LU
nooqqummanga	nuup-QQU<Causativ<HanMig
nooqqutigilli	nuup-QQU<Imperativ<ViDem+LI
nooqqutigillu	nuup-QQU<Imperativ<ViDem+LU
nooqqutiginuna	nuup-QQU<Imperativ<ViDem+UNA
nooqquiuk	nuup-QQU<Interrogativ<du-dem
nooqqullugillu	nuup-QQU<Ledsagemåde<dem+LU
nooqqulluginuna	nuup-QQU<Ledsagemåde<dem+UNA
nooqqullugu	nuup-QQU<Ledsagemåde<ham
nooriarama	nuup-RIAR<Causativ<jeg
nooriaramali	nuup-RIAR<Causativ<jeg+LI
nooriaramaana	nuup-RIAR<Causativ<jeg+UNA
nooriarlunga	nuup-RIAR<Ledsagemåde<jeg
nooriartut	nuup-RIAR<Participium<de
nooriartorli	nuup-RIAR<Participium<han+LI
nooriartungaana	nuup-RIAR<Participium<jeg+UNA
nooreeramali	nuup-RIIR<Causativ<jeg+LI
nooreeramalu	nuup-RIIR<Causativ<jeg+LU
nooreerput	nuup-RIIR<Indikativ<de
nooreerpit	nuup-RIIR<Interrogativ<du
nooreerlutik	nuup-RIIR<Ledsagemåde<de_selv
nooreerlutilli	nuup-RIIR<Ledsagemåde<de_selv+LI
nooreerlutinguna	nuup-RIIR<Ledsagemåde<de_selv+UNA
nooreerneq	nuup-RIIR+NIQ<ental<Absolut
nooreertut	nuup-RIIR<Participium<de
nooreertunga	nuup-RIIR<Participium<jeg
nooreertuinnarmali	nuup-RIIR+TUQ-INNAQ<ental<min>Relativ+LI
nooreertullilli	nuup-RIIR+TUQ-LIK<flertal<Absolut+LI
nooreertullinuna	nuup-RIIR+TUQ-LIK<flertal<Relativ+UNA
nuussimasarlutik	nuup+SIMA=TAR<Ledsagemåde<de_selv
nuussinnaasulli	nuup+SINNAA<Participium<de+LI
nuuppallaannginatillu	nuup+VALLAAR=NNGIT<Ledsagemåde<de_selv+LU
nuuppallaanngitsussamiilerpit	nuup+VALLAAR=NNGIT+TUQ-SSAQ<ental<Lokalis+IP-LIR<Interrogativ<du
nuuppallaartoqareernikkali	nuup+VALLAAR+TUQ-QAR-RIIR+NIQ<flertal<min<Absolut+LI
oqaaseruna	oqaaseq<ental<Absolut+UNA
oqaatsitulli	oqaaseq<ental<Aequalis+LI
oqaatsitullu	oqaaseq<ental<Aequalis+LU
oqaatsimi	oqaaseq<ental<Lokalis
oqaatsimiissimagamalu	oqaaseq<ental<Lokalis+IP+SIMA<Causativ<jeg+LU
oqaatsini	oqaaseq<ental<sin<Absolut
oqaatsimukassagaluarlutillu	oqaaseq<ental<Terminalis-KAR-SSA=GALUAR<Ledsagemåde<de_selv+LU
oqaatsinut	oqaaseq<flertal<flertal<Terminalis
oqaatsinukaannarlutik	oqaaseq<flertal<flertal<Terminalis-KAR-INNAR<Ledsagemåde<de_selv
oqaatsinukassasut	oqaaseq<flertal<flertal<Terminalis-KAR-SSA<Participium<de
oqaatsinulli	oqaaseq<flertal<flertal<Terminalis+LI
oqaatsinik	oqaaseq<flertal<Instrumentalis
oqaatsininguna	oqaaseq<flertal<Instrumentalis+UNA
oqaatsini	oqaaseq<flertal<Lokalis
oqaatsinili	oqaaseq<flertal<Lokalis+LI
oqaatsinilu	oqaaseq<flertal<Lokalis+LU
oqaatsikka	oqaaseq<flertal<min<Absolut
oqaaserilaarpaangaana	oqaaseq+GӘ-LAAR<Indikativ<HanMig+UNA
oqaasiinnarninguna	oqaaseq-INNAQ<flertal<Instrumentalis+UNA
oqaasiinnaaqqugakku	oqaaseq-INNAQ-U-QQU<Causativ<JegHam
oqaasermiuneeqqulluguuna	oqaaseq+MIU<flertal<Lokalis+IP-QQU<Ledsagemåde<ham+UNA
oqaasermioqartorlu	oqaaseq+MIU-QAR<Participium<han+LU
oqaasinngui	oqaaseq-NNGUAQ<flertal<hans<Absolut
oqaasinngooqqullugit	oqaaseq-NNGUAQ-U-QQU<Ledsagemåde<dem
oqaaserpassuarneereerpit	oqaaseq+PASSUAQ<flertal<Lokalis+IP-RIIR<Interrogativ<du
oqaaseqaannartunga	oqaaseq-QAR-INNAR<Participium<jeg
oqaaseqaannartoq	oqaaseq-QAR-INNAR+TUQ<ental<Absolut
oqaaseqalaartartunngorpallaannginnamalu	oqaaseq-QAR-LAAR=TAR+TUQ-NNGUR+VALLAAR=NNGIT<Causativ<jeg+LU
oqaaseqaqqaarpungali	oqaaseq-QAR-QQAAR<Indikativ<jeg+LI
oqaaseqareerpununa	oqaaseq-QAR-RIIR<Indikativ<de+UNA
oqaaseqareerpunga	oqaaseq-QAR-RIIR<Indikativ<jeg
oqaaseqassagama	oqaaseq-QAR-SSA<Causativ<jeg
oqaasissaq	oqaaseq-SSAQ<ental<Absolut
oqaasiuallaarnerali	oqaaseq-U+VALLAAR+NIQ<ental<hans<Absolut+LI
oqaasilerinera	oqaasilerineq<ental<hans<Absolut
oqaasilerinikkaana	oqaasilerineq<flertal<min<Absolut+UNA
oqaasilerisukkali	oqaasilerisoq<flertal<min<Absolut+LI
oqaasilerisuinnanngussagaluartoq	oqaasilerisoq-INNAQ-NNGUR-SSA=GALUAR<Participium<han
oqaasilerisunngooreertut	oqaasilerisoq-NNGUAQ-U-RIIR<Participium<de
oqaasilerisoqanngitsunga	oqaasilerisoq-QAR-NNGIT<Participium<jeg
oqaasilerisoqaqqummangalu	oqaasilerisoq-QAR-QQU<Causativ<HanMig+LU
oqaluttuarama	oqaluttuar<Causativ<jeg
oqaluttuariartortulli	oqaluttuar+GIARTUR<Participium<de+LI
oqaluttuaannarama	oqaluttuar-INNAR<Causativ<jeg
oqaluttuaannarlutilli	oqaluttuar-INNAR<Ledsagemåde<de_selv+LI
oqaluttuaannartooriarlunga	oqaluttuar-INNAR+TUQ-U-RIAR<Ledsagemåde<jeg
oqaluttuarisaanerat	oqaluttuarisaaneq<ental<deres
oqaluttuarisaanermiooqqaartungalu	oqaluttuarisaaneq+MIU-U-QQAAR<Participium<jeg+LU
oqaluttualaaramali	oqaluttuar-LAAR<Causativ<jeg+LI
oqaluttualaarlutilli	oqaluttuar-LAAR<Ledsagemåde<de_selv+LI
oqaluttualaartooqqaartungalu	oqaluttuar-LAAR+TUQ-U-QQAAR<Participium<jeg+LU
oqaluttualerpugut	oqaluttuar-LIR<Indikativ<vi
oqaluttualerpit	oqaluttuar-LIR<Interrogativ<du
oqaluttuarniarnatik	oqaluttuar+NIAR=NNGIT<Ledsagemåde<de_selv
oqaluttuarnianngitsuinnaanerama	oqaluttuar+NIAR=NNGIT+TUQ-INNAQ-U+NIR<Causativ<jeg
oqaluttuarnikuugama	oqaluttuar+NIKUU<Causativ<jeg
oqaluttuarneralli	oqaluttuar+NIQ<ental<deres+LI
oqaluttuarneri	oqaluttuar+NIQ<flertal<hans<Absolut
oqaluttuarnertullu	oqaluttuar+NIR<Participium<de+LU
oqaluttuarnertunga	oqaluttuar+NIR<Participium<jeg
oqaluttuannginnerinuna	oqaluttuar-NNGIT+NIQ<flertal<Absolut+UNA
oqaluttuanngitsut	oqaluttuar-NNGIT<Participium<de
oqaluttuanngitsunga	oqaluttuar-NNGIT<Participium<jeg
oqaluttuartunga	oqaluttuar<Participium<jeg
oqaluttuaqqugakkuuna	oqaluttuar-QQU<Causativ<JegHam+UNA
oqaluttuaqqutigilli	oqaluttuar-QQU<Imperativ<ViDem+LI
oqaluttuariaramali	oqaluttuar-RIAR<Causativ<jeg+LI
oqaluttuariarlunili	oqaluttuar-RIAR<Ledsagemåde<han_selv+LI
oqaluttuariarlunga	oqaluttuar-RIAR<Ledsagemåde<jeg
oqaluttuariartununa	oqaluttuar-RIAR<Participium<de+UNA
oqaluttuareerlutik	oqaluttuar-RIIR<Ledsagemåde<de_selv
oqaluttuarsimavit	oqaluttuar+SIMA<Interrogativ<du
oqaluttuarsinnaavoq	oqaluttuar+SINNAA<Indikativ<han
oqaluttuassagaluarpit	oqaluttuar-SSA=GALUAR<Interrogativ<du
oqaluttuartaraluarama	oqaluttuar+TAR=GALUAR<Causativ<jeg
oqaluttuartarnerilli	oqaluttuar+TAR+NIQ<flertal<Relativ+LI
oqaluttuarpallaarpunga	oqaluttuar+VALLAAR<Indikativ<jeg
oqaluttuarpallaannginnama	oqaluttuar+VALLAAR=NNGIT<Causativ<jeg
oqarama	oqar<Causativ<jeg
oqaramali	oqar<Causativ<jeg+LI
oqaramalu	oqar<Causativ<jeg+LU
oqarfigigaluarmangalu	oqarfigә+GALUAR<Causativ<HanMig+LU
oqarfigalugillu	oqarfigә<Ledsagemåde<dem+LU
oqarfigilerpakka	oqarfigә-LIR<Indikativ<JegDem
oqaraluarpunga	oqar+GALUAR<Indikativ<jeg
oqaraluarpugut	oqar+GALUAR<Indikativ<vi
oqaraluartungali	oqar+GALUAR<Participium<jeg+LI
oqariartorpungali	oqar+GIARTUR<Indikativ<jeg+LI
oqariartortorlu	oqar+GIARTUR<Participium<han+LU
oqariartortulerivunga	oqar+GIARTUR+TUQ-LIRI<Indikativ<jeg
oqarpullu	oqar<Indikativ<de+LU
oqarpununa	oqar<Indikativ<de+UNA
oqarpugut	oqar<Indikativ<vi
oqaannaramali	oqar-INNAR<Causativ<jeg+LI
oqaannarpunga	oqar-INNAR<Indikativ<jeg
oqaannarninili	oqar-INNAR+NIQ<ental<sin<Absolut+LI
oqaannarnikka	oqar-INNAR+NIQ<flertal<min<Absolut
oqaannartoqannginnama	oqar-INNAR+TUQ-QAR-NNGIT<Causativ<jeg
oqaannartooqqaaramaana	oqar-INNAR+TUQ-U-QQAAR<Causativ<jeg+UNA
oqaannartooqqutigit	oqar-INNAR+TUQ-U-QQU<Imperativ<ViDem
oqarpit	oqar<Interrogativ<du
oqalaarpit	oqar-LAAR<Interrogativ<du
oqalaarlutik	oqar-LAAR<Ledsagemåde<de_selv
oqalaarlutinguna	oqar-LAAR<Ledsagemåde<de_selv+UNA
oqalaartarpit	oqar-LAAR=TAR<Interrogativ<du
oqalaartarnerat	oqar-LAAR=TAR+NIQ<ental<deres
oqalaartarneri	oqar-LAAR=TAR+NIQ<flertal<hans<Absolut
oqalaartartungali	oqar-LAAR=TAR<Participium<jeg+LI
oqalaartartoqaannarpugullu	oqar-LAAR=TAR+TUQ-QAR-INNAR<Indikativ<vi+LU
oqalaartuni	oqar-LAAR+TUQ<flertal<Lokalis
oqarlutik	oqar<Ledsagemåde<de_selv
oqalerpit	oqar-LIR<Interrogativ<du
oqalernera	oqar-LIR+NIQ<ental<hans<Absolut
oqalernikkali	oqar-LIR+NIQ<flertal<min<Absolut+LI
oqalertullu	oqar-LIR<Participium<de+LU
oqalertoq	oqar-LIR<Participium<han
oqalertunga	oqar-LIR<Participium<jeg
oqarniarpugununa	oqar+NIAR<Indikativ<vi+UNA
oqarniarpit	oqar+NIAR<Interrogativ<du
oqarniarlutik	oqar+NIAR<Ledsagemåde<de_selv
oqarniarneraana	oqar+NIAR+NIQ<ental<hans<Absolut+UNA
oqarniarnikka	oqar+NIAR+NIQ<flertal<min<Absolut
oqarniarnatilli	oqar+NIAR=NNGIT<Ledsagemåde<de_selv+LI
oqarnerlungaana	oqar+NIR<Ledsagemåde<jeg+UNA
oqarnertunga	oqar+NIR<Participium<jeg
oqarnerusussannguinnarpunga	oqar+NIRU+TUQ-SSAQ-NNGUR-INNAR<Indikativ<jeg
oqanngillalli	oqar-NNGIT<Indikativ<de+LI
oqanngilanga	oqar-NNGIT<Indikativ<jeg
oqanngilatit	oqar-NNGIT<Interrogativ<du
oqarnatik	oqar-NNGIT<Ledsagemåde<de_selv
oqarnatinguna	oqar-NNGIT<Ledsagemåde<de_selv+UNA
oqannginnikka	oqar-NNGIT+NIQ<flertal<min<Absolut
oqanngitsorlu	oqar-NNGIT<Participium<han+LU
oqartut	oqar<Participium<de
oqaqqaarama	oqar-QQAAR<Causativ<jeg
oqaqqaarpit	oqar-QQAAR<Interrogativ<du
oqaqqaartorpassui	oqar-QQAAR+TUQ+PASSUAQ<flertal<hans<Absolut
oqaqqutigillu	oqar-QQU<Imperativ<ViDem+LU
oqaqqutiginuna	oqar-QQU<Imperativ<ViDem+UNA
oqaqquiuk	oqar-QQU<Interrogativ<du-dem
oqariarama	oqar-RIAR<Causativ<jeg
oqariaramalu	oqar-RIAR<Causativ<jeg+LU
oqariartoq	oqar-RIAR<Participium<han
oqariartunga	oqar-RIAR<Participium<jeg
oqareerporli	oqar-RIIR<Indikativ<han+LI
oqareerpit	oqar-RIIR<Interrogativ<du
oqarsimallutilli	oqar+SIMA<Ledsagemåde<de_selv+LI
oqarsimasartulerisorli	oqar+SIMA=TAR+TUQ-LIRI+TUQ+LI
oqarsimasartorpassui	oqar+SIMA=TAR+TUQ+PASSUAQ<flertal<hans<Absolut
oqarsinnaanera	oqar+SINNAA+NIQ<ental<hans<Absolut
oqarsinnaanikka	oqar+SINNAA+NIQ<flertal<min<Absolut
oqarsinnaasoruna	oqar+SINNAA<Participium<han+UNA
oqassagama	oqar-SSA<Causativ<jeg
oqassagaluarama	oqar-SSA=GALUAR<Causativ<jeg
oqassagaluaramali	oqar-SSA=GALUAR<Causativ<jeg+LI
oqassagaluarpit	oqar-SSA=GALUAR<Interrogativ<du
oqassagaluarlutilli	oqar-SSA=GALUAR<Ledsagemåde<de_selv+LI
oqassagaluartunga	oqar-SSA=GALUAR<Participium<jeg
oqassapput	oqar-SSA<Indikativ<de
oqassallutillu	oqar-SSA<Ledsagemåde<de_selv+LU
oqartaraluartununa	oqar+TAR=GALUAR<Participium<de+UNA
oqartartungali	oqar+TAR<Participium<jeg+LI
oqartuili	oqar+TUQ<flertal<hans<Absolut+LI
oqartoqaqqutiginuna	oqar+TUQ-QAR-QQU<Imperativ<ViDem+UNA
oqartooqqaarpunga	oqar+TUQ-U-QQAAR<Indikativ<jeg
oqarpallaarlutinguna	oqar+VALLAAR<Ledsagemåde<de_selv+UNA
oqarpallaannginnerni	oqar+VALLAAR=NNGIT+NIQ<flertal<Lokalis
oqarpallaanngitsunga	oqar+VALLAAR=NNGIT<Participium<jeg
Paamiut	Paamiut<Absolut
Paamiulli	Paamiut<Absolut+LI
Paamiullu	Paamiut<Absolut+LU
Paamiununa	Paamiut<Absolut+UNA
Paamiunik	Paamiut<Instrumentalis
Paamiunilli	Paamiut<Instrumentalis+LI
Paamiunillu	Paamiut<Instrumentalis+LU
Paamiuninguna	Paamiut<Instrumentalis+UNA
Paamiuni	Paamiut<Lokalis
Paamiuniinniannginnerlu	Paamiut<Lokalis+IP+NIAR=NNGIT+NIQ+LU
Paamiuneeqqaarlutinguna	Paamiut<Lokalis+IP-QQAAR<Ledsagemåde<de_selv+UNA
Paamiuneeqquaannga	Paamiut<Lokalis+IP-QQU<Indikativ<DeMig
Paamiuneeqquiuk	Paamiut<Lokalis+IP-QQU<Interrogativ<du-dem
Paamiuneeriarama	Paamiut<Lokalis+IP-RIAR<Causativ<jeg
Paamiuneeriarlutilli	Paamiut<Lokalis+IP-RIAR<Ledsagemåde<de_selv+LI
Paamiuneeriarnerli	Paamiut<Lokalis+IP-RIAR+NIQ+LI
Paamiuneeriartulli	Paamiut<Lokalis+IP-RIAR<Participium<de+LI
Paamiuneeriartorli	Paamiut<Lokalis+IP-RIAR<Participium<han+LI
Paamiuneereerpit	Paamiut<Lokalis+IP-RIIR<Interrogativ<du
Paamiuniissimasunga	Paamiut<Lokalis+IP+SIMA<Participium<jeg
Paamiuniissagaluarama	Paamiut<Lokalis+IP-SSA=GALUAR<Causativ<jeg
Paamiunili	Paamiut<Lokalis+LI
Paamiunilu	Paamiut<Lokalis+LU
Paamiuniuna	Paamiut<Lokalis+UNA
Paamiormiumillu	Paamiut+MIU<ental<Instrumentalis+LU
Paamiormiumilu	Paamiut+MIU<ental<Lokalis+LU
Paamiormiumiuna	Paamiut+MIU<ental<Lokalis+UNA
Paamiormiunik	Paamiut+MIU<flertal<Instrumentalis
Paamiormiuninguna	Paamiut+MIU<flertal<Instrumentalis+UNA
Paamiormiuneeqqaarpununa	Paamiut+MIU<flertal<Lokalis+IP-QQAAR<Indikativ<de+UNA
Paamiormiuneeqqaartulli	Paamiut+MIU<flertal<Lokalis+IP-QQAAR<Participium<de+LI
Paamiormiulerivit	Paamiut+MIU-LIRI<Interrogativ<du
Paamiormiulerillutilli	Paamiut+MIU-LIRI<Ledsagemåde<de_selv+LI
Paamiormiulerineq	Paamiut+MIU-LIRI+NIQ
Paamiormiunnguinnarpungali	Paamiut+MIU-NNGUR-INNAR<Indikativ<jeg+LI
Paamiormiunngulerpit	Paamiut+MIU-NNGUR-LIR<Interrogativ<du
Paamiormiunngunnginneranuna	Paamiut+MIU-NNGUR-NNGIT+NIQ<ental<deres+UNA
Paamiormiunngorpallaannginnamali	Paamiut+MIU-NNGUR+VALLAAR=NNGIT<Causativ<jeg+LI
Paamiormioqarpoq	Paamiut+MIU-QAR<Indikativ<han
Paamiormioqarneq	Paamiut+MIU-QAR+NIQ
Paamiormioqartoq	Paamiut+MIU-QAR<Participium<han
Paamiormioqartorli	Paamiut+MIU-QAR<Participium<han+LI
Paamiormioqartoq	Paamiut+MIU-QAR+TUQ
Paamiormioqartorlu	Paamiut+MIU-QAR+TUQ+LU
Paamiormioqartoruna	Paamiut+MIU-QAR+TUQ+UNA
Paamiormiuulerpulli	Paamiut+MIU-U-LIR<Indikativ<de+LI
Paamiormiuulerpullu	Paamiut+MIU-U-LIR<Indikativ<de+LU
Paamiormiuulerpugulli	Paamiut+MIU-U-LIR<Indikativ<vi+LI
Paamiormiuunikuugama	Paamiut+MIU-U+NIKUU<Causativ<jeg
Paamiormiuuneri	Paamiut+MIU-U+NIQ<flertal<hans<Absolut
Paamiormiuunerlunilu	Paamiut+MIU-U+NIR<Ledsagemåde<han_selv+LU
Paamiormiooqqaarpulli	Paamiut+MIU-U-QQAAR<Indikativ<de+LI
Paamiormiooqqaarpungalu	Paamiut+MIU-U-QQAAR<Indikativ<jeg+LU
Paamiormiooqqaarpit	Paamiut+MIU-U-QQAAR<Interrogativ<du
Paamiormiooqqaarlutilli	Paamiut+MIU-U-QQAAR<Ledsagemåde<de_selv+LI
Paamiormiooqqaartoqalaartullilli	Paamiut+MIU-U-QQAAR+TUQ-QAR-LAAR+TUQ-LIK<flertal<Absolut+LI
Paamiormiooriaramali	Paamiut+MIU-U-RIAR<Causativ<jeg+LI
Paamiormiooriartut	Paamiut+MIU-U-RIAR<Participium<de
Paamiormiooriartulli	Paamiut+MIU-U-RIAR<Participium<de+LI
Paamiormiooreerpit	Paamiut+MIU-U-RIIR<Interrogativ<du
Paamiormiooreerlutik	Paamiut+MIU-U-RIIR<Ledsagemåde<de_selv
Paamiormiuusimasarama	Paamiut+MIU-U+SIMA=TAR<Causativ<jeg
Paamiormiuusarpit	Paamiut+MIU-U+TAR<Interrogativ<du
Paamiunut	Paamiut<Terminalis
Paamiunukaannarpungalu	Paamiut<Terminalis-KAR-INNAR<Indikativ<jeg+LU
Paamiunukaannarlutik	Paamiut<Terminalis-KAR-INNAR<Ledsagemåde<de_selv
Paamiunukalaartarpit	Paamiut<Terminalis-KAR-LAAR=TAR<Interrogativ<du
Paamiunukalerama	Paamiut<Terminalis-KAR-LIR<Causativ<jeg
Paamiunukalerpulli	Paamiut<Terminalis-KAR-LIR<Indikativ<de+LI
Paamiunukarnikuusorlu	Paamiut<Terminalis-KAR+NIKUU<Participium<han+LU
Paamiunukaqqummangali	Paamiut<Terminalis-KAR-QQU<Causativ<HanMig+LI
Paamiunukarsimasarpungali	Paamiut<Terminalis-KAR+SIMA=TAR<Indikativ<jeg+LI
Paamiunulli	Paamiut<Terminalis+LI
Paamiunullu	Paamiut<Terminalis+LU
Paamiunununa	Paamiut<Terminalis+UNA
paasigakku	paasi<Causativ<JegHam
paasigaluarakku	paasi+GALUAR<Causativ<JegHam
paasigaluarpiuk	paasi+GALUAR<Interrogativ<du-dem
paasivagununa	paasi<Indikativ<ViDem+UNA
paasiinnarpaanngali	paasi-INNAR<Indikativ<DeMig+LI
paasiinnarlugu	paasi-INNAR<Ledsagemåde<ham
paasilaarakkuli	paasi-LAAR<Causativ<JegHam+LI
paasillugu	paasi<Ledsagemåde<ham
paasiniarmangali	paasi+NIAR<Causativ<HanMig+LI
paasiniartiginuna	paasi+NIAR<Imperativ<ViDem+UNA
paasiniarnagu	paasi+NIAR=NNGIT<Ledsagemåde<ham
paasinikuuaanga	paasi+NIKUU<Indikativ<HanMig
paasinikuuakka	paasi+NIKUU<Indikativ<JegDem
paasineqartoqaqqutigilli	paasi+NIQAR+TUQ-QAR-QQU<Imperativ<ViDem+LI
paasinermangali	paasi+NIR<Causativ<HanMig+LI
paasinerlunga	paasi+NIR<Ledsagemåde<mig
paasinagit	paasi-NNGIT<Ledsagemåde<dem
paaseqqaarmanga	paasi-QQAAR<Causativ<HanMig
paaseqqaarmangali	paasi-QQAAR<Causativ<HanMig+LI
paaseqqaarakku	paasi-QQAAR<Causativ<JegHam
paaseqqaartiginuna	paasi-QQAAR<Imperativ<ViDem+UNA
paaseqqaarpai	paasi-QQAAR<Indikativ<HanDem
paaseqqaarpiuk	paasi-QQAAR<Interrogativ<du-dem
paaseqqutigilli	paasi-QQU<Imperativ<ViDem+LI
paaseqquaalli	paasi-QQU<Indikativ<DeHam+LI
paaseqquakka	paasi-QQU<Indikativ<JegDem
paaseqquiuk	paasi-QQU<Interrogativ<du-dem
paaseqqulluguli	paasi-QQU<Ledsagemåde<ham+LI
paaseriarmangali	paasi-RIAR<Causativ<HanMig+LI
paaseriarakku	paasi-RIAR<Causativ<JegHam
paaseriarakkuli	paasi-RIAR<Causativ<JegHam+LI
paaseriarlugu	paasi-RIAR<Ledsagemåde<ham
paaseriarluguli	paasi-RIAR<Ledsagemåde<ham+LI
paaseriarluguuna	paasi-RIAR<Ledsagemåde<ham+UNA
paaseriarlunga	paasi-RIAR<Ledsagemåde<mig
paasereermanga	paasi-RIIR<Causativ<HanMig
paasereerpaanuna	paasi-RIIR<Indikativ<DeHam+UNA
paasereerpassili	paasi-RIIR<Indikativ<JegJer+LI
paasereerpassilu	paasi-RIIR<Indikativ<JegJer+LU
paasereerluginuna	paasi-RIIR<Ledsagemåde<dem+UNA
paasereerlugu	paasi-RIIR<Ledsagemåde<ham
paasereerlugulu	paasi-RIIR<Ledsagemåde<ham+LU
paasisinnaalluginuna	paasi+SINNAA<Ledsagemåde<dem+UNA
paasissagaluarakku	paasi-SSA=GALUAR<Causativ<JegHam
paasissagaluarpiuk	paasi-SSA=GALUAR<Interrogativ<du-dem
paasissavaanngalu	paasi-SSA<Indikativ<DeMig+LU
paasissavaajuna	paasi-SSA<Indikativ<HanHam+UNA
paasisaraluarmangali	paasi+TAR=GALUAR<Causativ<HanMig+LI
paasisaraluarlugu	paasi+TAR=GALUAR<Ledsagemåde<ham
paasivallaarlugu	paasi+VALLAAR<Ledsagemåde<ham
paasivallaanngimmangalu	paasi+VALLAAR=NNGIT<Causativ<HanMig+LU
piariissagaluaramalu	piareer-SSA=GALUAR<Causativ<jeg+LU
pimmangaana	pi<Causativ<HanMig+UNA
pigaluartigit	pi+GALUAR<Imperativ<ViDem
piartorakkuli	pi+GIARTUR<Causativ<JegHam+LI
piartortigit	pi+GIARTUR<Imperativ<ViDem
piartorlugilli	pi+GIARTUR<Ledsagemåde<dem+LI
piartorlugu	pi+GIARTUR<Ledsagemåde<ham
pitigit	pi<Imperativ<ViDem
pitigilli	pi<Imperativ<ViDem+LI
pitiginuna	pi<Imperativ<ViDem+UNA
pivassili	pi<Indikativ<JegJer+LI
piinnarakkuli	pi-INNAR<Causativ<JegHam+LI
piinnarakkulu	pi-INNAR<Causativ<JegHam+LU
piinnartiginuna	pi-INNAR<Imperativ<ViDem+UNA
piinnarparalu	pi-INNAR<Indikativ<JegHam+LU
piinnarpassi	pi-INNAR<Indikativ<JegJer
piinnarpiuk	pi-INNAR<Interrogativ<du-dem
piviuk	pi<Interrogativ<du-dem
pilaartarpagununa	pi-LAAR=TAR<Indikativ<ViDem+UNA
pilaartarpiuk	pi-LAAR=TAR<Interrogativ<du-dem
pillugu	pi<Ledsagemåde<ham
pilertigilli	pi-LIR<Imperativ<ViDem+LI
pilerpiuk	pi-LIR<Interrogativ<du-dem
pingasuinnaleripput	pingasut-INNAQ-LIRI<Indikativ<de
pingasussanngoreertunnguunerlunili	pingasut-SSAQ-NNGUR-RIIR+TUQ-NNGUAQ-U+NIR<Ledsagemåde<han_selv+LI
pingasussaassaarli	pingasut-SSAQ-U-SSA<Indikativ<han+LI
piniartigillu	pi+NIAR<Imperativ<ViDem+LU
piniarpiuk	pi+NIAR<Interrogativ<du-dem
pinikuugakku	pi+NIKUU<Causativ<JegHam
pinermangaana	pi+NIR<Causativ<HanMig+UNA
pinerakku	pi+NIR<Causativ<JegHam
pinerakkuli	pi+NIR<Causativ<JegHam+LI
pinerlunga	pi+NIR<Ledsagemåde<mig
pineruarali	pi+NIRU<Indikativ<JegHam+LI
peqqaarmanga	pi-QQAAR<Causativ<HanMig
peqqaarakku	pi-QQAAR<Causativ<JegHam
peqqaarakkuli	pi-QQAAR<Causativ<JegHam+LI
peqqaartigilli	pi-QQAAR<Imperativ<ViDem+LI
peqqaartigillu	pi-QQAAR<Imperativ<ViDem+LU
peqqaartiginuna	pi-QQAAR<Imperativ<ViDem+UNA
peqqaarpaanga	pi-QQAAR<Indikativ<HanMig
peqqaarpara	pi-QQAAR<Indikativ<JegHam
peqqaarpiuk	pi-QQAAR<Interrogativ<du-dem
peqqaarlugilli	pi-QQAAR<Ledsagemåde<dem+LI
peqqugakkulu	pi-QQU<Causativ<JegHam+LU
peqqutigit	pi-QQU<Imperativ<ViDem
peqqutigilli	pi-QQU<Imperativ<ViDem+LI
peqquaat	pi-QQU<Indikativ<DeHam
peqquaali	pi-QQU<Indikativ<HanDem+LI
peqquaanga	pi-QQU<Indikativ<HanMig
peqquassi	pi-QQU<Indikativ<JegJer
peqquagununa	pi-QQU<Indikativ<ViDem+UNA
peqquiuk	pi-QQU<Interrogativ<du-dem
peqqulluginuna	pi-QQU<Ledsagemåde<dem+UNA
peqqullugu	pi-QQU<Ledsagemåde<ham
peqqullugulu	pi-QQU<Ledsagemåde<ham+LU
periarmanga	pi-RIAR<Causativ<HanMig
periarakku	pi-RIAR<Causativ<JegHam
periarlugilli	pi-RIAR<Ledsagemåde<dem+LI
periarlugu	pi-RIAR<Ledsagemåde<ham
periarluguli	pi-RIAR<Ledsagemåde<ham+LI
periarluguuna	pi-RIAR<Ledsagemåde<ham+UNA
periarlunga	pi-RIAR<Ledsagemåde<mig
periarlungaana	pi-RIAR<Ledsagemåde<mig+UNA
pereermanga	pi-RIIR<Causativ<HanMig
pereermangali	pi-RIIR<Causativ<HanMig+LI
pereerakku	pi-RIIR<Causativ<JegHam
pereertigit	pi-RIIR<Imperativ<ViDem
pereertigilli	pi-RIIR<Imperativ<ViDem+LI
pereertigillu	pi-RIIR<Imperativ<ViDem+LU
pereertiginuna	pi-RIIR<Imperativ<ViDem+UNA
pereerpakka	pi-RIIR<Indikativ<JegDem
pereerpara	pi-RIIR<Indikativ<JegHam
pereerpassi	pi-RIIR<Indikativ<JegJer
pereerpagut	pi-RIIR<Indikativ<ViDem
pereerpiuk	pi-RIIR<Interrogativ<du-dem
pereerlugit	pi-RIIR<Ledsagemåde<dem
pereerlugilli	pi-RIIR<Ledsagemåde<dem+LI
pereerlugu	pi-RIIR<Ledsagemåde<ham
pisimatigillu	pi+SIMA<Imperativ<ViDem+LU
pisimasarakkuli	pi+SIMA=TAR<Causativ<JegHam+LI
pisimasarlugillu	pi+SIMA=TAR<Ledsagemåde<dem+LU
pisinnaammanga	pi+SINNAA<Causativ<HanMig
pisinnaaviuk	pi+SINNAA<Interrogativ<du-dem
pisinnaallugu	pi+SINNAA<Ledsagemåde<ham
pissammangalu	pi-SSA<Causativ<HanMig+LU
pissagakkuli	pi-SSA<Causativ<JegHam+LI
pissatigilli	pi-SSA<Imperativ<ViDem+LI
pisaraluarmanga	pi+TAR=GALUAR<Causativ<HanMig
pisaraluartigilli	pi+TAR=GALUAR<Imperativ<ViDem+LI
pisaraluarpiuk	pi+TAR=GALUAR<Interrogativ<du-dem
pisaraluarlugit	pi+TAR=GALUAR<Ledsagemåde<dem
pisartigit	pi+TAR<Imperativ<ViDem
pisartigillu	pi+TAR<Imperativ<ViDem+LU
pisarpassi	pi+TAR<Indikativ<JegJer
pisarpassili	pi+TAR<Indikativ<JegJer+LI
pisarpiuk	pi+TAR<Interrogativ<du-dem
Pituffik	Pituffik<Absolut
Pituffilli	Pituffik<Absolut+LI
Pituffillu	Pituffik<Absolut+LU
Pituffinguna	Pituffik<Absolut+UNA
Pituffimmik	Pituffik<Instrumentalis
Pituffimmilli	Pituffik<Instrumentalis+LI
Pituffimmillu	Pituffik<Instrumentalis+LU
Pituffimminguna	Pituffik<Instrumentalis+UNA
Pituffimmi	Pituffik<Lokalis
Pituffimmeeqqaarama	Pituffik<Lokalis+IP-QQAAR<Causativ<jeg
Pituffimmeeqqaarlutinguna	Pituffik<Lokalis+IP-QQAAR<Ledsagemåde<de_selv+UNA
Pituffimmeeqqaarnerlu	Pituffik<Lokalis+IP-QQAAR+NIQ+LU
Pituffimmeeqqutigit	Pituffik<Lokalis+IP-QQU<Imperativ<ViDem
Pituffimmeeriaramali	Pituffik<Lokalis+IP-RIAR<Causativ<jeg+LI
Pituffimmeeriarpit	Pituffik<Lokalis+IP-RIAR<Interrogativ<du
Pituffimmeeriarlutik	Pituffik<Lokalis+IP-RIAR<Ledsagemåde<de_selv
Pituffimmeereerpungali	Pituffik<Lokalis+IP-RIIR<Indikativ<jeg+LI
Pituffimmeereertullu	Pituffik<Lokalis+IP-RIIR<Participium<de+LU
Pituffimmilu	Pituffik<Lokalis+LU
Pituffimmiumik	Pituffik+MIU<ental<Instrumentalis
Pituffimmiumilli	Pituffik+MIU<ental<Instrumentalis+LI
Pituffimmiumiissallutillu	Pituffik+MIU<ental<Lokalis+IP-SSA<Ledsagemåde<de_selv+LU
Pituffimmiulerigama	Pituffik+MIU-LIRI<Causativ<jeg
Pituffimmiulerinerli	Pituffik+MIU-LIRI+NIQ+LI
Pituffimmiunngunngitsullinuna	Pituffik+MIU-NNGUR-NNGIT+TUQ-LIK<flertal<Relativ+UNA
Pituffimmiunngoqqaaramalu	Pituffik+MIU-NNGUR-QQAAR<Causativ<jeg+LU
Pituffimmiunngoqqugakku	Pituffik+MIU-NNGUR-QQU<Causativ<JegHam
Pituffimmiunngoriarama	Pituffik+MIU-NNGUR-RIAR<Causativ<jeg
Pituffimmiunngoreerpugulli	Pituffik+MIU-NNGUR-RIIR<Indikativ<vi+LI
Pituffimmioqarneq	Pituffik+MIU-QAR+NIQ
Pituffimmioqartorlu	Pituffik+MIU-QAR<Participium<han+LU
Pituffimmiuugama	Pituffik+MIU-U<Causativ<jeg
Pituffimmiuunertoq	Pituffik+MIU-U+NIR<Participium<han
Pituffimmiooqqugakku	Pituffik+MIU-U-QQU<Causativ<JegHam
Pituffimmiuusoqaannarpugulli	Pituffik+MIU-U+TUQ-QAR-INNAR<Indikativ<vi+LI
Pituffimmiuuallaarpit	Pituffik+MIU-U+VALLAAR<Interrogativ<du
Pituffimmut	Pituffik<Terminalis
Pituffimmukaannarpugulli	Pituffik<Terminalis-KAR-INNAR<Indikativ<vi+LI
Pituffimmukaannartoqarporlu	Pituffik<Terminalis-KAR-INNAR+TUQ-QAR<Indikativ<han+LU
Pituffimmukalaaramali	Pituffik<Terminalis-KAR-LAAR<Causativ<jeg+LI
Pituffimmukalaartarpit	Pituffik<Terminalis-KAR-LAAR=TAR<Interrogativ<du
Pituffimmukalerama	Pituffik<Terminalis-KAR-LIR<Causativ<jeg
Pituffimmukalerput	Pituffik<Terminalis-KAR-LIR<Indikativ<de
Pituffimmukalerpugut	Pituffik<Terminalis-KAR-LIR<Indikativ<vi
Pituffimmukaqqullugilli	Pituffik<Terminalis-KAR-QQU<Ledsagemåde<dem+LI
Pituffimmukassagaluartoqarpoq	Pituffik<Terminalis-KAR-SSA=GALUAR+TUQ-QAR<Indikativ<han
Pituffimmukassappulli	Pituffik<Terminalis-KAR-SSA<Indikativ<de+LI
Pituffimmulli	Pituffik<Terminalis+LI
Pituffimmullu	Pituffik<Terminalis+LU
Pituffimmununa	Pituffik<Terminalis+UNA
pivallaarakku	pi+VALLAAR<Causativ<JegHam
pivallaartigit	pi+VALLAAR<Imperativ<ViDem
pivallaanngilaajuna	pi+VALLAAR=NNGIT<Indikativ<HanDem+UNA
qaammalli	qaammat<ental<Absolut+LI
qaammanuna	qaammat<ental<Absolut+UNA
qaammamminguna	qaammat<ental<Instrumentalis+UNA
qaammammi	qaammat<ental<Lokalis
qaammammeeqqutigit	qaammat<ental<Lokalis+IP-QQU<Imperativ<ViDem
qaammammeeriartoqarporli	qaammat<ental<Lokalis+IP-RIAR+TUQ-QAR<Indikativ<han+LI
qaammammiissimasarpit	qaammat<ental<Lokalis+IP+SIMA=TAR<Interrogativ<du
qaammammut	qaammat<ental<Terminalis
qaammammullu	qaammat<ental<Terminalis+LU
qaammatimiumukaqqaarama	qaammat+MIU<ental<Terminalis-KAR-QQAAR<Causativ<jeg
qaammatinngoqqaartuninguna	qaammat-NNGUR-QQAAR+TUQ<flertal<Instrumentalis+UNA
qaammatinngoriarama	qaammat-NNGUR-RIAR<Causativ<jeg
qaammateqalaartut	qaammat-QAR-LAAR<Participium<de
qaammataasinnaallutillu	qaammat-U+SINNAA<Ledsagemåde<de_selv+LU
qallunaaq	qallunaaq<ental<Absolut
qallunaarli	qallunaaq<ental<Absolut+LI
qallunaaninguna	qallunaaq<flertal<Instrumentalis+UNA
qallunaariinngoriartooqqullugu	qallunaaq+GIIT-NNGUR-RIAR+TUQ-U-QQU<Ledsagemåde<ham
qallunaaralugu	qallunaaq+GӘ<Ledsagemåde<ham
qallunaarinikuutigilli	qallunaaq+GӘ+NIKUU<Imperativ<ViDem+LI
qallunaarineqartunga	qallunaaq+GӘ+NIQAR<Participium<jeg
qallunaarisimallugu	qallunaaq+GӘ+SIMA<Ledsagemåde<ham
qallunaannaqassagaluarama	qallunaaq-INNAQ-QAR-SSA=GALUAR<Causativ<jeg
qallunaanngooriarluni	qallunaaq-NNGUAQ-U-RIAR<Ledsagemåde<han_selv
qallunaarpassuarniissagaluarpunga	qallunaaq+PASSUAQ<flertal<Lokalis+IP-SSA=GALUAR<Indikativ<jeg
qallunaarpassuakkaana	qallunaaq+PASSUAQ<flertal<min<Absolut+UNA
qallunaaqaqqugakku	qallunaaq-QAR-QQU<Causativ<JegHam
qallunaajuvugulli	qallunaaq-U<Indikativ<vi+LI
qallunaajunatik	qallunaaq-U-NNGIT<Ledsagemåde<de_selv
qallunaareerpugulli	qallunaaq-U-RIIR<Indikativ<vi+LI
qangali	qangali<Partikel
qangalili	qangali<Partikel+LI
qangalilu	qangali<Partikel+LU
qanga	qanga<Partikel
qangali	qanga<Partikel+LI
qangalu	qanga<Partikel+LU
qangaana	qanga<Partikel+UNA
Qaqortoq	Qaqortoq<Absolut
Qaqortorli	Qaqortoq<Absolut+LI
Qaqortorlu	Qaqortoq<Absolut+LU
Qaqortoruna	Qaqortoq<Absolut+UNA
Qaqortumik	Qaqortoq<Instrumentalis
Qaqortuminguna	Qaqortoq<Instrumentalis+UNA
Qaqortumi	Qaqortoq<Lokalis
Qaqortumiinnginnama	Qaqortoq<Lokalis+IP-NNGIT<Causativ<jeg
Qaqortumeeqqaarpugununa	Qaqortoq<Lokalis+IP-QQAAR<Indikativ<vi+UNA
Qaqortumeeqqaarlutik	Qaqortoq<Lokalis+IP-QQAAR<Ledsagemåde<de_selv
Qaqortumeeqqummanga	Qaqortoq<Lokalis+IP-QQU<Causativ<HanMig
Qaqortumeeriartoq	Qaqortoq<Lokalis+IP-RIAR<Participium<han
Qaqortumeeriartoqarpoq	Qaqortoq<Lokalis+IP-RIAR+TUQ-QAR<Indikativ<han
Qaqortumeeriartoruna	Qaqortoq<Lokalis+IP-RIAR+TUQ+UNA
Qaqortumilu	Qaqortoq<Lokalis+LU
Qaqortumiuna	Qaqortoq<Lokalis+UNA
Qaqortormiunik	Qaqortoq+MIU<flertal<Instrumentalis
Qaqortormiuninguna	Qaqortoq+MIU<flertal<Instrumentalis+UNA
Qaqortormiuneeqquaanga	Qaqortoq+MIU<flertal<Lokalis+IP-QQU<Indikativ<HanMig
Qaqortormiuneeriartoruna	Qaqortoq+MIU<flertal<Lokalis+IP-RIAR<Participium<han+UNA
Qaqortormiulerivit	Qaqortoq+MIU-LIRI<Interrogativ<du
Qaqortormioqarporlu	Qaqortoq+MIU-QAR<Indikativ<han+LU
Qaqortormioqarneq	Qaqortoq+MIU-QAR+NIQ
Qaqortormioqartorli	Qaqortoq+MIU-QAR<Participium<han+LI
Qaqortormioqartoq	Qaqortoq+MIU-QAR+TUQ
Qaqortormiuugaluarpit	Qaqortoq+MIU-U+GALUAR<Interrogativ<du
Qaqortormiuulerlutik	Qaqortoq+MIU-U-LIR<Ledsagemåde<de_selv
Qaqortumut	Qaqortoq<Terminalis
Qaqortumukalaarpunga	Qaqortoq<Terminalis-KAR-LAAR<Indikativ<jeg
Qaqortumukalerpit	Qaqortoq<Terminalis-KAR-LIR<Interrogativ<du
Qaqortumukalernerli	Qaqortoq<Terminalis-KAR-LIR+NIQ+LI
Qaqortumukalertoqarporlu	Qaqortoq<Terminalis-KAR-LIR+TUQ-QAR<Indikativ<han+LU
Qaqortumukanngilanga	Qaqortoq<Terminalis-KAR-NNGIT<Indikativ<jeg
Qaqortumukaqqaarpit	Qaqortoq<Terminalis-KAR-QQAAR<Interrogativ<du
Qaqortumukaqquaajuna	Qaqortoq<Terminalis-KAR-QQU<Indikativ<HanDem+UNA
Qaqortumukaqquaa	Qaqortoq<Terminalis-KAR-QQU<Indikativ<HanHam
Qaqortumukareerpit	Qaqortoq<Terminalis-KAR-RIIR<Interrogativ<du
Qaqortumukareerlutilli	Qaqortoq<Terminalis-KAR-RIIR<Ledsagemåde<de_selv+LI
Qaqortumukareertoqarpoq	Qaqortoq<Terminalis-KAR-RIIR+TUQ-QAR<Indikativ<han
Qaqortumukarpallaanngilatit	Qaqortoq<Terminalis-KAR+VALLAAR=NNGIT<Interrogativ<du
Qaqortumulli	Qaqortoq<Terminalis+LI
Qaqortumullu	Qaqortoq<Terminalis+LU
Qaqortumununa	Qaqortoq<Terminalis+UNA
qarasaasiaq	qarasaasiaq<ental<Absolut
qarasaasiariittut	qarasaasiaq+GIIT<flertal<Aequalis
qarasaasiariinnilli	qarasaasiaq+GIIT<flertal<Instrumentalis+LI
qarasaasiariinneeqquiuk	qarasaasiaq+GIIT<flertal<Lokalis+IP-QQU<Interrogativ<du-dem
qarasaasiaralugu	qarasaasiaq+GӘ<Ledsagemåde<ham
qarasaasiarinikuuaannga	qarasaasiaq+GӘ+NIKUU<Indikativ<DeMig
qarasaasiarissagakku	qarasaasiaq+GӘ-SSA<Causativ<JegHam
qarasaasiaannaalli	qarasaasiaq-INNAQ<flertal<Relativ+LI
qarasaasiaannalerisulli	qarasaasiaq-INNAQ-LIRI<Participium<de+LI
qarasaasialikka	qarasaasiaq-LIK<flertal<min<Absolut
qarasaasianngunngilatit	qarasaasiaq-NNGUR-NNGIT<Interrogativ<du
qarasaasianngoreerama	qarasaasiaq-NNGUR-RIIR<Causativ<jeg
qarasaasiarpassuit	qarasaasiaq+PASSUAQ<flertal<Absolut
qarasaasiarpassui	qarasaasiaq+PASSUAQ<flertal<hans<Absolut
qarasaasiarpassuarneeqquaanuna	qarasaasiaq+PASSUAQ<flertal<Lokalis+IP-QQU<Indikativ<DeHam+UNA
qarasaasiaqaannartooreeramali	qarasaasiaq-QAR-INNAR+TUQ-U-RIIR<Causativ<jeg+LI
qarasaasiaqaqqaarnerat	qarasaasiaq-QAR-QQAAR+NIQ<ental<deres
qarasaasiaavit	qarasaasiaq-U<Interrogativ<du
qarasaasiaavallaarpugullu	qarasaasiaq-U+VALLAAR<Indikativ<vi+LU
Qasigiannguit	Qasigiannguit<Absolut
Qasigiannguilli	Qasigiannguit<Absolut+LI
Qasigiannguillu	Qasigiannguit<Absolut+LU
Qasigiannguinuna	Qasigiannguit<Absolut+UNA
Qasigiannguanillu	Qasigiannguit<Instrumentalis+LU
Qasigiannguaninguna	Qasigiannguit<Instrumentalis+UNA
Qasigiannguani	Qasigiannguit<Lokalis
Qasigiannguaneeqquassi	Qasigiannguit<Lokalis+IP-QQU<Indikativ<JegJer
Qasigiannguaneereerpulli	Qasigiannguit<Lokalis+IP-RIIR<Indikativ<de+LI
Qasigiannguanilu	Qasigiannguit<Lokalis+LU
Qasigiannguaniuna	Qasigiannguit<Lokalis+UNA
Qasigiannguarmiumiilaarlutik	Qasigiannguit+MIU<ental<Lokalis+IP-LAAR<Ledsagemåde<de_selv
Qasigiannguarmiumeeriartoqarpoq	Qasigiannguit+MIU<ental<Lokalis+IP-RIAR+TUQ-QAR<Indikativ<han
Qasigiannguarmiuni	Qasigiannguit+MIU<flertal<Lokalis
Qasigiannguarmiuneeqqugakku	Qasigiannguit+MIU<flertal<Lokalis+IP-QQU<Causativ<JegHam
Qasigiannguarmiunngoqqaartunnguullutik	Qasigiannguit+MIU-NNGUR-QQAAR+TUQ-NNGUAQ-U<Ledsagemåde<de_selv
Qasigiannguarmiunngoriartoq	Qasigiannguit+MIU-NNGUR-RIAR<Participium<han
Qasigiannguarmioqarpoq	Qasigiannguit+MIU-QAR<Indikativ<han
Qasigiannguarmioqarporli	Qasigiannguit+MIU-QAR<Indikativ<han+LI
Qasigiannguarmioqarnerlu	Qasigiannguit+MIU-QAR+NIQ+LU
Qasigiannguarmioqartoq	Qasigiannguit+MIU-QAR+TUQ
Qasigiannguarmiuunikuusunga	Qasigiannguit+MIU-U+NIKUU<Participium<jeg
Qasigiannguarmiuusorlu	Qasigiannguit+MIU-U<Participium<han+LU
Qasigiannguarmiooqqummangali	Qasigiannguit+MIU-U-QQU<Causativ<HanMig+LI
Qasigiannguarmiooqqutiginuna	Qasigiannguit+MIU-U-QQU<Imperativ<ViDem+UNA
Qasigiannguarmiooqqullugit	Qasigiannguit+MIU-U-QQU<Ledsagemåde<dem
Qasigiannguarmiuusinnaavit	Qasigiannguit+MIU-U+SINNAA<Interrogativ<du
Qasigiannguarmiuusaraluartunga	Qasigiannguit+MIU-U+TAR=GALUAR<Participium<jeg
Qasigiannguanut	Qasigiannguit<Terminalis
Qasigiannguanukaannarlutik	Qasigiannguit<Terminalis-KAR-INNAR<Ledsagemåde<de_selv
Qasigiannguanukalaartarlutilli	Qasigiannguit<Terminalis-KAR-LAAR=TAR<Ledsagemåde<de_selv+LI
Qasigiannguanukariarporuna	Qasigiannguit<Terminalis-KAR-RIAR<Indikativ<han+UNA
qatanngulli	qatanngut<ental<Absolut+LI
qatanngullu	qatanngut<ental<Absolut+LU
qatanngununa	qatanngut<ental<Absolut+UNA
qatanngummik	qatanngut<ental<Instrumentalis
qatanngummilli	qatanngut<ental<Instrumentalis+LI
qatanngumminguna	qatanngut<ental<Instrumentalis+UNA
qatanngummi	qatanngut<ental<Lokalis
qatanngummiipput	qatanngut<ental<Lokalis+IP<Indikativ<de
qatanngummukalaarpugut	qatanngut<ental<Terminalis-KAR-LAAR<Indikativ<vi
qatanngummukalerpunga	qatanngut<ental<Terminalis-KAR-LIR<Indikativ<jeg
qatanngummununa	qatanngut<ental<Terminalis+UNA
qatanngutigilerakkuli	qatanngut+GӘ-LIR<Causativ<JegHam+LI
qatanngutaannaq	qatanngut-INNAQ<ental<Absolut
qatanngutilinngoreertuneereernerlu	qatanngut-LIK-NNGUR-RIIR+TUQ<flertal<Lokalis+IP-RIIR+NIQ+LU
qatanngutimioqartoq	qatanngut+MIU-QAR+TUQ
qatanngutinnguakka	qatanngut-NNGUAQ<flertal<min<Absolut
qatanngutaasinnaasoruna	qatanngut-U+SINNAA+TUQ<ental<Absolut+UNA
Qeqertarsuaq	Qeqertarsuaq<Absolut
Qeqertarsuarli	Qeqertarsuaq<Absolut+LI
Qeqertarsuarlu	Qeqertarsuaq<Absolut+LU
Qeqertarsuaruna	Qeqertarsuaq<Absolut+UNA
Qeqertarsuarmik	Qeqertarsuaq<Instrumentalis
Qeqertarsuarmilli	Qeqertarsuaq<Instrumentalis+LI
Qeqertarsuarmillu	Qeqertarsuaq<Instrumentalis+LU
Qeqertarsuarminguna	Qeqertarsuaq<Instrumentalis+UNA
Qeqertarsuarmi	Qeqertarsuaq<Lokalis
Qeqertarsuarmiilaartarama	Qeqertarsuaq<Lokalis+IP-LAAR=TAR<Causativ<jeg
Qeqertarsuarmeeqqaarama	Qeqertarsuaq<Lokalis+IP-QQAAR<Causativ<jeg
Qeqertarsuarmeeqquiuk	Qeqertarsuaq<Lokalis+IP-QQU<Interrogativ<du-dem
Qeqertarsuarmeeriarlutik	Qeqertarsuaq<Lokalis+IP-RIAR<Ledsagemåde<de_selv
Qeqertarsuarmeereerpoq	Qeqertarsuaq<Lokalis+IP-RIIR<Indikativ<han
Qeqertarsuarmeereerpit	Qeqertarsuaq<Lokalis+IP-RIIR<Interrogativ<du
Qeqertarsuarmeereerneruna	Qeqertarsuaq<Lokalis+IP-RIIR+NIQ+UNA
Qeqertarsuarmeereertulli	Qeqertarsuaq<Lokalis+IP-RIIR<Participium<de+LI
Qeqertarsuarmiissagaluarpit	Qeqertarsuaq<Lokalis+IP-SSA=GALUAR<Interrogativ<du
Qeqertarsuarmili	Qeqertarsuaq<Lokalis+LI
Qeqertarsuarmilu	Qeqertarsuaq<Lokalis+LU
Qeqertarsuarmiuna	Qeqertarsuaq<Lokalis+UNA
Qeqertarsuarmiumeeqqaarpunga	Qeqertarsuaq+MIU<ental<Lokalis+IP-QQAAR<Indikativ<jeg
Qeqertarsuarmiunilli	Qeqertarsuaq+MIU<flertal<Instrumentalis+LI
Qeqertarsuarmiuneeqqaarpoq	Qeqertarsuaq+MIU<flertal<Lokalis+IP-QQAAR<Indikativ<han
Qeqertarsuarmiuneeriartoq	Qeqertarsuaq+MIU<flertal<Lokalis+IP-RIAR+TUQ
Qeqertarsuarmiulerippullu	Qeqertarsuaq+MIU-LIRI<Indikativ<de+LU
Qeqertarsuarmioqarpoq	Qeqertarsuaq+MIU-QAR<Indikativ<han
Qeqertarsuarmioqarporuna	Qeqertarsuaq+MIU-QAR<Indikativ<han+UNA
Qeqertarsuarmioqartoq	Qeqertarsuaq+MIU-QAR<Participium<han
Qeqertarsuarmiuuniartulerisoqanngilaruna	Qeqertarsuaq+MIU-U+NIAR+TUQ-LIRI+TUQ-QAR-NNGIT<Indikativ<han+UNA
Qeqertarsuarmiuunerluni	Qeqertarsuaq+MIU-U+NIR<Ledsagemåde<han_selv
Qeqertarsuarmiuunerullutik	Qeqertarsuaq+MIU-U+NIRU<Ledsagemåde<de_selv
Qeqertarsuarmiuunerusoq	Qeqertarsuaq+MIU-U+NIRU<Participium<han
Qeqertarsuarmiooqqaarpit	Qeqertarsuaq+MIU-U-QQAAR<Interrogativ<du
Qeqertarsuarmiooriarama	Qeqertarsuaq+MIU-U-RIAR<Causativ<jeg
Qeqertarsuarmiooriaramalu	Qeqertarsuaq+MIU-U-RIAR<Causativ<jeg+LU
Qeqertarsuarmiooriartunga	Qeqertarsuaq+MIU-U-RIAR<Participium<jeg
Qeqertarsuarmut	Qeqertarsuaq<Terminalis
Qeqertarsuarmukariartornerli	Qeqertarsuaq<Terminalis-KAR+GIARTUR+NIQ+LI
Qeqertarsuarmukalaartarpit	Qeqertarsuaq<Terminalis-KAR-LAAR=TAR<Interrogativ<du
Qeqertarsuarmukalerpungali	Qeqertarsuaq<Terminalis-KAR-LIR<Indikativ<jeg+LI
Qeqertarsuarmukanngilatit	Qeqertarsuaq<Terminalis-KAR-NNGIT<Interrogativ<du
Qeqertarsuarmukaqqaarneq	Qeqertarsuaq<Terminalis-KAR-QQAAR+NIQ
Qeqertarsuarmukariarnerli	Qeqertarsuaq<Terminalis-KAR-RIAR+NIQ+LI
Qeqertarsuarmukassagaluarama	Qeqertarsuaq<Terminalis-KAR-SSA=GALUAR<Causativ<jeg
Qeqertarsuarmulli	Qeqertarsuaq<Terminalis+LI
Qeqertarsuarmununa	Qeqertarsuaq<Terminalis+UNA
qinnulli	qinnut<ental<Absolut+LI
qinnullu	qinnut<ental<Absolut+LU
qinnununa	qinnut<ental<Absolut+UNA
qinnutitullu	qinnut<ental<Aequalis+LU
qinnummik	qinnut<ental<Instrumentalis
qinnummilli	qinnut<ental<Instrumentalis+LI
qinnummillu	qinnut<ental<Instrumentalis+LU
qinnummi	qinnut<ental<Lokalis
qinnummiilaartoqarporli	qinnut<ental<Lokalis+IP-LAAR+TUQ-QAR<Indikativ<han+LI
qinnummeeqqaarpugut	qinnut<ental<Lokalis+IP-QQAAR<Indikativ<vi
qinnummeeqqaarpit	qinnut<ental<Lokalis+IP-QQAAR<Interrogativ<du
qinnummeeqqaarlutik	qinnut<ental<Lokalis+IP-QQAAR<Ledsagemåde<de_selv
qinnummeeqqaarneq	qinnut<ental<Lokalis+IP-QQAAR+NIQ
qinnummeeqqaarnerli	qinnut<ental<Lokalis+IP-QQAAR+NIQ+LI
qinnummeeqquaannga	qinnut<ental<Lokalis+IP-QQU<Indikativ<DeMig
qinnummeeqquiuk	qinnut<ental<Lokalis+IP-QQU<Interrogativ<du-dem
qinnummeeriaramalu	qinnut<ental<Lokalis+IP-RIAR<Causativ<jeg+LU
qinnummeereerama	qinnut<ental<Lokalis+IP-RIIR<Causativ<jeg
qinnummeereerlutik	qinnut<ental<Lokalis+IP-RIIR<Ledsagemåde<de_selv
qinnummeereertoqanngilaq	qinnut<ental<Lokalis+IP-RIIR+TUQ-QAR-NNGIT<Indikativ<han
qinnummilu	qinnut<ental<Lokalis+LU
qinnummiuna	qinnut<ental<Lokalis+UNA
qinnutimalu	qinnut<ental<min>Relativ+LU
qinnummukaqqaarama	qinnut<ental<Terminalis-KAR-QQAAR<Causativ<jeg
qinnummukaqqaaramali	qinnut<ental<Terminalis-KAR-QQAAR<Causativ<jeg+LI
qinnummukareerpoq	qinnut<ental<Terminalis-KAR-RIIR<Indikativ<han
qinnummukareerpunga	qinnut<ental<Terminalis-KAR-RIIR<Indikativ<jeg
qinnummukarsinnaavugulli	qinnut<ental<Terminalis-KAR+SINNAA<Indikativ<vi+LI
qinnummulli	qinnut<ental<Terminalis+LI
qinnummullu	qinnut<ental<Terminalis+LU
qinnummununa	qinnut<ental<Terminalis+UNA
qinnutai	qinnut<flertal<hans<Absolut
qinnutinili	qinnut<flertal<Lokalis+LI
qinnutikka	qinnut<flertal<min<Absolut
qinnutigiittulli	qinnut+GIIT<flertal<Aequalis+LI
qinnutigiinneereerama	qinnut+GIIT<flertal<Lokalis+IP-RIIR<Causativ<jeg
qinnutigalugu	qinnut+GӘ<Ledsagemåde<ham
qinnutiginikuutigillu	qinnut+GӘ+NIKUU<Imperativ<ViDem+LU
qinnutigeriarakkulu	qinnut+GӘ-RIAR<Causativ<JegHam+LU
qinnutigivallaarlugu	qinnut+GӘ+VALLAAR<Ledsagemåde<ham
qinnutaannaqalertuinnalerillutinguna	qinnut-INNAQ-QAR-LIR+TUQ-INNAQ-LIRI<Ledsagemåde<de_selv+UNA
qinnutilia	qinnut-LIK<ental<hans<Absolut
qinnutilikka	qinnut-LIK<flertal<min<Absolut
qinnutillit	qinnut-LIK<flertal<Relativ
qinnutillillu	qinnut-LIK<flertal<Relativ+LU
qinnutillinuna	qinnut-LIK<flertal<Relativ+UNA
qinnutililerigama	qinnut-LIK-LIRI<Causativ<jeg
qinnutimiumik	qinnut+MIU<ental<Instrumentalis
qinnutinnguanngulaartarama	qinnut-NNGUAQ-NNGUR-LAAR=TAR<Causativ<jeg
qinnutinngooqqaarpit	qinnut-NNGUAQ-U-QQAAR<Interrogativ<du
qinnutinngooqqaarnikka	qinnut-NNGUAQ-U-QQAAR+NIQ<flertal<min<Absolut
qinnutinngooreerpit	qinnut-NNGUAQ-U-RIIR<Interrogativ<du
qinnutinngoriarlutillu	qinnut-NNGUR-RIAR<Ledsagemåde<de_selv+LU
qinnuteqalaartarniniuna	qinnut-QAR-LAAR=TAR+NIQ<ental<sin<Absolut+UNA
qinnuteqalerpit	qinnut-QAR-LIR<Interrogativ<du
qinnutissaninguna	qinnut-SSAQ<flertal<Instrumentalis+UNA
qinnutaagaluarnerit	qinnut-U+GALUAR+NIQ<flertal<Relativ
qinnutaasimasarama	qinnut-U+SIMA=TAR<Causativ<jeg
sammisarimmanga	sammisarә<Causativ<HanMig
sammisarigakku	sammisarә<Causativ<JegHam
sammisarigaluarmanga	sammisarә+GALUAR<Causativ<HanMig
sammisarigaluarlugu	sammisarә+GALUAR<Ledsagemåde<ham
sammisarartorpiuk	sammisarә+GIARTUR<Interrogativ<du-dem
sammisaritigillu	sammisarә<Imperativ<ViDem+LU
sammisaritiginuna	sammisarә<Imperativ<ViDem+UNA
sammisarivai	sammisarә<Indikativ<HanDem
sammisarivaanga	sammisarә<Indikativ<HanMig
sammisarivakka	sammisarә<Indikativ<JegDem
sammisarilaarpaangali	sammisarә-LAAR<Indikativ<HanMig+LI
sammisarilaartarpagut	sammisarә-LAAR=TAR<Indikativ<ViDem
sammisaralugu	sammisarә<Ledsagemåde<ham
sammisaraluguli	sammisarә<Ledsagemåde<ham+LI
sammisarinianngimmanga	sammisarә+NIAR=NNGIT<Causativ<HanMig
sammisarinikuullugu	sammisarә+NIKUU<Ledsagemåde<ham
sammisarineqaramalu	sammisarә+NIQAR<Causativ<jeg+LU
sammisarinermanga	sammisarә+NIR<Causativ<HanMig
sammisarinngilaat	sammisarә-NNGIT<Indikativ<DeHam
sammisareqqaarluginuna	sammisarә-QQAAR<Ledsagemåde<dem+UNA
sammisareqqugakku	sammisarә-QQU<Causativ<JegHam
sammisareriarakku	sammisarә-RIAR<Causativ<JegHam
sammisarereertigillu	sammisarә-RIIR<Imperativ<ViDem+LU
sammisarisimasarlugu	sammisarә+SIMA=TAR<Ledsagemåde<ham
sammisarisinnaaviuk	sammisarә+SINNAA<Interrogativ<du-dem
sammisarissatiginuna	sammisarә-SSA<Imperativ<ViDem+UNA
sammisarissavakka	sammisarә-SSA<Indikativ<JegDem
sammisarisaraluartiginuna	sammisarә+TAR=GALUAR<Imperativ<ViDem+UNA
sammisarisartigillu	sammisarә+TAR<Imperativ<ViDem+LU
sammisarisarpassi	sammisarә+TAR<Indikativ<JegJer
sammisarivallaartigilli	sammisarә+VALLAAR<Imperativ<ViDem+LI
sammisarivallaartiginuna	sammisarә+VALLAAR<Imperativ<ViDem+UNA
sammisarivallaannginnakku	sammisarә+VALLAAR=NNGIT<Causativ<JegHam
sammisarivallaanngiliuk	sammisarә+VALLAAR=NNGIT<Interrogativ<du-dem
sammisarivallaannginagilli	sammisarә+VALLAAR=NNGIT<Ledsagemåde<dem+LI
sinnilaartarmanga	sinner-LAAR=TAR<Causativ<HanMig
sinnernikuutigit	sinner+NIKUU<Imperativ<ViDem
sinninngimmanga	sinner-NNGIT<Causativ<HanMig
sinneqqaarmangali	sinner-QQAAR<Causativ<HanMig+LI
sinnereermanga	sinner-RIIR<Causativ<HanMig
sinnereerakku	sinner-RIIR<Causativ<JegHam
sinnereerlugu	sinner-RIIR<Ledsagemåde<ham
sinnissatigilli	sinner-SSA<Imperativ<ViDem+LI
sinnissavaangali	sinner-SSA<Indikativ<HanMig+LI
sisamaannalerisoq	sisamat-INNAQ-LIRI<Participium<han
sisamaannanngoqqaarama	sisamat-INNAQ-NNGUR-QQAAR<Causativ<jeg
sisamaannanngussappulli	sisamat-INNAQ-NNGUR-SSA<Indikativ<de+LI
sisamassallu	sisamat-SSAQ<flertal<Absolut+LU
sisamassaa	sisamat-SSAQ<flertal<hans<Absolut
sisamassalerigama	sisamat-SSAQ-LIRI<Causativ<jeg
sisamassanngulaarpununa	sisamat-SSAQ-NNGUR-LAAR<Indikativ<de+UNA
sisamassaqassasununa	sisamat-SSAQ-QAR-SSA<Participium<de+UNA
sisamassaainnarlutinguna	sisamat-SSAQ-U-INNAR<Ledsagemåde<de_selv+UNA
sisamassaasaraluartorpassuarninguna	sisamat-SSAQ-U+TAR=GALUAR+TUQ+PASSUAQ<flertal<Instrumentalis+UNA
sisamat	sisamat<Talord<flertal<Absolut
sisamanukaannaramaana	sisamat<Talord<flertal<Terminalis-KAR-INNAR<Causativ<jeg+UNA
sisamanukariarneq	sisamat<Talord<flertal<Terminalis-KAR-RIAR+NIQ
sisamaneeqqutigilli	sisamat<Talord<Lokalis+IP-QQU<Imperativ<ViDem+LI
Sisimiut	Sisimiut<Absolut
Sisimiulli	Sisimiut<Absolut+LI
Sisimiullu	Sisimiut<Absolut+LU
Sisimiununa	Sisimiut<Absolut+UNA
Sisimiunik	Sisimiut<Instrumentalis
Sisimiunilli	Sisimiut<Instrumentalis+LI
Sisimiunillu	Sisimiut<Instrumentalis+LU
Sisimiuninguna	Sisimiut<Instrumentalis+UNA
Sisimiuni	Sisimiut<Lokalis
Sisimiuneeqqummanga	Sisimiut<Lokalis+IP-QQU<Causativ<HanMig
Sisimiuneeriarama	Sisimiut<Lokalis+IP-RIAR<Causativ<jeg
Sisimiuneeriartorli	Sisimiut<Lokalis+IP-RIAR+TUQ+LI
Sisimiuneereerpit	Sisimiut<Lokalis+IP-RIIR<Interrogativ<du
Sisimiuniissimasarpulli	Sisimiut<Lokalis+IP+SIMA=TAR<Indikativ<de+LI
Sisimiunili	Sisimiut<Lokalis+LI
Sisimiuniuna	Sisimiut<Lokalis+UNA
Sisimiormiu	Sisimiut+MIU<ental<Absolut
Sisimiormiumi	Sisimiut+MIU<ental<Lokalis
Sisimiormiumiissagaluarpugut	Sisimiut+MIU<ental<Lokalis+IP-SSA=GALUAR<Indikativ<vi
Sisimiormiumukanngitsoq	Sisimiut+MIU<ental<Terminalis-KAR-NNGIT+TUQ
Sisimiormiumununa	Sisimiut+MIU<ental<Terminalis+UNA
Sisimiormiunik	Sisimiut+MIU<flertal<Instrumentalis
Sisimiormiuni	Sisimiut+MIU<flertal<Lokalis
Sisimiormiuniissagaluarpit	Sisimiut+MIU<flertal<Lokalis+IP-SSA=GALUAR<Interrogativ<du
Sisimiormiunilu	Sisimiut+MIU<flertal<Lokalis+LU
Sisimiormiulerineq	Sisimiut+MIU-LIRI+NIQ
Sisimiormiunngulaarpit	Sisimiut+MIU-NNGUR-LAAR<Interrogativ<du
Sisimiormiunngulaarlutik	Sisimiut+MIU-NNGUR-LAAR<Ledsagemåde<de_selv
Sisimiormiunngulertunga	Sisimiut+MIU-NNGUR-LIR<Participium<jeg
Sisimiormiunngoqqullugilli	Sisimiut+MIU-NNGUR-QQU<Ledsagemåde<dem+LI
Sisimiormiunngoriartungali	Sisimiut+MIU-NNGUR-RIAR<Participium<jeg+LI
Sisimiormioqarpoq	Sisimiut+MIU-QAR<Indikativ<han
Sisimiormioqarporli	Sisimiut+MIU-QAR<Indikativ<han+LI
Sisimiormioqarporlu	Sisimiut+MIU-QAR<Indikativ<han+LU
Sisimiormioqarporuna	Sisimiut+MIU-QAR<Indikativ<han+UNA
Sisimiormioqarneq	Sisimiut+MIU-QAR+NIQ
Sisimiormioqarnerli	Sisimiut+MIU-QAR+NIQ+LI
Sisimiormioqarneruna	Sisimiut+MIU-QAR+NIQ+UNA
Sisimiormioqartoq	Sisimiut+MIU-QAR<Participium<han
Sisimiormioqartorli	Sisimiut+MIU-QAR<Participium<han+LI
Sisimiormioqartoq	Sisimiut+MIU-QAR+TUQ
Sisimiormioqartorli	Sisimiut+MIU-QAR+TUQ+LI
Sisimiormiuunianngitsorlu	Sisimiut+MIU-U+NIAR=NNGIT<Participium<han+LU
Sisimiormiuusunga	Sisimiut+MIU-U<Participium<jeg
Sisimiormiooqqaarpugut	Sisimiut+MIU-U-QQAAR<Indikativ<vi
Sisimiormiooqqaarpit	Sisimiut+MIU-U-QQAAR<Interrogativ<du
Sisimiormiooqqaartoqareertuinnaagaluarpunga	Sisimiut+MIU-U-QQAAR+TUQ-QAR-RIIR+TUQ-INNAQ-U+GALUAR<Indikativ<jeg
Sisimiormiooqqummangali	Sisimiut+MIU-U-QQU<Causativ<HanMig+LI
Sisimiormiuusimasartorli	Sisimiut+MIU-U+SIMA=TAR<Participium<han+LI
Sisimiormiuusinnaavit	Sisimiut+MIU-U+SINNAA<Interrogativ<du
Sisimiormiuusaraluartulli	Sisimiut+MIU-U+TAR=GALUAR<Participium<de+LI
Sisimiormiuusaraluartulerineq	Sisimiut+MIU-U+TAR=GALUAR+TUQ-LIRI+NIQ
Sisimiormiuusarneq	Sisimiut+MIU-U+TAR+NIQ<ental<Absolut
Sisimiormiuusartooqqaartorlu	Sisimiut+MIU-U+TAR+TUQ-U-QQAAR<Participium<han+LU
Sisimiunut	Sisimiut<Terminalis
Sisimiunukaraluartoqarporli	Sisimiut<Terminalis-KAR+GALUAR+TUQ-QAR<Indikativ<han+LI
Sisimiunukaqqullugillu	Sisimiut<Terminalis-KAR-QQU<Ledsagemåde<dem+LU
Sisimiunukariartoqarporli	Sisimiut<Terminalis-KAR-RIAR+TUQ-QAR<Indikativ<han+LI
Sisimiunukareerpunga	Sisimiut<Terminalis-KAR-RIIR<Indikativ<jeg
Sisimiunukareertoq	Sisimiut<Terminalis-KAR-RIIR<Participium<han
Sisimiunukassagamalu	Sisimiut<Terminalis-KAR-SSA<Causativ<jeg+LU
Sisimiunulli	Sisimiut<Terminalis+LI
Sisimiunullu	Sisimiut<Terminalis+LU
Sisimiunununa	Sisimiut<Terminalis+UNA
siulleq	siulleq<ental<Absolut
siullia	siulleq<ental<hans<Absolut
siulliinnanngussagaluaramalu	siulleq-INNAQ-NNGUR-SSA=GALUAR<Causativ<jeg+LU
siulleqaannarlutik	siulleq-QAR-INNAR<Ledsagemåde<de_selv
siulleqalaartarpit	siulleq-QAR-LAAR=TAR<Interrogativ<du
sivikikkaluartuugama	sivikip+GALUAR+TUQ-U<Causativ<jeg
sivikinniarpit	sivikip+NIAR<Interrogativ<du
sivikeqqutigit	sivikip-QQU<Imperativ<ViDem
sivikeqqullugilli	sivikip-QQU<Ledsagemåde<dem+LI
sivikeriarama	sivikip-RIAR<Causativ<jeg
sivikeriartut	sivikip-RIAR<Participium<de
sivikereertutununa	sivikip-RIIR+TUQ<ental<Aequalis+UNA
sivikittaraluarlutinguna	sivikip+TAR=GALUAR<Ledsagemåde<de_selv+UNA
sivikittarlutik	sivikip+TAR<Ledsagemåde<de_selv
soqutigigaluarpakkaana	soqutigә+GALUAR<Indikativ<JegDem+UNA
soqutigigaluarlugu	soqutigә+GALUAR<Ledsagemåde<ham
soqutigartorakku	soqutigә+GIARTUR<Causativ<JegHam
soqutigartorpakka	soqutigә+GIARTUR<Indikativ<JegDem
soqutigiviuk	soqutigә<Interrogativ<du-dem
soqutigilaarakku	soqutigә-LAAR<Causativ<JegHam
soqutigilaarlugilli	soqutigә-LAAR<Ledsagemåde<dem+LI
soqutigilaartarakkulu	soqutigә-LAAR=TAR<Causativ<JegHam+LU
soqutigilaartarlugilli	soqutigә-LAAR=TAR<Ledsagemåde<dem+LI
soqutigalugit	soqutigә<Ledsagemåde<dem
soqutigalugilli	soqutigә<Ledsagemåde<dem+LI
soqutiginikuutigillu	soqutigә+NIKUU<Imperativ<ViDem+LU
soqutigineqaramali	soqutigә+NIQAR<Causativ<jeg+LI
soqutigineqarpungali	soqutigә+NIQAR<Indikativ<jeg+LI
soqutiginerummanga	soqutigә+NIRU<Causativ<HanMig
soqutiginerugakku	soqutigә+NIRU<Causativ<JegHam
soqutiginnginnakku	soqutigә-NNGIT<Causativ<JegHam
soqutiginngiliuk	soqutigә-NNGIT<Interrogativ<du-dem
soqutigeqqaarpiuk	soqutigә-QQAAR<Interrogativ<du-dem
soqutigeriarlugu	soqutigә-RIAR<Ledsagemåde<ham
soqutigisimatiginuna	soqutigә+SIMA<Imperativ<ViDem+UNA
soqutigisimaviuk	soqutigә+SIMA<Interrogativ<du-dem
soqutigisimasarmangalu	soqutigә+SIMA=TAR<Causativ<HanMig+LU
soqutigisimasarakku	soqutigә+SIMA=TAR<Causativ<JegHam
soqutigisimasartigilli	soqutigә+SIMA=TAR<Imperativ<ViDem+LI
soqutigissagaluartigilli	soqutigә-SSA=GALUAR<Imperativ<ViDem+LI
soqutigisarpakkali	soqutigә+TAR<Indikativ<JegDem+LI
soqutigivallaarmanga	soqutigә+VALLAAR<Causativ<HanMig
soqutigivallaanngilassi	soqutigә+VALLAAR=NNGIT<Indikativ<JegJer
sugamali	su<Causativ<jeg+LI
sugaluarama	su+GALUAR<Causativ<jeg
sugaluarpunga	su+GALUAR<Indikativ<jeg
sugaluarpit	su+GALUAR<Interrogativ<du
sugaluarnikka	su+GALUAR+NIQ<flertal<min<Absolut
sugaluartullillu	su+GALUAR+TUQ-LIK<flertal<Relativ+LU
suvoq	su<Indikativ<han
suinnarpit	su-INNAR<Interrogativ<du
suit	su<Interrogativ<du
sulaarama	su-LAAR<Causativ<jeg
sulaaramalu	su-LAAR<Causativ<jeg+LU
sulaarpoq	su-LAAR<Indikativ<han
sulaartut	su-LAAR<Participium<de
sulaartarporlu	su-LAAR=TAR<Indikativ<han+LU
sulaartarpit	su-LAAR=TAR<Interrogativ<du
sulillutilli	suli<Ledsagemåde<de_selv+LI
SULI	SULI<Partikel
SULIli	SULI<Partikel+LI
SULIlu	SULI<Partikel+LU
SULIuna	SULI<Partikel+UNA
suleqqulluguuna	suli-QQU<Ledsagemåde<ham+UNA
sulisarpit	suli+TAR<Interrogativ<du
suniarnatillu	su+NIAR=NNGIT<Ledsagemåde<de_selv+LU
sunianngitsungali	su+NIAR=NNGIT<Participium<jeg+LI
sunikuugama	su+NIKUU<Causativ<jeg
sunikuuniniuna	su+NIKUU+NIQ<ental<sin<Absolut+UNA
sunini	su+NIQ<ental<sin<Absolut
suninili	su+NIQ<ental<sin<Absolut+LI
sunikka	su+NIQ<flertal<min<Absolut
sunertoruna	su+NIR<Participium<han+UNA
sunerugama	su+NIRU<Causativ<jeg
sunerugamalu	su+NIRU<Causativ<jeg+LU
sunerunikkaana	su+NIRU+NIQ<flertal<min<Absolut+UNA
sunatik	su-NNGIT<Ledsagemåde<de_selv
susullu	su<Participium<de+LU
susunga	su<Participium<jeg
soqqaaramali	su-QQAAR<Causativ<jeg+LI
soqqaaramalu	su-QQAAR<Causativ<jeg+LU
soqqaarpulli	su-QQAAR<Indikativ<de+LI
soqqaarlutik	su-QQAAR<Ledsagemåde<de_selv
soqqaarlutilli	su-QQAAR<Ledsagemåde<de_selv+LI
soqqaarlutinguna	su-QQAAR<Ledsagemåde<de_selv+UNA
soqqaarnini	su-QQAAR+NIQ<ental<sin<Absolut
soqqaarneriuna	su-QQAAR+NIQ<flertal<hans<Absolut+UNA
soqqaarnikka	su-QQAAR+NIQ<flertal<min<Absolut
soqqaartunga	su-QQAAR<Participium<jeg
soqqaartungali	su-QQAAR<Participium<jeg+LI
soqqugakkulu	su-QQU<Causativ<JegHam+LU
soqqutigit	su-QQU<Imperativ<ViDem
soqqutiginuna	su-QQU<Imperativ<ViDem+UNA
soqquaajuna	su-QQU<Indikativ<HanDem+UNA
soqquaalu	su-QQU<Indikativ<HanHam+LU
soqquiuk	su-QQU<Interrogativ<du-dem
soqqullugillu	su-QQU<Ledsagemåde<dem+LU
soqqullugu	su-QQU<Ledsagemåde<ham
soriarama	su-RIAR<Causativ<jeg
soriaramaana	su-RIAR<Causativ<jeg+UNA
soriarlutillu	su-RIAR<Ledsagemåde<de_selv+LU
soriartut	su-RIAR<Participium<de
soriartorli	su-RIAR<Participium<han+LI
soreerama	su-RIIR<Causativ<jeg
soreerpoq	su-RIIR<Indikativ<han
soreerlutik	su-RIIR<Ledsagemåde<de_selv
soreertunga	su-RIIR<Participium<jeg
soreertuinnaqalaartartuuvoq	su-RIIR+TUQ-INNAQ-QAR-LAAR=TAR+TUQ-U<Indikativ<han
susimaninili	su+SIMA+NIQ<ental<sin<Absolut+LI
susimasartora	su+SIMA=TAR+TUQ<ental<min<Absolut
susinnaasungali	su+SINNAA<Participium<jeg+LI
sussagaluarlutik	su-SSA=GALUAR<Ledsagemåde<de_selv
sussagaluarlutinguna	su-SSA=GALUAR<Ledsagemåde<de_selv+UNA
sussagaluartorereerlugu	su-SSA=GALUAR+TUQ+GӘ-RIIR<Ledsagemåde<ham
sussaagut	su-SSA<Indikativ<vi
susullilli	su+TUQ-LIK<flertal<Absolut+LI
susoqaqquiuk	su+TUQ-QAR-QQU<Interrogativ<du-dem
susooqqaartoruna	su+TUQ-U-QQAAR<Participium<han+UNA
suallaanngilagulli	su+VALLAAR=NNGIT<Indikativ<vi+LI
suallaartullu	su+VALLAAR<Participium<de+LU
suallaartoq	su+VALLAAR+TUQ<ental<Absolut
taagakkulu	taa<Causativ<JegHam+LU
taamaammallu	taamaammat<Partikel+LU
taamani	taamani<Partikel
taanianngimmanga	taa+NIAR=NNGIT<Causativ<HanMig
taanikuummangalu	taa+NIKUU<Causativ<HanMig+LU
taanikuullugit	taa+NIKUU<Ledsagemåde<dem
taaneqarpungali	taa+NIQAR<Indikativ<jeg+LI
taanerakkuli	taa+NIR<Causativ<JegHam+LI
taanerakkulu	taa+NIR<Causativ<JegHam+LU
taanerummangali	taa+NIRU<Causativ<HanMig+LI
taanna	taanna<Pronomen<ental
taannalu	taanna<Pronomen<ental+LU
taariarlugu	taa-RIAR<Ledsagemåde<ham
taasinnaallugu	taa+SINNAA<Ledsagemåde<ham
taassatiginuna	taa-SSA<Imperativ<ViDem+UNA
taasarpaanga	taa+TAR<Indikativ<HanMig
taavallaanngilaanga	taa+VALLAAR=NNGIT<Indikativ<HanMig
tallimaannarnilu	tallimat-INNAQ<flertal<Lokalis+LU
tallimaannalerigamaana	tallimat-INNAQ-LIRI<Causativ<jeg+UNA
tallimaannannguinnartorpassuilli	tallimat-INNAQ-NNGUR-INNAR+TUQ+PASSUAQ<flertal<Absolut+LI
tallimaannanngoqqaarpungalu	tallimat-INNAQ-NNGUR-QQAAR<Indikativ<jeg+LU
tallimaannanngoqqaarlutillu	tallimat-INNAQ-NNGUR-QQAAR<Ledsagemåde<de_selv+LU
tallimaannanngoqquiuk	tallimat-INNAQ-NNGUR-QQU<Interrogativ<du-dem
tallimaannanngussaangali	tallimat-INNAQ-NNGUR-SSA<Indikativ<jeg+LI
tallimassanilli	tallimat-SSAQ<flertal<Instrumentalis+LI
tallimassani	tallimat-SSAQ<flertal<Lokalis
tallimassalerigama	tallimat-SSAQ-LIRI<Causativ<jeg
tallimassalerinerli	tallimat-SSAQ-LIRI+NIQ+LI
tallimassalerisununa	tallimat-SSAQ-LIRI<Participium<de+UNA
tallimassaqaannarpit	tallimat-SSAQ-QAR-INNAR<Interrogativ<du
tallimassaqalaartartorisinnaaviuk	tallimat-SSAQ-QAR-LAAR=TAR+TUQ+GӘ+SINNAA<Interrogativ<du-dem
tallimassaalaartarpugununa	tallimat-SSAQ-U-LAAR=TAR<Indikativ<vi+UNA
tallimassaanerusulli	tallimat-SSAQ-U+NIRU<Participium<de+LI
tallimassaasarlutinguna	tallimat-SSAQ-U+TAR<Ledsagemåde<de_selv+UNA
tallimassaasorpassuarnullu	tallimat-SSAQ-U+TUQ+PASSUAQ<flertal<Terminalis+LU
tallimatulli	tallimat<Talord<Aequalis+LI
tallimatununa	tallimat<Talord<Aequalis+UNA
tallimaat	tallimat<Talord<ental<deres
tallimaalli	tallimat<Talord<ental<deres+LI
tallimaallu	tallimat<Talord<ental<deres+LU
tallimalli	tallimat<Talord<flertal<Absolut+LI
tallimanik	tallimat<Talord<Instrumentalis
tallimanilli	tallimat<Talord<Instrumentalis+LI
tallimanillu	tallimat<Talord<Instrumentalis+LU
tallimaneeqquaangaana	tallimat<Talord<Lokalis+IP-QQU<Indikativ<HanMig+UNA
tamarmik	tamarmik<Adjektiv
tamarmilli	tamarmik<Adjektiv+LI
tamarmillu	tamarmik<Adjektiv+LU
tamarminguna	tamarmik<Adjektiv+UNA
tamatta	tamatta<Adjektiv
tamattali	tamatta<Adjektiv+LI
tamattalu	tamatta<Adjektiv+LU
tamattaana	tamatta<Adjektiv+UNA
Tasiilaq	Tasiilaq<Absolut
Tasiilarli	Tasiilaq<Absolut+LI
Tasiilarlu	Tasiilaq<Absolut+LU
Tasiilaruna	Tasiilaq<Absolut+UNA
Tasiilamik	Tasiilaq<Instrumentalis
Tasiilamilli	Tasiilaq<Instrumentalis+LI
Tasiilamillu	Tasiilaq<Instrumentalis+LU
Tasiilaminguna	Tasiilaq<Instrumentalis+UNA
Tasiilami	Tasiilaq<Lokalis
Tasiilamiinnerullutik	Tasiilaq<Lokalis+IP+NIRU<Ledsagemåde<de_selv
Tasiilameeqqaarpugut	Tasiilaq<Lokalis+IP-QQAAR<Indikativ<vi
Tasiilameeqqaarlutilli	Tasiilaq<Lokalis+IP-QQAAR<Ledsagemåde<de_selv+LI
Tasiilameeqqaartulli	Tasiilaq<Lokalis+IP-QQAAR<Participium<de+LI
Tasiilameeqquaannga	Tasiilaq<Lokalis+IP-QQU<Indikativ<DeMig
Tasiilameeqquai	Tasiilaq<Lokalis+IP-QQU<Indikativ<HanDem
Tasiilameeqquakkali	Tasiilaq<Lokalis+IP-QQU<Indikativ<JegDem+LI
Tasiilameeqquiuk	Tasiilaq<Lokalis+IP-QQU<Interrogativ<du-dem
Tasiilameeriaramaana	Tasiilaq<Lokalis+IP-RIAR<Causativ<jeg+UNA
Tasiilameeriarpit	Tasiilaq<Lokalis+IP-RIAR<Interrogativ<du
Tasiilameereerneq	Tasiilaq<Lokalis+IP-RIIR+NIQ
Tasiilamili	Tasiilaq<Lokalis+LI
Tasiilarmiu	Tasiilaq+MIU<ental<Absolut
Tasiilarmiumeeriartoq	Tasiilaq+MIU<ental<Lokalis+IP-RIAR<Participium<han
Tasiilarmiunik	Tasiilaq+MIU<flertal<Instrumentalis
Tasiilarmiuneeqqaartunga	Tasiilaq+MIU<flertal<Lokalis+IP-QQAAR<Participium<jeg
Tasiilarmiulerivit	Tasiilaq+MIU-LIRI<Interrogativ<du
Tasiilarmiunngoqqulluguli	Tasiilaq+MIU-NNGUR-QQU<Ledsagemåde<ham+LI
Tasiilarmioqarporuna	Tasiilaq+MIU-QAR<Indikativ<han+UNA
Tasiilarmioqarneruna	Tasiilaq+MIU-QAR+NIQ+UNA
Tasiilarmioqartoq	Tasiilaq+MIU-QAR<Participium<han
Tasiilarmioqartorli	Tasiilaq+MIU-QAR<Participium<han+LI
Tasiilarmioqartorlu	Tasiilaq+MIU-QAR<Participium<han+LU
Tasiilarmioqartoq	Tasiilaq+MIU-QAR+TUQ
Tasiilarmioqartorli	Tasiilaq+MIU-QAR+TUQ+LI
Tasiilarmioqartorlu	Tasiilaq+MIU-QAR+TUQ+LU
Tasiilarmioqartoruna	Tasiilaq+MIU-QAR+TUQ+UNA
Tasiilarmiuulaartartunga	Tasiilaq+MIU-U-LAAR=TAR<Participium<jeg
Tasiilarmiuunikuullutik	Tasiilaq+MIU-U+NIKUU<Ledsagemåde<de_selv
Tasiilarmiuunikuunini	Tasiilaq+MIU-U+NIKUU+NIQ<ental<sin<Absolut
Tasiilarmiuunerlutilli	Tasiilaq+MIU-U+NIR<Ledsagemåde<de_selv+LI
Tasiilarmiuunerusussalerisungalu	Tasiilaq+MIU-U+NIRU+TUQ-SSAQ-LIRI<Participium<jeg+LU
Tasiilarmiooqqaarpit	Tasiilaq+MIU-U-QQAAR<Interrogativ<du
Tasiilarmiooqqaarlutinguna	Tasiilaq+MIU-U-QQAAR<Ledsagemåde<de_selv+UNA
Tasiilarmiooriarlutik	Tasiilaq+MIU-U-RIAR<Ledsagemåde<de_selv
Tasiilarmiooriarlutillu	Tasiilaq+MIU-U-RIAR<Ledsagemåde<de_selv+LU
Tasiilarmiooriartununa	Tasiilaq+MIU-U-RIAR<Participium<de+UNA
Tasiilarmiuusinnaasoq	Tasiilaq+MIU-U+SINNAA+TUQ<ental<Absolut
Tasiilarmiuussagaluarpit	Tasiilaq+MIU-U-SSA=GALUAR<Interrogativ<du
Tasiilarmiuussagaluarnera	Tasiilaq+MIU-U-SSA=GALUAR+NIQ<ental<hans<Absolut
Tasiilamukaannartunga	Tasiilaq<Terminalis-KAR-INNAR<Participium<jeg
Tasiilamukalaarama	Tasiilaq<Terminalis-KAR-LAAR<Causativ<jeg
Tasiilamukalaarpit	Tasiilaq<Terminalis-KAR-LAAR<Interrogativ<du
Tasiilamukalaartoqarpoq	Tasiilaq<Terminalis-KAR-LAAR+TUQ-QAR<Indikativ<han
Tasiilamukalertoqarporlu	Tasiilaq<Terminalis-KAR-LIR+TUQ-QAR<Indikativ<han+LU
Tasiilamukarnatik	Tasiilaq<Terminalis-KAR-NNGIT<Ledsagemåde<de_selv
Tasiilamukaqquaanga	Tasiilaq<Terminalis-KAR-QQU<Indikativ<HanMig
Tasiilamukaqquara	Tasiilaq<Terminalis-KAR-QQU<Indikativ<JegHam
Tasiilamukassagaluarpunga	Tasiilaq<Terminalis-KAR-SSA=GALUAR<Indikativ<jeg
Tasiilamukassagaluarnerli	Tasiilaq<Terminalis-KAR-SSA=GALUAR+NIQ+LI
Tasiilamukassasut	Tasiilaq<Terminalis-KAR-SSA<Participium<de
Tasiilamukartaraluarpungali	Tasiilaq<Terminalis-KAR+TAR=GALUAR<Indikativ<jeg+LI
Tasiilamukartaraluartununa	Tasiilaq<Terminalis-KAR+TAR=GALUAR<Participium<de+UNA
Tasiilamulli	Tasiilaq<Terminalis+LI
Tasiilamununa	Tasiilaq<Terminalis+UNA
tassa	tassa<Partikel
tassali	tassa<Partikel+LI
tassalu	tassa<Partikel+LU
tassaana	tassa<Partikel+UNA
tulluaraluarpit	tulluar+GALUAR<Interrogativ<du
tulluaraluarlutik	tulluar+GALUAR<Ledsagemåde<de_selv
tulluaraluartuinnartut	tulluar+GALUAR+TUQ-INNAQ<ental<Aequalis
tullualaartuinnanngorpit	tulluar-LAAR+TUQ-INNAQ-NNGUR<Interrogativ<du
tullualeramaana	tulluar-LIR<Causativ<jeg+UNA
tullualerpugullu	tulluar-LIR<Indikativ<vi+LU
tullualertulerigama	tulluar-LIR+TUQ-LIRI<Causativ<jeg
tulluarniarnera	tulluar+NIAR+NIQ<ental<hans<Absolut
tulluarnerat	tulluar+NIQ<ental<deres
tulluarnerit	tulluar+NIQ<flertal<Absolut
tulluarneramalu	tulluar+NIR<Causativ<jeg+LU
tulluarnertungalu	tulluar+NIR<Participium<jeg+LU
tulluarneruvoq	tulluar+NIRU<Indikativ<han
tulluaqqaarama	tulluar-QQAAR<Causativ<jeg
tulluaqqaarlutik	tulluar-QQAAR<Ledsagemåde<de_selv
tulluaqqaarnerilli	tulluar-QQAAR+NIQ<flertal<Absolut+LI
tulluaqqaartoq	tulluar-QQAAR+TUQ<ental<Absolut
tulluaqqugakku	tulluar-QQU<Causativ<JegHam
tulluaqqugakkuli	tulluar-QQU<Causativ<JegHam+LI
tulluaqquagulli	tulluar-QQU<Indikativ<ViDem+LI
tulluariarama	tulluar-RIAR<Causativ<jeg
tulluareerpugut	tulluar-RIIR<Indikativ<vi
tulluareertulli	tulluar-RIIR<Participium<de+LI
tulluarsinnaavit	tulluar+SINNAA<Interrogativ<du
tulluarsinnaasulerisoqanngilaq	tulluar+SINNAA+TUQ-LIRI+TUQ-QAR-NNGIT<Indikativ<han
tulluassagaluarama	tulluar-SSA=GALUAR<Causativ<jeg
tulluartaraluarama	tulluar+TAR=GALUAR<Causativ<jeg
tulluartarpit	tulluar+TAR<Interrogativ<du
tulluartartunga	tulluar+TAR<Participium<jeg
tulluarpallaanngilatit	tulluar+VALLAAR=NNGIT<Interrogativ<du
tulluarpallaannginnerat	tulluar+VALLAAR=NNGIT+NIQ<ental<deres
tusagassiortoq	tusagassiortoq<ental<Absolut
tusagassiortutununa	tusagassiortoq<ental<Aequalis+UNA
tusagassiortumiinngitsullu	tusagassiortoq<ental<Lokalis+IP-NNGIT<Participium<de+LU
tusagassiortui	tusagassiortoq<flertal<hans<Absolut
tusagassiortorilaartigilli	tusagassiortoq+GӘ-LAAR<Imperativ<ViDem+LI
tusagassiortuinnaalli	tusagassiortoq-INNAQ<ental<deres<Absolut+LI
tusagassiortuinnanngulaarlutilli	tusagassiortoq-INNAQ-NNGUR-LAAR<Ledsagemåde<de_selv+LI
tusagassiortuinnaanertulli	tusagassiortoq-INNAQ-U+NIR<Participium<de+LI
tusagassiortulerigamaana	tusagassiortoq-LIRI<Causativ<jeg+UNA
tusagassiortulerisunga	tusagassiortoq-LIRI<Participium<jeg
tusagassiortunngoqqaarneri	tusagassiortoq-NNGUR-QQAAR+NIQ<flertal<hans<Absolut
tusagassiortoqalertungalu	tusagassiortoq-QAR-LIR<Participium<jeg+LU
tusagassiortussarali	tusagassiortoq-SSAQ<ental<min<Absolut+LI
tusagassiortussamukassagamalu	tusagassiortoq-SSAQ<ental<Terminalis-KAR-SSA<Causativ<jeg+LU
tusagassiortooriarluni	tusagassiortoq-U-RIAR<Ledsagemåde<han_selv
tusagassiortooreeramaana	tusagassiortoq-U-RIIR<Causativ<jeg+UNA
tusilaraluartunngoqqugakkuli	tusilar+GALUAR+TUQ-NNGUR-QQU<Causativ<JegHam+LI
tusilariartortoqalaartora	tusilar+GIARTUR+TUQ-QAR-LAAR+TUQ<ental<min<Absolut
tusilaannartooqqaarpugulli	tusilar-INNAR+TUQ-U-QQAAR<Indikativ<vi+LI
tusilarpit	tusilar<Interrogativ<du
tusilalaartarpugununa	tusilar-LAAR=TAR<Indikativ<vi+UNA
tusilalaartartunga	tusilar-LAAR=TAR<Participium<jeg
tusilarnikuuvunga	tusilar+NIKUU<Indikativ<jeg
tusilarneri	tusilar+NIQ<flertal<hans<Absolut
tusilarnernut	tusilar+NIQ<flertal<Terminalis
tusilarnerama	tusilar+NIR<Causativ<jeg
tusilarnerusorilaartarpara	tusilar+NIRU+TUQ+GӘ-LAAR=TAR<Indikativ<JegHam
tusilanngilangaana	tusilar-NNGIT<Indikativ<jeg+UNA
tusilarnatinguna	tusilar-NNGIT<Ledsagemåde<de_selv+UNA
tusilartunga	tusilar<Participium<jeg
tusilaqqaartorineruakkali	tusilar-QQAAR+TUQ+GӘ+NIRU<Indikativ<JegDem+LI
tusilareeramaana	tusilar-RIIR<Causativ<jeg+UNA
tusilarsinnaagama	tusilar+SINNAA<Causativ<jeg
tusilarsinnaasunnguunerusoq	tusilar+SINNAA+TUQ-NNGUAQ-U+NIRU+TUQ<ental<Absolut
tutsiuteqqikkaluartormioqarporli	tutsiuteqqip+GALUAR+TUQ+MIU-QAR<Indikativ<han+LI
tutsiuteqqikkiartorama	tutsiuteqqip+GIARTUR<Causativ<jeg
tutsiuteqqikkiartornikkalu	tutsiuteqqip+GIARTUR+NIQ<flertal<min<Absolut+LU
tutsiuteqqippunga	tutsiuteqqip<Indikativ<jeg
tutsiuteqqiinnartorlu	tutsiuteqqip-INNAR<Participium<han+LU
tutsiuteqqillutik	tutsiuteqqip<Ledsagemåde<de_selv
tutsiuteqqillutillu	tutsiuteqqip<Ledsagemåde<de_selv+LU
tutsiuteqqinnianngitsunga	tutsiuteqqip+NIAR=NNGIT<Participium<jeg
tutsiuteqqinnikuusunga	tutsiuteqqip+NIKUU<Participium<jeg
tutsiuteqqinngitsorli	tutsiuteqqip-NNGIT<Participium<han+LI
tutsiuteqqittunga	tutsiuteqqip<Participium<jeg
tutsiuteqqeqqaarnermullu	tutsiuteqqip-QQAAR+NIQ<ental<Terminalis+LU
tutsiuteqqeqqaartuussagaluartunga	tutsiuteqqip-QQAAR+TUQ-U-SSA=GALUAR<Participium<jeg
tutsiuteqqeqqummanga	tutsiuteqqip-QQU<Causativ<HanMig
tutsiuteqqeqqummangalu	tutsiuteqqip-QQU<Causativ<HanMig+LU
tutsiuteqqeqqugakku	tutsiuteqqip-QQU<Causativ<JegHam
tutsiuteqqeqqugakkulu	tutsiuteqqip-QQU<Causativ<JegHam+LU
tutsiuteqqeqquaali	tutsiuteqqip-QQU<Indikativ<HanHam+LI
tutsiuteqqeriarlutilli	tutsiuteqqip-RIAR<Ledsagemåde<de_selv+LI
tutsiuteqqeriarlutinguna	tutsiuteqqip-RIAR<Ledsagemåde<de_selv+UNA
tutsiuteqqeriarlunga	tutsiuteqqip-RIAR<Ledsagemåde<jeg
tutsiuteqqereerpununa	tutsiuteqqip-RIIR<Indikativ<de+UNA
tutsiuteqqereerpugut	tutsiuteqqip-RIIR<Indikativ<vi
tutsiuteqqereerpit	tutsiuteqqip-RIIR<Interrogativ<du
tutsiuteqqereerlutinguna	tutsiuteqqip-RIIR<Ledsagemåde<de_selv+UNA
tutsiuteqqereertungalu	tutsiuteqqip-RIIR<Participium<jeg+LU
tutsiuteqqereertorpassuit	tutsiuteqqip-RIIR+TUQ+PASSUAQ<flertal<Absolut
tutsiuteqqissimasaramalu	tutsiuteqqip+SIMA=TAR<Causativ<jeg+LU
tutsiuteqqissasungalu	tutsiuteqqip-SSA<Participium<jeg+LU
tutsiuteqqittarama	tutsiuteqqip+TAR<Causativ<jeg
tutsiuteqqittulerineq	tutsiuteqqip+TUQ-LIRI+NIQ
tutsiuteqqippallaartoqalaartoq	tutsiuteqqip+VALLAAR+TUQ-QAR-LAAR<Participium<han
uagut	uagut<Pronomen<ental
uagulli	uagut<Pronomen<ental+LI
uagullu	uagut<Pronomen<ental+LU
uagununa	uagut<Pronomen<ental+UNA
uannit	uanga<Pronomen<Ablativ<jeg
uannilli	uanga<Pronomen<Ablativ<jeg+LI
uannillu	uanga<Pronomen<Ablativ<jeg+LU
uanninuna	uanga<Pronomen<Ablativ<jeg+UNA
uanga	uanga<Pronomen<jeg
uangalu	uanga<Pronomen<jeg+LU
uangaana	uanga<Pronomen<jeg+UNA
uannut	uanga<Pronomen<Terminalis<jeg
uannullu	uanga<Pronomen<Terminalis<jeg+LU
uannununa	uanga<Pronomen<Terminalis<jeg+UNA
ukiigamalu	ukii<Causativ<jeg+LU
ukiigaluartumukarnerpoq	ukii+GALUAR+TUQ<ental<Terminalis-KAR+NIR<Indikativ<han
ukiivit	ukii<Interrogativ<du
ukiilaartarpulli	ukii-LAAR=TAR<Indikativ<de+LI
ukiillutik	ukii<Ledsagemåde<de_selv
ukiininilu	ukii+NIQ<ental<sin<Absolut+LU
ukeeqqaarama	ukii-QQAAR<Causativ<jeg
ukeeqqaarpugullu	ukii-QQAAR<Indikativ<vi+LU
ukeeqqaarlutinguna	ukii-QQAAR<Ledsagemåde<de_selv+UNA
ukeeqqaartoq	ukii-QQAAR+TUQ<ental<Absolut
ukeeqqaartuni	ukii-QQAAR+TUQ<ental<sin<Absolut
ukeeqqutigit	ukii-QQU<Imperativ<ViDem
ukeeqqutigillu	ukii-QQU<Imperativ<ViDem+LU
ukeeqqullugu	ukii-QQU<Ledsagemåde<ham
ukeeriarama	ukii-RIAR<Causativ<jeg
ukeeriarlutik	ukii-RIAR<Ledsagemåde<de_selv
ukeeriarluni	ukii-RIAR<Ledsagemåde<han_selv
ukeeriartunga	ukii-RIAR<Participium<jeg
ukeeriartungaana	ukii-RIAR<Participium<jeg+UNA
ukeereernikka	ukii-RIIR+NIQ<flertal<min<Absolut
ukeereertungalu	ukii-RIIR<Participium<jeg+LU
ukiisimasarama	ukii+SIMA=TAR<Causativ<jeg
ukiisimasulerisorlu	ukii+SIMA+TUQ-LIRI<Participium<han+LU
ukiisorisaraluarpiuk	ukii+TUQ+GӘ+TAR=GALUAR<Interrogativ<du-dem
ukioq	ukioq<ental<Absolut
ukiunut	ukioq<flertal<Terminalis
ukioriittulli	ukioq+GIIT<flertal<Aequalis+LI
ukioriinnukaannaramalu	ukioq+GIIT<flertal<Terminalis-KAR-INNAR<Causativ<jeg+LU
ukioriilerigama	ukioq+GIIT-LIRI<Causativ<jeg
ukioriilerisulli	ukioq+GIIT-LIRI<Participium<de+LI
ukiuinnaallu	ukioq-INNAQ<ental<deres<Absolut+LU
ukiullilli	ukioq-LIK<flertal<Relativ+LI
ukiunngulertorlu	ukioq-NNGUR-LIR+TUQ+LU
ukiunngunngitsoq	ukioq-NNGUR-NNGIT+TUQ
ukiorpassui	ukioq+PASSUAQ<flertal<hans<Absolut
ukioqalaartarnerli	ukioq-QAR-LAAR=TAR+NIQ+LI
ukioqanngilaruna	ukioq-QAR-NNGIT<Indikativ<han+UNA
ukioqanngitsorli	ukioq-QAR-NNGIT<Participium<han+LI
ukioqaqqaarnerli	ukioq-QAR-QQAAR+NIQ+LI
ukioqaqqutiginuna	ukioq-QAR-QQU<Imperativ<ViDem+UNA
ukiussannguinnarlutik	ukioq-SSAQ-NNGUR-INNAR<Ledsagemåde<de_selv
ukiooriaramali	ukioq-U-RIAR<Causativ<jeg+LI
ukiooreerlutik	ukioq-U-RIIR<Ledsagemåde<de_selv
ullora	ulloq<ental<min<Absolut
ullorali	ulloq<ental<min<Absolut+LI
ullunili	ulloq<ental<sin<Absolut+LI
ullumut	ulloq<ental<Terminalis
ullui	ulloq<flertal<hans<Absolut
ulluiuna	ulloq<flertal<hans<Absolut+UNA
ullunilli	ulloq<flertal<Instrumentalis+LI
ulloriit	ulloq+GIIT<flertal<Absolut
ulloriinnillu	ulloq+GIIT<flertal<Instrumentalis+LU
ullorartorlugu	ulloq+GӘ+GIARTUR<Ledsagemåde<ham
ullorilaartartiginuna	ulloq+GӘ-LAAR=TAR<Imperativ<ViDem+UNA
ullorereermangali	ulloq+GӘ-RIIR<Causativ<HanMig+LI
ullorisimasartigit	ulloq+GӘ+SIMA=TAR<Imperativ<ViDem
ulluinnaainnartui	ulloq-INNAQ-U-INNAR+TUQ<flertal<hans<Absolut
ullulikka	ulloq-LIK<flertal<min<Absolut
ullullinuna	ulloq-LIK<flertal<Relativ+UNA
ullulerivoq	ulloq-LIRI<Indikativ<han
ullulerillutinguna	ulloq-LIRI<Ledsagemåde<de_selv+UNA
ullunnguuneq	ulloq-NNGUAQ-U+NIQ<ental<Absolut
ullunnguusimasulerivoq	ulloq-NNGUAQ-U+SIMA+TUQ-LIRI<Indikativ<han
ullunnguinnarpunga	ulloq-NNGUR-INNAR<Indikativ<jeg
ullorpassui	ulloq+PASSUAQ<flertal<hans<Absolut
ullorpassuilu	ulloq+PASSUAQ<flertal<hans<Absolut+LU
ullorpassuarnillu	ulloq+PASSUAQ<flertal<Instrumentalis+LU
ulloqalaarpit	ulloq-QAR-LAAR<Interrogativ<du
ulloqalaartarama	ulloq-QAR-LAAR=TAR<Causativ<jeg
ulloqalertungaana	ulloq-QAR-LIR<Participium<jeg+UNA
ulloqassagaluarlutik	ulloq-QAR-SSA=GALUAR<Ledsagemåde<de_selv
ullussamalu	ulloq-SSAQ<ental<min>Relativ+LU
ullussaa	ulloq-SSAQ<flertal<hans<Absolut
ullussakka	ulloq-SSAQ<flertal<min<Absolut
ullussalerivit	ulloq-SSAQ-LIRI<Interrogativ<du
ullussaqassasununa	ulloq-SSAQ-QAR-SSA<Participium<de+UNA
ulluunerlutillu	ulloq-U+NIR<Ledsagemåde<de_selv+LU
ullooqqutigillu	ulloq-U-QQU<Imperativ<ViDem+LU
ullooreertoqaqqaarlutinguna	ulloq-U-RIIR+TUQ-QAR-QQAAR<Ledsagemåde<de_selv+UNA
ulluussagaluartuussagaluarpugut	ulloq-U-SSA=GALUAR+TUQ-U-SSA=GALUAR<Indikativ<vi
ullumi	ullumi<Partikel
ullumili	ullumi<Partikel+LI
ullumilu	ullumi<Partikel+LU
ullumiuna	ullumi<Partikel+UNA
unikkama	unip<Causativ<jeg
unikkaluarpullu	unip+GALUAR<Indikativ<de+LU
unikkiartortoriviuk	unip+GIARTUR+TUQ+GӘ<Interrogativ<du-dem
unilaartarpunga	unip-LAAR=TAR<Indikativ<jeg
unillutik	unip<Ledsagemåde<de_selv
uninniartuma	unip+NIAR+TUQ<ental<min>Relativ
uninnikuusooreertooriartoruna	unip+NIKUU+TUQ-U-RIIR+TUQ-U-RIAR<Participium<han+UNA
uninnatik	unip-NNGIT<Ledsagemåde<de_selv
unittunga	unip<Participium<jeg
uneqqaarpulli	unip-QQAAR<Indikativ<de+LI
uneqqaarpugut	unip-QQAAR<Indikativ<vi
uneqqaarnini	unip-QQAAR+NIQ<ental<sin<Absolut
uneqqaartungali	unip-QQAAR<Participium<jeg+LI
uneqqummanga	unip-QQU<Causativ<HanMig
uneqqugakkuli	unip-QQU<Causativ<JegHam+LI
uneqqutigillu	unip-QQU<Imperativ<ViDem+LU
uneqquaallu	unip-QQU<Indikativ<DeHam+LU
uneqquassi	unip-QQU<Indikativ<JegJer
uneqquiuk	unip-QQU<Interrogativ<du-dem
uneqqullugu	unip-QQU<Ledsagemåde<ham
uneriarama	unip-RIAR<Causativ<jeg
unereerpit	unip-RIIR<Interrogativ<du
unereerlutik	unip-RIIR<Ledsagemåde<de_selv
unereertorartortiginuna	unip-RIIR+TUQ+GӘ+GIARTUR<Imperativ<ViDem+UNA
unissimasarama	unip+SIMA=TAR<Causativ<jeg
unittaraluarlutinguna	unip+TAR=GALUAR<Ledsagemåde<de_selv+UNA
unittaraluartussama	unip+TAR=GALUAR+TUQ-SSAQ<ental<min>Relativ
unittarlutik	unip+TAR<Ledsagemåde<de_selv
unittartungali	unip+TAR<Participium<jeg+LI
unittussalerivit	unip+TUQ-SSAQ-LIRI<Interrogativ<du
unittuunikka	unip+TUQ-U+NIQ<flertal<min<Absolut
unippallaarlutilli	unip+VALLAAR<Ledsagemåde<de_selv+LI
unippallaanngilanga	unip+VALLAAR=NNGIT<Indikativ<jeg
unippallaanngitsorlu	unip+VALLAAR=NNGIT<Participium<han+LU
unippallaanngitsunilu	unip+VALLAAR=NNGIT+TUQ<ental<sin<Absolut+LU
Upernavik	Upernavik<Absolut
Upernavilli	Upernavik<Absolut+LI
Upernavillu	Upernavik<Absolut+LU
Upernavinguna	Upernavik<Absolut+UNA
Upernavimmik	Upernavik<Instrumentalis
Upernavimmilli	Upernavik<Instrumentalis+LI
Upernavimmillu	Upernavik<Instrumentalis+LU
Upernavimminguna	Upernavik<Instrumentalis+UNA
Upernavimmi	Upernavik<Lokalis
Upernavimmiillutinguna	Upernavik<Lokalis+IP<Ledsagemåde<de_selv+UNA
Upernavimmiinnertorlu	Upernavik<Lokalis+IP+NIR<Participium<han+LU
Upernavimmeeqqugakku	Upernavik<Lokalis+IP-QQU<Causativ<JegHam
Upernavimmeeqquarali	Upernavik<Lokalis+IP-QQU<Indikativ<JegHam+LI
Upernavimmeeriarama	Upernavik<Lokalis+IP-RIAR<Causativ<jeg
Upernavimmeeriarpit	Upernavik<Lokalis+IP-RIAR<Interrogativ<du
Upernavimmeeriarneq	Upernavik<Lokalis+IP-RIAR+NIQ
Upernavimmeeriartununa	Upernavik<Lokalis+IP-RIAR<Participium<de+UNA
Upernavimmeeriartungali	Upernavik<Lokalis+IP-RIAR<Participium<jeg+LI
Upernavimmeeriartoqanngilaq	Upernavik<Lokalis+IP-RIAR+TUQ-QAR-NNGIT<Indikativ<han
Upernavimmeereerpit	Upernavik<Lokalis+IP-RIIR<Interrogativ<du
Upernavimmeereerlutilli	Upernavik<Lokalis+IP-RIIR<Ledsagemåde<de_selv+LI
Upernavimmeereerlutinguna	Upernavik<Lokalis+IP-RIIR<Ledsagemåde<de_selv+UNA
Upernavimmili	Upernavik<Lokalis+LI
Upernavimmiumi	Upernavik+MIU<ental<Lokalis
Upernavimmiumukanngillalli	Upernavik+MIU<ental<Terminalis-KAR-NNGIT<Indikativ<de+LI
Upernavimmiumukareerlutilli	Upernavik+MIU<ental<Terminalis-KAR-RIIR<Ledsagemåde<de_selv+LI
Upernavimmiuni	Upernavik+MIU<flertal<Lokalis
Upernavimmiuneeqquassilu	Upernavik+MIU<flertal<Lokalis+IP-QQU<Indikativ<JegJer+LU
Upernavimmiulerigamali	Upernavik+MIU-LIRI<Causativ<jeg+LI
Upernavimmiunngulaartunga	Upernavik+MIU-NNGUR-LAAR<Participium<jeg
Upernavimmiunngornerugamalu	Upernavik+MIU-NNGUR+NIRU<Causativ<jeg+LU
Upernavimmioqarpoq	Upernavik+MIU-QAR<Indikativ<han
Upernavimmioqarporli	Upernavik+MIU-QAR<Indikativ<han+LI
Upernavimmioqarnerli	Upernavik+MIU-QAR+NIQ+LI
Upernavimmioqartoq	Upernavik+MIU-QAR<Participium<han
Upernavimmioqartoq	Upernavik+MIU-QAR+TUQ
Upernavimmioqartorlu	Upernavik+MIU-QAR+TUQ+LU
Upernavimmiuuniarama	Upernavik+MIU-U+NIAR<Causativ<jeg
Upernavimmiuunikuusorli	Upernavik+MIU-U+NIKUU<Participium<han+LI
Upernavimmiooqqaarama	Upernavik+MIU-U-QQAAR<Causativ<jeg
Upernavimmiooqqaarpugut	Upernavik+MIU-U-QQAAR<Indikativ<vi
Upernavimmiooriaramaana	Upernavik+MIU-U-RIAR<Causativ<jeg+UNA
Upernavimmiooriarlunilu	Upernavik+MIU-U-RIAR<Ledsagemåde<han_selv+LU
Upernavimmiuusinnaasununa	Upernavik+MIU-U+SINNAA<Participium<de+UNA
Upernavimmiuusaraluarnerilli	Upernavik+MIU-U+TAR=GALUAR+NIQ<flertal<Relativ+LI
Upernavimmut	Upernavik<Terminalis
Upernavimmukalerneq	Upernavik<Terminalis-KAR-LIR+NIQ
Upernavimmukanngilatit	Upernavik<Terminalis-KAR-NNGIT<Interrogativ<du
Upernavimmukaqqaarneq	Upernavik<Terminalis-KAR-QQAAR+NIQ
Upernavimmukariartorlu	Upernavik<Terminalis-KAR-RIAR+TUQ+LU
Upernavimmukareernerli	Upernavik<Terminalis-KAR-RIIR+NIQ+LI
Upernavimmukassallutik	Upernavik<Terminalis-KAR-SSA<Ledsagemåde<de_selv
Upernavimmulli	Upernavik<Terminalis+LI
Upernavimmununa	Upernavik<Terminalis+UNA
Uummannaq	Uummannaq<Absolut
Uummannarli	Uummannaq<Absolut+LI
Uummannarlu	Uummannaq<Absolut+LU
Uummannaruna	Uummannaq<Absolut+UNA
Uummannamik	Uummannaq<Instrumentalis
Uummannamilli	Uummannaq<Instrumentalis+LI
Uummannamillu	Uummannaq<Instrumentalis+LU
Uummannaminguna	Uummannaq<Instrumentalis+UNA
Uummannami	Uummannaq<Lokalis
Uummannamiilerama	Uummannaq<Lokalis+IP-LIR<Causativ<jeg
Uummannameeqqaartoqarporli	Uummannaq<Lokalis+IP-QQAAR+TUQ-QAR<Indikativ<han+LI
Uummannameeqqutigit	Uummannaq<Lokalis+IP-QQU<Imperativ<ViDem
Uummannameeqqutigilli	Uummannaq<Lokalis+IP-QQU<Imperativ<ViDem+LI
Uummannameeriaramali	Uummannaq<Lokalis+IP-RIAR<Causativ<jeg+LI
Uummannameeriarneruna	Uummannaq<Lokalis+IP-RIAR+NIQ+UNA
Uummannameereerpungali	Uummannaq<Lokalis+IP-RIIR<Indikativ<jeg+LI
Uummannameereertoq	Uummannaq<Lokalis+IP-RIIR+TUQ
Uummannameereertoqarporlu	Uummannaq<Lokalis+IP-RIIR+TUQ-QAR<Indikativ<han+LU
Uummannamiissagaluartoqarporli	Uummannaq<Lokalis+IP-SSA=GALUAR+TUQ-QAR<Indikativ<han+LI
Uummannamili	Uummannaq<Lokalis+LI
Uummannarmiu	Uummannaq+MIU<ental<Absolut
Uummannarmiuminguna	Uummannaq+MIU<ental<Instrumentalis+UNA
Uummannarmiumiippit	Uummannaq+MIU<ental<Lokalis+IP<Interrogativ<du
Uummannarmiumullu	Uummannaq+MIU<ental<Terminalis+LU
Uummannarmiuneeqqaarneq	Uummannaq+MIU<flertal<Lokalis+IP-QQAAR+NIQ
Uummannarmiulerillutinguna	Uummannaq+MIU-LIRI<Ledsagemåde<de_selv+UNA
Uummannarmiunngorama	Uummannaq+MIU-NNGUR<Causativ<jeg
Uummannarmiunngulaarnerit	Uummannaq+MIU-NNGUR-LAAR+NIQ<flertal<Relativ
Uummannarmiunngunngilanga	Uummannaq+MIU-NNGUR-NNGIT<Indikativ<jeg
Uummannarmiunngussagaluarlutilli	Uummannaq+MIU-NNGUR-SSA=GALUAR<Ledsagemåde<de_selv+LI
Uummannarmioqarporli	Uummannaq+MIU-QAR<Indikativ<han+LI
Uummannarmioqarneq	Uummannaq+MIU-QAR+NIQ
Uummannarmioqarnerli	Uummannaq+MIU-QAR+NIQ+LI
Uummannarmioqarnerlu	Uummannaq+MIU-QAR+NIQ+LU
Uummannarmioqartoq	Uummannaq+MIU-QAR+TUQ
Uummannarmiuugaluarnikkalu	Uummannaq+MIU-U+GALUAR+NIQ<flertal<min<Absolut+LU
Uummannarmiuulerpoq	Uummannaq+MIU-U-LIR<Indikativ<han
Uummannarmiooriarama	Uummannaq+MIU-U-RIAR<Causativ<jeg
Uummannarmiuusaraluarporli	Uummannaq+MIU-U+TAR=GALUAR<Indikativ<han+LI
Uummannarmiuusoqanngitsorinerlugu	Uummannaq+MIU-U+TUQ-QAR-NNGIT+TUQ+GӘ+NIR<Ledsagemåde<ham
Uummannarmiuuallaanngilagulli	Uummannaq+MIU-U+VALLAAR=NNGIT<Indikativ<vi+LI
Uummannarmiuuallaanngitsunga	Uummannaq+MIU-U+VALLAAR=NNGIT<Participium<jeg
Uummannamut	Uummannaq<Terminalis
Uummannamukalaarnerli	Uummannaq<Terminalis-KAR-LAAR+NIQ+LI
Uummannamukalaartorli	Uummannaq<Terminalis-KAR-LAAR<Participium<han+LI
Uummannamukalaartartorli	Uummannaq<Terminalis-KAR-LAAR=TAR+TUQ+LI
Uummannamukanngitsorlu	Uummannaq<Terminalis-KAR-NNGIT<Participium<han+LU
Uummannamukareerama	Uummannaq<Terminalis-KAR-RIIR<Causativ<jeg
Uummannamulli	Uummannaq<Terminalis+LI
Uummannamullu	Uummannaq<Terminalis+LU
Uummannamununa	Uummannaq<Terminalis+UNA
