aasaq	aasaq<ental<Absolut
aasarluunniit	aasaq<ental<Absolut+LUUNNIIT
aasakkut	aasaq<ental<Vialis
aasakkulluunniit	aasaq<ental<Vialis+LUUNNIIT
aasama	aasaq<flertal<min>Relativ
aasamaluunniit	aasaq<flertal<min>Relativ+LUUNNIIT
aasakkut	aasaq-KKUT<flertal<Absolut
aasakkulluunniit	aasaq-KKUT<flertal<Absolut+LUUNNIIT
aasarsioratta	aasaq+SIUR<Causativ<vi
aasarsiorunnaaratta	aasaq+SIUR+GUNNAAR<Causativ<vi
aasarsiorporluunniit	aasaq+SIUR<Indikativ<han+LUUNNIIT
aasarsiorluarattaluunniit	aasaq+SIUR+LUAR<Causativ<vi+LUUNNIIT
aasarsiorluarporluunniit	aasaq+SIUR+LUAR<Indikativ<han+LUUNNIIT
aasarsiuippoq	aasaq+SIUR-VIP<Indikativ<han
aasartaaratta	aasaq+TAAR<Causativ<vi
aasartaarattaluunniit	aasaq+TAAR<Causativ<vi+LUUNNIIT
aasartaarunnaarattaluunniit	aasaq+TAAR+GUNNAAR<Causativ<vi+LUUNNIIT
aasartaarusuppoq	aasaq+TAAR+GUSUP<Indikativ<han
aasartaavimmataluunniit	aasaq+TAAR-VIP<Causativ<de+LUUNNIIT
aasartaavimmalluunniit	aasaq+TAAR-VIP<Causativ<han+LUUNNIIT
aasartaavikkatta	aasaq+TAAR-VIP<Causativ<vi
aasartaavippoq	aasaq+TAAR-VIP<Indikativ<han
aasartaavipporluunniit	aasaq+TAAR-VIP<Indikativ<han+LUUNNIIT
akueriunnaarpat	akuerә+GUNNAAR<Indikativ<DuHam
akueriunnaarpaa	akuerә+GUNNAAR<Indikativ<HanHam
akueriunnaarlaraluunniit	akuerә+GUNNAAR<Optativ<JegHam+LUUNNIIT
akuererusuppat	akuerә+GUSUP<Indikativ<DuHam
akuererusuppalluunniit	akuerә+GUSUP<Indikativ<DuHam+LUUNNIIT
akuererusuppaa	akuerә+GUSUP<Indikativ<HanHam
akuererusuppaaluunniit	akuerә+GUSUP<Indikativ<HanHam+LUUNNIIT
akuererusullara	akuerә+GUSUP<Optativ<JegHam
akuererusullaraluunniit	akuerә+GUSUP<Optativ<JegHam+LUUNNIIT
akuerivat	akuerә<Indikativ<DuHam
akuerivalluunniit	akuerә<Indikativ<DuHam+LUUNNIIT
akuerivaa	akuerә<Indikativ<HanHam
akuerivaaluunniit	akuerә<Indikativ<HanHam+LUUNNIIT
akuerilluarpat	akuerә+LUAR<Indikativ<DuHam
akuerilluarpalluunniit	akuerә+LUAR<Indikativ<DuHam+LUUNNIIT
akuerilluarpaa	akuerә+LUAR<Indikativ<HanHam
akuerilluarpaaluunniit	akuerә+LUAR<Indikativ<HanHam+LUUNNIIT
akuerilluarlara	akuerә+LUAR<Optativ<JegHam
akuerilluarlaraluunniit	akuerә+LUAR<Optativ<JegHam+LUUNNIIT
akuerilara	akuerә<Optativ<JegHam
akuerilaraluunniit	akuerә<Optativ<JegHam+LUUNNIIT
akuerivippat	akuerә-VIP<Indikativ<DuHam
akuerivippalluunniit	akuerә-VIP<Indikativ<DuHam+LUUNNIIT
akuerivippaa	akuerә-VIP<Indikativ<HanHam
akuerivippaaluunniit	akuerә-VIP<Indikativ<HanHam+LUUNNIIT
akuerivillara	akuerә-VIP<Optativ<JegHam
akuerivillaraluunniit	akuerә-VIP<Optativ<JegHam+LUUNNIIT
alla	alla<ental<Absolut
allaluunniit	alla<ental<Absolut+LUUNNIIT
allakkut	alla<ental<Vialis
allakkulluunniit	alla<ental<Vialis+LUUNNIIT
allama	alla<flertal<min>Relativ
allamaluunniit	alla<flertal<min>Relativ+LUUNNIIT
allakkut	alla-KKUT<flertal<Absolut
allakkulluunniit	alla-KKUT<flertal<Absolut+LUUNNIIT
allasiorusummataluunniit	alla+SIUR+GUSUP<Causativ<de+LUUNNIIT
allasiorusukkatta	alla+SIUR+GUSUP<Causativ<vi
allasiorusukkattaluunniit	alla+SIUR+GUSUP<Causativ<vi+LUUNNIIT
allasiorpoq	alla+SIUR<Indikativ<han
allasiorluaratta	alla+SIUR+LUAR<Causativ<vi
allasiorluarattaluunniit	alla+SIUR+LUAR<Causativ<vi+LUUNNIIT
allasiorluarpoq	alla+SIUR+LUAR<Indikativ<han
allasiuimmata	alla+SIUR-VIP<Causativ<de
allasiuimmataluunniit	alla+SIUR-VIP<Causativ<de+LUUNNIIT
allasiuimmat	alla+SIUR-VIP<Causativ<han
allasiuimmalluunniit	alla+SIUR-VIP<Causativ<han+LUUNNIIT
allasiuikkattaluunniit	alla+SIUR-VIP<Causativ<vi+LUUNNIIT
allasiuippoq	alla+SIUR-VIP<Indikativ<han
allasiuipporluunniit	alla+SIUR-VIP<Indikativ<han+LUUNNIIT
allataarmata	alla+TAAR<Causativ<de
allataarunnaarmata	alla+TAAR+GUNNAAR<Causativ<de
allataarunnaaratta	alla+TAAR+GUNNAAR<Causativ<vi
allataarunnaarattaluunniit	alla+TAAR+GUNNAAR<Causativ<vi+LUUNNIIT
allataarusummata	alla+TAAR+GUSUP<Causativ<de
allataarusummat	alla+TAAR+GUSUP<Causativ<han
allataarusukkattaluunniit	alla+TAAR+GUSUP<Causativ<vi+LUUNNIIT
allataarluarmata	alla+TAAR+LUAR<Causativ<de
allataarluarmataluunniit	alla+TAAR+LUAR<Causativ<de+LUUNNIIT
allataarluarpoq	alla+TAAR+LUAR<Indikativ<han
allataarluarporluunniit	alla+TAAR+LUAR<Indikativ<han+LUUNNIIT
allataavimmata	alla+TAAR-VIP<Causativ<de
allataavikkatta	alla+TAAR-VIP<Causativ<vi
allataavippoq	alla+TAAR-VIP<Indikativ<han
allataavipporluunniit	alla+TAAR-VIP<Indikativ<han+LUUNNIIT
angajoqqaaq	angajoqqaaq<ental<Absolut
angajoqqaarluunniit	angajoqqaaq<ental<Absolut+LUUNNIIT
angajoqqaakkut	angajoqqaaq<ental<Vialis
angajoqqaakkulluunniit	angajoqqaaq<ental<Vialis+LUUNNIIT
angajoqqaama	angajoqqaaq<flertal<min>Relativ
angajoqqaamaluunniit	angajoqqaaq<flertal<min>Relativ+LUUNNIIT
angajoqqaakkut	angajoqqaaq-KKUT<flertal<Absolut
angajoqqaakkulluunniit	angajoqqaaq-KKUT<flertal<Absolut+LUUNNIIT
angajoqqaarsioratta	angajoqqaaq+SIUR<Causativ<vi
angajoqqaarsiorattaluunniit	angajoqqaaq+SIUR<Causativ<vi+LUUNNIIT
angajoqqaarsiorunnaaratta	angajoqqaaq+SIUR+GUNNAAR<Causativ<vi
angajoqqaarsiorunnaarporluunniit	angajoqqaaq+SIUR+GUNNAAR<Indikativ<han+LUUNNIIT
angajoqqaarsiorusuppoq	angajoqqaaq+SIUR+GUSUP<Indikativ<han
angajoqqaarsiorpoq	angajoqqaaq+SIUR<Indikativ<han
angajoqqaarsiorluarporluunniit	angajoqqaaq+SIUR+LUAR<Indikativ<han+LUUNNIIT
angajoqqaarsiuimmata	angajoqqaaq+SIUR-VIP<Causativ<de
angajoqqaarsiuimmataluunniit	angajoqqaaq+SIUR-VIP<Causativ<de+LUUNNIIT
angajoqqaarsiuimmalluunniit	angajoqqaaq+SIUR-VIP<Causativ<han+LUUNNIIT
angajoqqaarsiuikkatta	angajoqqaaq+SIUR-VIP<Causativ<vi
angajoqqaarsiuikkattaluunniit	angajoqqaaq+SIUR-VIP<Causativ<vi+LUUNNIIT
angajoqqaarsiuippoq	angajoqqaaq+SIUR-VIP<Indikativ<han
angajoqqaartaaratta	angajoqqaaq+TAAR<Causativ<vi
angajoqqaartaarunnaarmataluunniit	angajoqqaaq+TAAR+GUNNAAR<Causativ<de+LUUNNIIT
angajoqqaartaarunnaarmalluunniit	angajoqqaaq+TAAR+GUNNAAR<Causativ<han+LUUNNIIT
angajoqqaartaarunnaaratta	angajoqqaaq+TAAR+GUNNAAR<Causativ<vi
angajoqqaartaarunnaarporluunniit	angajoqqaaq+TAAR+GUNNAAR<Indikativ<han+LUUNNIIT
angajoqqaartaarporluunniit	angajoqqaaq+TAAR<Indikativ<han+LUUNNIIT
angajoqqaartaarluarporluunniit	angajoqqaaq+TAAR+LUAR<Indikativ<han+LUUNNIIT
angajoqqaartaavimmat	angajoqqaaq+TAAR-VIP<Causativ<han
angajoqqaartaavikkatta	angajoqqaaq+TAAR-VIP<Causativ<vi
angajoqqaartaavikkattaluunniit	angajoqqaaq+TAAR-VIP<Causativ<vi+LUUNNIIT
angajoqqaartaavippoq	angajoqqaaq+TAAR-VIP<Indikativ<han
angajoqqaartaavipporluunniit	angajoqqaaq+TAAR-VIP<Indikativ<han+LUUNNIIT
assut	assut<Partikel
assulluunniit	assut<Partikel+LUUNNIIT
atassut	atassut<ental<Absolut
atassulluunniit	atassut<ental<Absolut+LUUNNIIT
atassutima	atassut<flertal<min>Relativ
atassutimaluunniit	atassut<flertal<min>Relativ+LUUNNIIT
atassutikkut	atassut-KKUT<flertal<Absolut
atassutikkulluunniit	atassut-KKUT<flertal<Absolut+LUUNNIIT
atassutisiormat	atassut+SIUR<Causativ<han
atassutisiorunnaarmata	atassut+SIUR+GUNNAAR<Causativ<de
atassutisiorunnaarmalluunniit	atassut+SIUR+GUNNAAR<Causativ<han+LUUNNIIT
atassutisiorunnaarpoq	atassut+SIUR+GUNNAAR<Indikativ<han
atassutisiorluarmataluunniit	atassut+SIUR+LUAR<Causativ<de+LUUNNIIT
atassutisiuimmat	atassut+SIUR-VIP<Causativ<han
atassutisiuimmalluunniit	atassut+SIUR-VIP<Causativ<han+LUUNNIIT
atassutisiuikkatta	atassut+SIUR-VIP<Causativ<vi
atassutisiuikkattaluunniit	atassut+SIUR-VIP<Causativ<vi+LUUNNIIT
atassutisiuipporluunniit	atassut+SIUR-VIP<Indikativ<han+LUUNNIIT
atassutitaarunnaarmata	atassut+TAAR+GUNNAAR<Causativ<de
atassutitaarunnaarmat	atassut+TAAR+GUNNAAR<Causativ<han
atassutitaarusuppoq	atassut+TAAR+GUSUP<Indikativ<han
atassutitaarluaratta	atassut+TAAR+LUAR<Causativ<vi
atassutitaarluarporluunniit	atassut+TAAR+LUAR<Indikativ<han+LUUNNIIT
atassutitaavikkatta	atassut+TAAR-VIP<Causativ<vi
atassutitaavikkattaluunniit	atassut+TAAR-VIP<Causativ<vi+LUUNNIIT
atassutitaavipporluunniit	atassut+TAAR-VIP<Indikativ<han+LUUNNIIT
avimmata	avip<Causativ<de
avimmataluunniit	avip<Causativ<de+LUUNNIIT
avikkatta	avip<Causativ<vi
avikkattaluunniit	avip<Causativ<vi+LUUNNIIT
avikkunnaarattaluunniit	avip+GUNNAAR<Causativ<vi+LUUNNIIT
avikkunnaarput	avip+GUNNAAR<Indikativ<de
avikkunnaarpulluunniit	avip+GUNNAAR<Indikativ<de+LUUNNIIT
avikkusummata	avip+GUSUP<Causativ<de
avikkusukkatta	avip+GUSUP<Causativ<vi
avipput	avip<Indikativ<de
avippulluunniit	avip<Indikativ<de+LUUNNIIT
avilluarmata	avip+LUAR<Causativ<de
avilluarmataluunniit	avip+LUAR<Causativ<de+LUUNNIIT
avilluaratta	avip+LUAR<Causativ<vi
avilluarput	avip+LUAR<Indikativ<de
avilluarpulluunniit	avip+LUAR<Indikativ<de+LUUNNIIT
avivimmataluunniit	avip-VIP<Causativ<de+LUUNNIIT
avivikkatta	avip-VIP<Causativ<vi
avivipput	avip-VIP<Indikativ<de
avivippulluunniit	avip-VIP<Indikativ<de+LUUNNIIT
erniinnaq	erniinnaq<Partikel
erniinnarluunniit	erniinnaq<Partikel+LUUNNIIT
fiistermata	fiister<Causativ<de
fiistermataluunniit	fiister<Causativ<de+LUUNNIIT
fiistermat	fiister<Causativ<han
fiistermalluunniit	fiister<Causativ<han+LUUNNIIT
fiisteratta	fiister<Causativ<vi
fiisterattaluunniit	fiister<Causativ<vi+LUUNNIIT
fiisterunnaarmata	fiister+GUNNAAR<Causativ<de
fiisterunnaarmataluunniit	fiister+GUNNAAR<Causativ<de+LUUNNIIT
fiisterunnaarmat	fiister+GUNNAAR<Causativ<han
fiisterunnaarmalluunniit	fiister+GUNNAAR<Causativ<han+LUUNNIIT
fiisterunnaaratta	fiister+GUNNAAR<Causativ<vi
fiisterunnaarattaluunniit	fiister+GUNNAAR<Causativ<vi+LUUNNIIT
fiisterunnaarpoq	fiister+GUNNAAR<Indikativ<han
fiisterunnaarporluunniit	fiister+GUNNAAR<Indikativ<han+LUUNNIIT
fiisterusummata	fiister+GUSUP<Causativ<de
fiisterusummataluunniit	fiister+GUSUP<Causativ<de+LUUNNIIT
fiisterusummat	fiister+GUSUP<Causativ<han
fiisterusummalluunniit	fiister+GUSUP<Causativ<han+LUUNNIIT
fiisterusukkatta	fiister+GUSUP<Causativ<vi
fiisterusukkattaluunniit	fiister+GUSUP<Causativ<vi+LUUNNIIT
fiisterusuppoq	fiister+GUSUP<Indikativ<han
fiisterusupporluunniit	fiister+GUSUP<Indikativ<han+LUUNNIIT
fiisterpoq	fiister<Indikativ<han
fiisterporluunniit	fiister<Indikativ<han+LUUNNIIT
fiisterluarmata	fiister+LUAR<Causativ<de
fiisterluarmataluunniit	fiister+LUAR<Causativ<de+LUUNNIIT
fiisterluarmat	fiister+LUAR<Causativ<han
fiisterluarmalluunniit	fiister+LUAR<Causativ<han+LUUNNIIT
fiisterluaratta	fiister+LUAR<Causativ<vi
fiisterluarattaluunniit	fiister+LUAR<Causativ<vi+LUUNNIIT
fiisterluarpoq	fiister+LUAR<Indikativ<han
fiisterluarporluunniit	fiister+LUAR<Indikativ<han+LUUNNIIT
fiistivimmata	fiister-VIP<Causativ<de
fiistivimmataluunniit	fiister-VIP<Causativ<de+LUUNNIIT
fiistivimmat	fiister-VIP<Causativ<han
fiistivimmalluunniit	fiister-VIP<Causativ<han+LUUNNIIT
fiistivikkatta	fiister-VIP<Causativ<vi
fiistivikkattaluunniit	fiister-VIP<Causativ<vi+LUUNNIIT
fiistivippoq	fiister-VIP<Indikativ<han
fiistivipporluunniit	fiister-VIP<Indikativ<han+LUUNNIIT
guitarermata	guitarer<Causativ<de
guitarermataluunniit	guitarer<Causativ<de+LUUNNIIT
guitarermat	guitarer<Causativ<han
guitarermalluunniit	guitarer<Causativ<han+LUUNNIIT
guitareratta	guitarer<Causativ<vi
guitarerattaluunniit	guitarer<Causativ<vi+LUUNNIIT
guitarerunnaarmata	guitarer+GUNNAAR<Causativ<de
guitarerunnaarmataluunniit	guitarer+GUNNAAR<Causativ<de+LUUNNIIT
guitarerunnaarmat	guitarer+GUNNAAR<Causativ<han
guitarerunnaarmalluunniit	guitarer+GUNNAAR<Causativ<han+LUUNNIIT
guitarerunnaaratta	guitarer+GUNNAAR<Causativ<vi
guitarerunnaarattaluunniit	guitarer+GUNNAAR<Causativ<vi+LUUNNIIT
guitarerunnaarpoq	guitarer+GUNNAAR<Indikativ<han
guitarerunnaarporluunniit	guitarer+GUNNAAR<Indikativ<han+LUUNNIIT
guitarerusummata	guitarer+GUSUP<Causativ<de
guitarerusummataluunniit	guitarer+GUSUP<Causativ<de+LUUNNIIT
guitarerusummalluunniit	guitarer+GUSUP<Causativ<han+LUUNNIIT
guitarerusukkatta	guitarer+GUSUP<Causativ<vi
guitarerusukkattaluunniit	guitarer+GUSUP<Causativ<vi+LUUNNIIT
guitarerusuppoq	guitarer+GUSUP<Indikativ<han
guitarerusupporluunniit	guitarer+GUSUP<Indikativ<han+LUUNNIIT
guitarerpoq	guitarer<Indikativ<han
guitarerporluunniit	guitarer<Indikativ<han+LUUNNIIT
guitarerluarmata	guitarer+LUAR<Causativ<de
guitarerluarmataluunniit	guitarer+LUAR<Causativ<de+LUUNNIIT
guitarerluarmat	guitarer+LUAR<Causativ<han
guitarerluarmalluunniit	guitarer+LUAR<Causativ<han+LUUNNIIT
guitarerluaratta	guitarer+LUAR<Causativ<vi
guitarerluarattaluunniit	guitarer+LUAR<Causativ<vi+LUUNNIIT
guitarerluarpoq	guitarer+LUAR<Indikativ<han
guitarerluarporluunniit	guitarer+LUAR<Indikativ<han+LUUNNIIT
guitarivimmata	guitarer-VIP<Causativ<de
guitarivimmataluunniit	guitarer-VIP<Causativ<de+LUUNNIIT
guitarivimmat	guitarer-VIP<Causativ<han
guitarivimmalluunniit	guitarer-VIP<Causativ<han+LUUNNIIT
guitarivikkatta	guitarer-VIP<Causativ<vi
guitarivikkattaluunniit	guitarer-VIP<Causativ<vi+LUUNNIIT
guitarivippoq	guitarer-VIP<Indikativ<han
guitarivipporluunniit	guitarer-VIP<Indikativ<han+LUUNNIIT
ikiorti	ikiurtә<ental<Absolut
ikiortiluunniit	ikiurtә<ental<Absolut+LUUNNIIT
ikiortikkut	ikiurtә<ental<Vialis
ikiortikkulluunniit	ikiurtә<ental<Vialis+LUUNNIIT
ikiortima	ikiurtә<flertal<min>Relativ
ikiortimaluunniit	ikiurtә<flertal<min>Relativ+LUUNNIIT
ikiortikkut	ikiurtә-KKUT<flertal<Absolut
ikiortikkulluunniit	ikiurtә-KKUT<flertal<Absolut+LUUNNIIT
ikiortisiormata	ikiurtә+SIUR<Causativ<de
ikiortisiormalluunniit	ikiurtә+SIUR<Causativ<han+LUUNNIIT
ikiortisioratta	ikiurtә+SIUR<Causativ<vi
ikiortisiorattaluunniit	ikiurtә+SIUR<Causativ<vi+LUUNNIIT
ikiortisiorunnaaratta	ikiurtә+SIUR+GUNNAAR<Causativ<vi
ikiortisiorunnaarpoq	ikiurtә+SIUR+GUNNAAR<Indikativ<han
ikiortisiorusummalluunniit	ikiurtә+SIUR+GUSUP<Causativ<han+LUUNNIIT
ikiortisiorusuppoq	ikiurtә+SIUR+GUSUP<Indikativ<han
ikiortisiorusupporluunniit	ikiurtә+SIUR+GUSUP<Indikativ<han+LUUNNIIT
ikiortisiorluarporluunniit	ikiurtә+SIUR+LUAR<Indikativ<han+LUUNNIIT
ikiortisiuimmata	ikiurtә+SIUR-VIP<Causativ<de
ikiortisiuimmataluunniit	ikiurtә+SIUR-VIP<Causativ<de+LUUNNIIT
ikiortisiuimmalluunniit	ikiurtә+SIUR-VIP<Causativ<han+LUUNNIIT
ikiortisiuikkatta	ikiurtә+SIUR-VIP<Causativ<vi
ikiortisiuikkattaluunniit	ikiurtә+SIUR-VIP<Causativ<vi+LUUNNIIT
ikiortisiuippoq	ikiurtә+SIUR-VIP<Indikativ<han
ikiortisiuipporluunniit	ikiurtә+SIUR-VIP<Indikativ<han+LUUNNIIT
ikiortitaaratta	ikiurtә+TAAR<Causativ<vi
ikiortitaarunnaarmalluunniit	ikiurtә+TAAR+GUNNAAR<Causativ<han+LUUNNIIT
ikiortitaarunnaarattaluunniit	ikiurtә+TAAR+GUNNAAR<Causativ<vi+LUUNNIIT
ikiortitaarunnaarporluunniit	ikiurtә+TAAR+GUNNAAR<Indikativ<han+LUUNNIIT
ikiortitaarusummata	ikiurtә+TAAR+GUSUP<Causativ<de
ikiortitaarusukkattaluunniit	ikiurtә+TAAR+GUSUP<Causativ<vi+LUUNNIIT
ikiortitaarpoq	ikiurtә+TAAR<Indikativ<han
ikiortitaarluaratta	ikiurtә+TAAR+LUAR<Causativ<vi
ikiortitaarluarporluunniit	ikiurtә+TAAR+LUAR<Indikativ<han+LUUNNIIT
ikiortitaavimmataluunniit	ikiurtә+TAAR-VIP<Causativ<de+LUUNNIIT
ikiortitaavimmat	ikiurtә+TAAR-VIP<Causativ<han
ikiortitaavimmalluunniit	ikiurtә+TAAR-VIP<Causativ<han+LUUNNIIT
ikiortitaavikkatta	ikiurtә+TAAR-VIP<Causativ<vi
ikiortitaavipporluunniit	ikiurtә+TAAR-VIP<Indikativ<han+LUUNNIIT
illoqarfik	illoqarfik<ental<Absolut
illoqarfilluunniit	illoqarfik<ental<Absolut+LUUNNIIT
illoqarfikkut	illoqarfik<ental<Vialis
illoqarfikkulluunniit	illoqarfik<ental<Vialis+LUUNNIIT
illoqarfima	illoqarfik<flertal<min>Relativ
illoqarfimaluunniit	illoqarfik<flertal<min>Relativ+LUUNNIIT
illoqarfikkut	illoqarfik-KKUT<flertal<Absolut
illoqarfikkulluunniit	illoqarfik-KKUT<flertal<Absolut+LUUNNIIT
illoqarfissiormalluunniit	illoqarfik+SIUR<Causativ<han+LUUNNIIT
illoqarfissioratta	illoqarfik+SIUR<Causativ<vi
illoqarfissiorunnaarmalluunniit	illoqarfik+SIUR+GUNNAAR<Causativ<han+LUUNNIIT
illoqarfissiorunnaaratta	illoqarfik+SIUR+GUNNAAR<Causativ<vi
illoqarfissiorunnaarporluunniit	illoqarfik+SIUR+GUNNAAR<Indikativ<han+LUUNNIIT
illoqarfissiorusummat	illoqarfik+SIUR+GUSUP<Causativ<han
illoqarfissiorusukkatta	illoqarfik+SIUR+GUSUP<Causativ<vi
illoqarfissiorusukkattaluunniit	illoqarfik+SIUR+GUSUP<Causativ<vi+LUUNNIIT
illoqarfissiorpoq	illoqarfik+SIUR<Indikativ<han
illoqarfissiorporluunniit	illoqarfik+SIUR<Indikativ<han+LUUNNIIT
illoqarfissiorluarmata	illoqarfik+SIUR+LUAR<Causativ<de
illoqarfissiorluarpoq	illoqarfik+SIUR+LUAR<Indikativ<han
illoqarfissiorluarporluunniit	illoqarfik+SIUR+LUAR<Indikativ<han+LUUNNIIT
illoqarfissiuimmataluunniit	illoqarfik+SIUR-VIP<Causativ<de+LUUNNIIT
illoqarfissiuimmat	illoqarfik+SIUR-VIP<Causativ<han
illoqarfissiuimmalluunniit	illoqarfik+SIUR-VIP<Causativ<han+LUUNNIIT
illoqarfissiuikkatta	illoqarfik+SIUR-VIP<Causativ<vi
illoqarfissiuippoq	illoqarfik+SIUR-VIP<Indikativ<han
illoqarfissiuipporluunniit	illoqarfik+SIUR-VIP<Indikativ<han+LUUNNIIT
illoqarfittaarmata	illoqarfik+TAAR<Causativ<de
illoqarfittaarmataluunniit	illoqarfik+TAAR<Causativ<de+LUUNNIIT
illoqarfittaarmalluunniit	illoqarfik+TAAR<Causativ<han+LUUNNIIT
illoqarfittaaratta	illoqarfik+TAAR<Causativ<vi
illoqarfittaarattaluunniit	illoqarfik+TAAR<Causativ<vi+LUUNNIIT
illoqarfittaarunnaarmata	illoqarfik+TAAR+GUNNAAR<Causativ<de
illoqarfittaarunnaarmat	illoqarfik+TAAR+GUNNAAR<Causativ<han
illoqarfittaarunnaarmalluunniit	illoqarfik+TAAR+GUNNAAR<Causativ<han+LUUNNIIT
illoqarfittaarusummata	illoqarfik+TAAR+GUSUP<Causativ<de
illoqarfittaarusummalluunniit	illoqarfik+TAAR+GUSUP<Causativ<han+LUUNNIIT
illoqarfittaarusukkatta	illoqarfik+TAAR+GUSUP<Causativ<vi
illoqarfittaarusukkattaluunniit	illoqarfik+TAAR+GUSUP<Causativ<vi+LUUNNIIT
illoqarfittaarusuppoq	illoqarfik+TAAR+GUSUP<Indikativ<han
illoqarfittaarpoq	illoqarfik+TAAR<Indikativ<han
illoqarfittaarporluunniit	illoqarfik+TAAR<Indikativ<han+LUUNNIIT
illoqarfittaarluarmataluunniit	illoqarfik+TAAR+LUAR<Causativ<de+LUUNNIIT
illoqarfittaarluarmat	illoqarfik+TAAR+LUAR<Causativ<han
illoqarfittaarluaratta	illoqarfik+TAAR+LUAR<Causativ<vi
illoqarfittaarluarpoq	illoqarfik+TAAR+LUAR<Indikativ<han
illoqarfittaavimmataluunniit	illoqarfik+TAAR-VIP<Causativ<de+LUUNNIIT
illoqarfittaavikkatta	illoqarfik+TAAR-VIP<Causativ<vi
illoqarfittaavikkattaluunniit	illoqarfik+TAAR-VIP<Causativ<vi+LUUNNIIT
illoqarfittaavippoq	illoqarfik+TAAR-VIP<Indikativ<han
illoqarfittaavipporluunniit	illoqarfik+TAAR-VIP<Indikativ<han+LUUNNIIT
imatut	imatut<Partikel
imatulluunniit	imatut<Partikel+LUUNNIIT
imermata	imer<Causativ<de
imermat	imer<Causativ<han
imermalluunniit	imer<Causativ<han+LUUNNIIT
imeratta	imer<Causativ<vi
imerattaluunniit	imer<Causativ<vi+LUUNNIIT
imerunnaarmataluunniit	imer+GUNNAAR<Causativ<de+LUUNNIIT
imerunnaaratta	imer+GUNNAAR<Causativ<vi
imerunnaarattaluunniit	imer+GUNNAAR<Causativ<vi+LUUNNIIT
imerunnaarporluunniit	imer+GUNNAAR<Indikativ<han+LUUNNIIT
imerusummataluunniit	imer+GUSUP<Causativ<de+LUUNNIIT
imerusummat	imer+GUSUP<Causativ<han
imerusukkatta	imer+GUSUP<Causativ<vi
imerusukkattaluunniit	imer+GUSUP<Causativ<vi+LUUNNIIT
imerusuppoq	imer+GUSUP<Indikativ<han
imerusupporluunniit	imer+GUSUP<Indikativ<han+LUUNNIIT
imerpoq	imer<Indikativ<han
imerluarmataluunniit	imer+LUAR<Causativ<de+LUUNNIIT
imerluarmat	imer+LUAR<Causativ<han
imerluaratta	imer+LUAR<Causativ<vi
imerluarpoq	imer+LUAR<Indikativ<han
imivimmata	imer-VIP<Causativ<de
imivimmataluunniit	imer-VIP<Causativ<de+LUUNNIIT
imivimmat	imer-VIP<Causativ<han
imivimmalluunniit	imer-VIP<Causativ<han+LUUNNIIT
imivikkatta	imer-VIP<Causativ<vi
imivikkattaluunniit	imer-VIP<Causativ<vi+LUUNNIIT
imivippoq	imer-VIP<Indikativ<han
imivipporluunniit	imer-VIP<Indikativ<han+LUUNNIIT
immaqa	immaqa<Partikel
immaqaluunniit	immaqa<Partikel+LUUNNIIT
inersimasoq	inersimasoq<ental<Absolut
inersimasorluunniit	inersimasoq<ental<Absolut+LUUNNIIT
inersimasukkut	inersimasoq<ental<Vialis
inersimasukkulluunniit	inersimasoq<ental<Vialis+LUUNNIIT
inersimasukkut	inersimasoq-KKUT<flertal<Absolut
inersimasukkulluunniit	inersimasoq-KKUT<flertal<Absolut+LUUNNIIT
ingerlammat	ingerla<Causativ<han
ingerlammalluunniit	ingerla<Causativ<han+LUUNNIIT
ingerlagatta	ingerla<Causativ<vi
ingerlagattaluunniit	ingerla<Causativ<vi+LUUNNIIT
ingerlajunnaarmata	ingerla+GUNNAAR<Causativ<de
ingerlajunnaarmat	ingerla+GUNNAAR<Causativ<han
ingerlajunnaaratta	ingerla+GUNNAAR<Causativ<vi
ingerlajunnaarpoq	ingerla+GUNNAAR<Indikativ<han
ingerlajunnaarporluunniit	ingerla+GUNNAAR<Indikativ<han+LUUNNIIT
ingerlarusukkattaluunniit	ingerla+GUSUP<Causativ<vi+LUUNNIIT
ingerlarusupporluunniit	ingerla+GUSUP<Indikativ<han+LUUNNIIT
ingerlavoq	ingerla<Indikativ<han
ingerlalluaratta	ingerla+LUAR<Causativ<vi
ingerlalluarattaluunniit	ingerla+LUAR<Causativ<vi+LUUNNIIT
ingerlalluarpoq	ingerla+LUAR<Indikativ<han
ingerlavimmat	ingerla-VIP<Causativ<han
ingerlavimmalluunniit	ingerla-VIP<Causativ<han+LUUNNIIT
ingerlavikkatta	ingerla-VIP<Causativ<vi
ingerlavippoq	ingerla-VIP<Indikativ<han
inuttassarsiuussineq	inuttassarsiuussineq<ental<Absolut
inuttassarsiuussinerluunniit	inuttassarsiuussineq<ental<Absolut+LUUNNIIT
inuttassarsiuussinikkulluunniit	inuttassarsiuussineq<ental<Vialis+LUUNNIIT
inuttassarsiuussinima	inuttassarsiuussineq<flertal<min>Relativ
inuttassarsiuussinimaluunniit	inuttassarsiuussineq<flertal<min>Relativ+LUUNNIIT
inuttassarsiuussinikkulluunniit	inuttassarsiuussineq-KKUT<flertal<Absolut+LUUNNIIT
inuttassarsiuussinersiormataluunniit	inuttassarsiuussineq+SIUR<Causativ<de+LUUNNIIT
inuttassarsiuussinersiorluarporluunniit	inuttassarsiuussineq+SIUR+LUAR<Indikativ<han+LUUNNIIT
inuttassarsiuussinertaarusummat	inuttassarsiuussineq+TAAR+GUSUP<Causativ<han
inuummata	inuu<Causativ<de
inuummat	inuu<Causativ<han
inuugattaluunniit	inuu<Causativ<vi+LUUNNIIT
inuujunnaarmataluunniit	inuu+GUNNAAR<Causativ<de+LUUNNIIT
inuujunnaaratta	inuu+GUNNAAR<Causativ<vi
inuujunnaarattaluunniit	inuu+GUNNAAR<Causativ<vi+LUUNNIIT
inoorusummata	inuu+GUSUP<Causativ<de
inoorusummataluunniit	inuu+GUSUP<Causativ<de+LUUNNIIT
inoorusummat	inuu+GUSUP<Causativ<han
inoorusummalluunniit	inuu+GUSUP<Causativ<han+LUUNNIIT
inoorusukkatta	inuu+GUSUP<Causativ<vi
inoorusukkattaluunniit	inuu+GUSUP<Causativ<vi+LUUNNIIT
inoorusuppoq	inuu+GUSUP<Indikativ<han
inoorusupporluunniit	inuu+GUSUP<Indikativ<han+LUUNNIIT
inuuvoq	inuu<Indikativ<han
inuuvorluunniit	inuu<Indikativ<han+LUUNNIIT
inuulluarmataluunniit	inuu+LUAR<Causativ<de+LUUNNIIT
inuulluarmalluunniit	inuu+LUAR<Causativ<han+LUUNNIIT
inuulluarattaluunniit	inuu+LUAR<Causativ<vi+LUUNNIIT
inuulluarpoq	inuu+LUAR<Indikativ<han
inuulluarporluunniit	inuu+LUAR<Indikativ<han+LUUNNIIT
inuusuttoq	inuusuttoq<ental<Absolut
inuuimmata	inuu-VIP<Causativ<de
inuuimmataluunniit	inuu-VIP<Causativ<de+LUUNNIIT
kapitali	kapitali<ental<Absolut
kapitaliluunniit	kapitali<ental<Absolut+LUUNNIIT
kapitalikkut	kapitali<ental<Vialis
kapitalikkulluunniit	kapitali<ental<Vialis+LUUNNIIT
kapitalima	kapitali<flertal<min>Relativ
kapitalimaluunniit	kapitali<flertal<min>Relativ+LUUNNIIT
kapitalikkut	kapitali-KKUT<flertal<Absolut
kapitalikkulluunniit	kapitali-KKUT<flertal<Absolut+LUUNNIIT
kapitalisiormata	kapitali+SIUR<Causativ<de
kapitalisiormataluunniit	kapitali+SIUR<Causativ<de+LUUNNIIT
kapitalisiormat	kapitali+SIUR<Causativ<han
kapitalisiormalluunniit	kapitali+SIUR<Causativ<han+LUUNNIIT
kapitalisioratta	kapitali+SIUR<Causativ<vi
kapitalisiorattaluunniit	kapitali+SIUR<Causativ<vi+LUUNNIIT
kapitalisiorunnaarmata	kapitali+SIUR+GUNNAAR<Causativ<de
kapitalisiorunnaarmataluunniit	kapitali+SIUR+GUNNAAR<Causativ<de+LUUNNIIT
kapitalisiorunnaarmalluunniit	kapitali+SIUR+GUNNAAR<Causativ<han+LUUNNIIT
kapitalisiorunnaaratta	kapitali+SIUR+GUNNAAR<Causativ<vi
kapitalisiorunnaarattaluunniit	kapitali+SIUR+GUNNAAR<Causativ<vi+LUUNNIIT
kapitalisiorunnaarpoq	kapitali+SIUR+GUNNAAR<Indikativ<han
kapitalisiorunnaarporluunniit	kapitali+SIUR+GUNNAAR<Indikativ<han+LUUNNIIT
kapitalisiorusummata	kapitali+SIUR+GUSUP<Causativ<de
kapitalisiorusummataluunniit	kapitali+SIUR+GUSUP<Causativ<de+LUUNNIIT
kapitalisiorusummalluunniit	kapitali+SIUR+GUSUP<Causativ<han+LUUNNIIT
kapitalisiorusukkatta	kapitali+SIUR+GUSUP<Causativ<vi
kapitalisiorusukkattaluunniit	kapitali+SIUR+GUSUP<Causativ<vi+LUUNNIIT
kapitalisiorusuppoq	kapitali+SIUR+GUSUP<Indikativ<han
kapitalisiorusupporluunniit	kapitali+SIUR+GUSUP<Indikativ<han+LUUNNIIT
kapitalisiorpoq	kapitali+SIUR<Indikativ<han
kapitalisiorporluunniit	kapitali+SIUR<Indikativ<han+LUUNNIIT
kapitalisiorluarmata	kapitali+SIUR+LUAR<Causativ<de
kapitalisiorluarmat	kapitali+SIUR+LUAR<Causativ<han
kapitalisiorluarmalluunniit	kapitali+SIUR+LUAR<Causativ<han+LUUNNIIT
kapitalisiorluaratta	kapitali+SIUR+LUAR<Causativ<vi
kapitalisiorluarattaluunniit	kapitali+SIUR+LUAR<Causativ<vi+LUUNNIIT
kapitalisiorluarpoq	kapitali+SIUR+LUAR<Indikativ<han
kapitalisiorluarporluunniit	kapitali+SIUR+LUAR<Indikativ<han+LUUNNIIT
kapitalisiuimmata	kapitali+SIUR-VIP<Causativ<de
kapitalisiuimmataluunniit	kapitali+SIUR-VIP<Causativ<de+LUUNNIIT
kapitalisiuimmat	kapitali+SIUR-VIP<Causativ<han
kapitalisiuimmalluunniit	kapitali+SIUR-VIP<Causativ<han+LUUNNIIT
kapitalisiuikkatta	kapitali+SIUR-VIP<Causativ<vi
kapitalisiuikkattaluunniit	kapitali+SIUR-VIP<Causativ<vi+LUUNNIIT
kapitalisiuippoq	kapitali+SIUR-VIP<Indikativ<han
kapitalisiuipporluunniit	kapitali+SIUR-VIP<Indikativ<han+LUUNNIIT
kapitalitaarmata	kapitali+TAAR<Causativ<de
kapitalitaarmat	kapitali+TAAR<Causativ<han
kapitalitaarmalluunniit	kapitali+TAAR<Causativ<han+LUUNNIIT
kapitalitaaratta	kapitali+TAAR<Causativ<vi
kapitalitaarattaluunniit	kapitali+TAAR<Causativ<vi+LUUNNIIT
kapitalitaarunnaarmata	kapitali+TAAR+GUNNAAR<Causativ<de
kapitalitaarunnaarmataluunniit	kapitali+TAAR+GUNNAAR<Causativ<de+LUUNNIIT
kapitalitaarunnaarmalluunniit	kapitali+TAAR+GUNNAAR<Causativ<han+LUUNNIIT
kapitalitaarunnaaratta	kapitali+TAAR+GUNNAAR<Causativ<vi
kapitalitaarunnaarporluunniit	kapitali+TAAR+GUNNAAR<Indikativ<han+LUUNNIIT
kapitalitaarusummalluunniit	kapitali+TAAR+GUSUP<Causativ<han+LUUNNIIT
kapitalitaarusukkatta	kapitali+TAAR+GUSUP<Causativ<vi
kapitalitaarusukkattaluunniit	kapitali+TAAR+GUSUP<Causativ<vi+LUUNNIIT
kapitalitaarusuppoq	kapitali+TAAR+GUSUP<Indikativ<han
kapitalitaarusupporluunniit	kapitali+TAAR+GUSUP<Indikativ<han+LUUNNIIT
kapitalitaarpoq	kapitali+TAAR<Indikativ<han
kapitalitaarporluunniit	kapitali+TAAR<Indikativ<han+LUUNNIIT
kapitalitaarluarmataluunniit	kapitali+TAAR+LUAR<Causativ<de+LUUNNIIT
kapitalitaarluarattaluunniit	kapitali+TAAR+LUAR<Causativ<vi+LUUNNIIT
kapitalitaarluarporluunniit	kapitali+TAAR+LUAR<Indikativ<han+LUUNNIIT
kapitalitaavimmata	kapitali+TAAR-VIP<Causativ<de
kapitalitaavimmataluunniit	kapitali+TAAR-VIP<Causativ<de+LUUNNIIT
kapitalitaavimmat	kapitali+TAAR-VIP<Causativ<han
kapitalitaavimmalluunniit	kapitali+TAAR-VIP<Causativ<han+LUUNNIIT
kapitalitaavikkatta	kapitali+TAAR-VIP<Causativ<vi
kapitalitaavikkattaluunniit	kapitali+TAAR-VIP<Causativ<vi+LUUNNIIT
kapitalitaavippoq	kapitali+TAAR-VIP<Indikativ<han
kapitalitaavipporluunniit	kapitali+TAAR-VIP<Indikativ<han+LUUNNIIT
nalaa	nalә<Absolut<ental<hans
nalaaluunniit	nalә<Absolut<ental<hans+LUUNNIIT
nangikkunnaarpalluunniit	nangip+GUNNAAR<Indikativ<DuHam+LUUNNIIT
nangikkunnaarpaa	nangip+GUNNAAR<Indikativ<HanHam
nangikkunnaarpaaluunniit	nangip+GUNNAAR<Indikativ<HanHam+LUUNNIIT
nangikkunnaarlara	nangip+GUNNAAR<Optativ<JegHam
nangikkusuppalluunniit	nangip+GUSUP<Indikativ<DuHam+LUUNNIIT
nangikkusullaraluunniit	nangip+GUSUP<Optativ<JegHam+LUUNNIIT
nangippat	nangip<Indikativ<DuHam
nangippalluunniit	nangip<Indikativ<DuHam+LUUNNIIT
nangippaa	nangip<Indikativ<HanHam
nangilluarpat	nangip+LUAR<Indikativ<DuHam
nangilluarpalluunniit	nangip+LUAR<Indikativ<DuHam+LUUNNIIT
nangilluarpaa	nangip+LUAR<Indikativ<HanHam
nangilluarpaaluunniit	nangip+LUAR<Indikativ<HanHam+LUUNNIIT
nangilluarlara	nangip+LUAR<Optativ<JegHam
nangilluarlaraluunniit	nangip+LUAR<Optativ<JegHam+LUUNNIIT
nangillara	nangip<Optativ<JegHam
nangivippat	nangip-VIP<Indikativ<DuHam
nangivippalluunniit	nangip-VIP<Indikativ<DuHam+LUUNNIIT
nangivippaa	nangip-VIP<Indikativ<HanHam
nangivippaaluunniit	nangip-VIP<Indikativ<HanHam+LUUNNIIT
nangivillara	nangip-VIP<Optativ<JegHam
nangivillaraluunniit	nangip-VIP<Optativ<JegHam+LUUNNIIT
nassiussaq	nassiussaq<ental<Absolut
nassiussarluunniit	nassiussaq<ental<Absolut+LUUNNIIT
nassiussakkut	nassiussaq<ental<Vialis
nassiussakkulluunniit	nassiussaq<ental<Vialis+LUUNNIIT
nassiussama	nassiussaq<flertal<min>Relativ
nassiussamaluunniit	nassiussaq<flertal<min>Relativ+LUUNNIIT
nassiussakkut	nassiussaq-KKUT<flertal<Absolut
nassiussakkulluunniit	nassiussaq-KKUT<flertal<Absolut+LUUNNIIT
nassiussarsiormata	nassiussaq+SIUR<Causativ<de
nassiussarsiorunnaarmataluunniit	nassiussaq+SIUR+GUNNAAR<Causativ<de+LUUNNIIT
nassiussarsiorunnaarmalluunniit	nassiussaq+SIUR+GUNNAAR<Causativ<han+LUUNNIIT
nassiussarsiorpoq	nassiussaq+SIUR<Indikativ<han
nassiussarsiorluaratta	nassiussaq+SIUR+LUAR<Causativ<vi
nassiussarsiuimmataluunniit	nassiussaq+SIUR-VIP<Causativ<de+LUUNNIIT
nassiussarsiuikkatta	nassiussaq+SIUR-VIP<Causativ<vi
nassiussarsiuippoq	nassiussaq+SIUR-VIP<Indikativ<han
nassiussartaaratta	nassiussaq+TAAR<Causativ<vi
nassiussartaarunnaarporluunniit	nassiussaq+TAAR+GUNNAAR<Indikativ<han+LUUNNIIT
nassiussartaarusummata	nassiussaq+TAAR+GUSUP<Causativ<de
nassiussartaarusukkatta	nassiussaq+TAAR+GUSUP<Causativ<vi
nassiussartaarporluunniit	nassiussaq+TAAR<Indikativ<han+LUUNNIIT
nassiussartaarluarpoq	nassiussaq+TAAR+LUAR<Indikativ<han
nassiussartaavikkatta	nassiussaq+TAAR-VIP<Causativ<vi
nipilersormata	nipilersor<Causativ<de
nipilersormataluunniit	nipilersor<Causativ<de+LUUNNIIT
nipilersormat	nipilersor<Causativ<han
nipilersormalluunniit	nipilersor<Causativ<han+LUUNNIIT
nipilersoratta	nipilersor<Causativ<vi
nipilersorattaluunniit	nipilersor<Causativ<vi+LUUNNIIT
nipilersorunnaarmata	nipilersor+GUNNAAR<Causativ<de
nipilersorunnaarmataluunniit	nipilersor+GUNNAAR<Causativ<de+LUUNNIIT
nipilersorunnaarmat	nipilersor+GUNNAAR<Causativ<han
nipilersorunnaarmalluunniit	nipilersor+GUNNAAR<Causativ<han+LUUNNIIT
nipilersorunnaaratta	nipilersor+GUNNAAR<Causativ<vi
nipilersorunnaarattaluunniit	nipilersor+GUNNAAR<Causativ<vi+LUUNNIIT
nipilersorunnaarpoq	nipilersor+GUNNAAR<Indikativ<han
nipilersorunnaarporluunniit	nipilersor+GUNNAAR<Indikativ<han+LUUNNIIT
nipilersorusummata	nipilersor+GUSUP<Causativ<de
nipilersorusummataluunniit	nipilersor+GUSUP<Causativ<de+LUUNNIIT
nipilersorusummalluunniit	nipilersor+GUSUP<Causativ<han+LUUNNIIT
nipilersorusukkatta	nipilersor+GUSUP<Causativ<vi
nipilersorusukkattaluunniit	nipilersor+GUSUP<Causativ<vi+LUUNNIIT
nipilersorusuppoq	nipilersor+GUSUP<Indikativ<han
nipilersorusupporluunniit	nipilersor+GUSUP<Indikativ<han+LUUNNIIT
nipilersorpoq	nipilersor<Indikativ<han
nipilersorporluunniit	nipilersor<Indikativ<han+LUUNNIIT
nipilersorluarmata	nipilersor+LUAR<Causativ<de
nipilersorluarmataluunniit	nipilersor+LUAR<Causativ<de+LUUNNIIT
nipilersorluarmalluunniit	nipilersor+LUAR<Causativ<han+LUUNNIIT
nipilersorluarattaluunniit	nipilersor+LUAR<Causativ<vi+LUUNNIIT
nipilersorluarpoq	nipilersor+LUAR<Indikativ<han
nipilersorluarporluunniit	nipilersor+LUAR<Indikativ<han+LUUNNIIT
nipilersuimmata	nipilersor-VIP<Causativ<de
nipilersuimmataluunniit	nipilersor-VIP<Causativ<de+LUUNNIIT
nipilersuimmat	nipilersor-VIP<Causativ<han
nipilersuimmalluunniit	nipilersor-VIP<Causativ<han+LUUNNIIT
nipilersuikkatta	nipilersor-VIP<Causativ<vi
nipilersuikkattaluunniit	nipilersor-VIP<Causativ<vi+LUUNNIIT
nipilersuippoq	nipilersor-VIP<Indikativ<han
nipilersuipporluunniit	nipilersor-VIP<Indikativ<han+LUUNNIIT
oqaluttuariunnaarpat	oqaluttuarә+GUNNAAR<Indikativ<DuHam
oqaluttuariunnaarpalluunniit	oqaluttuarә+GUNNAAR<Indikativ<DuHam+LUUNNIIT
oqaluttuariunnaarpaa	oqaluttuarә+GUNNAAR<Indikativ<HanHam
oqaluttuariunnaarpaaluunniit	oqaluttuarә+GUNNAAR<Indikativ<HanHam+LUUNNIIT
oqaluttuariunnaarlara	oqaluttuarә+GUNNAAR<Optativ<JegHam
oqaluttuariunnaarlaraluunniit	oqaluttuarә+GUNNAAR<Optativ<JegHam+LUUNNIIT
oqaluttuarerusuppat	oqaluttuarә+GUSUP<Indikativ<DuHam
oqaluttuarerusuppalluunniit	oqaluttuarә+GUSUP<Indikativ<DuHam+LUUNNIIT
oqaluttuarerusuppaa	oqaluttuarә+GUSUP<Indikativ<HanHam
oqaluttuarerusuppaaluunniit	oqaluttuarә+GUSUP<Indikativ<HanHam+LUUNNIIT
oqaluttuarerusullara	oqaluttuarә+GUSUP<Optativ<JegHam
oqaluttuarerusullaraluunniit	oqaluttuarә+GUSUP<Optativ<JegHam+LUUNNIIT
oqaluttuarivat	oqaluttuarә<Indikativ<DuHam
oqaluttuarivalluunniit	oqaluttuarә<Indikativ<DuHam+LUUNNIIT
oqaluttuarivaa	oqaluttuarә<Indikativ<HanHam
oqaluttuarivaaluunniit	oqaluttuarә<Indikativ<HanHam+LUUNNIIT
oqaluttuarilluarpat	oqaluttuarә+LUAR<Indikativ<DuHam
oqaluttuarilluarpalluunniit	oqaluttuarә+LUAR<Indikativ<DuHam+LUUNNIIT
oqaluttuarilluarpaa	oqaluttuarә+LUAR<Indikativ<HanHam
oqaluttuarilluarpaaluunniit	oqaluttuarә+LUAR<Indikativ<HanHam+LUUNNIIT
oqaluttuarilluarlara	oqaluttuarә+LUAR<Optativ<JegHam
oqaluttuarilluarlaraluunniit	oqaluttuarә+LUAR<Optativ<JegHam+LUUNNIIT
oqaluttuarilara	oqaluttuarә<Optativ<JegHam
oqaluttuarilaraluunniit	oqaluttuarә<Optativ<JegHam+LUUNNIIT
oqaluttuarivippat	oqaluttuarә-VIP<Indikativ<DuHam
oqaluttuarivippalluunniit	oqaluttuarә-VIP<Indikativ<DuHam+LUUNNIIT
oqaluttuarivippaa	oqaluttuarә-VIP<Indikativ<HanHam
oqaluttuarivippaaluunniit	oqaluttuarә-VIP<Indikativ<HanHam+LUUNNIIT
oqaluttuarivillara	oqaluttuarә-VIP<Optativ<JegHam
oqaluttuarivillaraluunniit	oqaluttuarә-VIP<Optativ<JegHam+LUUNNIIT
panik	panik<ental<Absolut
panilluunniit	panik<ental<Absolut+LUUNNIIT
panikkut	panik<ental<Vialis
panikkulluunniit	panik<ental<Vialis+LUUNNIIT
panima	panik<flertal<min>Relativ
panimaluunniit	panik<flertal<min>Relativ+LUUNNIIT
panikkut	panik-KKUT<flertal<Absolut
panikkulluunniit	panik-KKUT<flertal<Absolut+LUUNNIIT
panissiormata	panik+SIUR<Causativ<de
panissiormat	panik+SIUR<Causativ<han
panissiormalluunniit	panik+SIUR<Causativ<han+LUUNNIIT
panissioratta	panik+SIUR<Causativ<vi
panissiorattaluunniit	panik+SIUR<Causativ<vi+LUUNNIIT
panissiorunnaarmata	panik+SIUR+GUNNAAR<Causativ<de
panissiorunnaarattaluunniit	panik+SIUR+GUNNAAR<Causativ<vi+LUUNNIIT
panissiorunnaarpoq	panik+SIUR+GUNNAAR<Indikativ<han
panissiorunnaarporluunniit	panik+SIUR+GUNNAAR<Indikativ<han+LUUNNIIT
panissiorusummataluunniit	panik+SIUR+GUSUP<Causativ<de+LUUNNIIT
panissiorusummat	panik+SIUR+GUSUP<Causativ<han
panissiorusukkatta	panik+SIUR+GUSUP<Causativ<vi
panissiorusukkattaluunniit	panik+SIUR+GUSUP<Causativ<vi+LUUNNIIT
panissiorpoq	panik+SIUR<Indikativ<han
panissiorporluunniit	panik+SIUR<Indikativ<han+LUUNNIIT
panissiorluarporluunniit	panik+SIUR+LUAR<Indikativ<han+LUUNNIIT
panissiuimmata	panik+SIUR-VIP<Causativ<de
panissiuimmataluunniit	panik+SIUR-VIP<Causativ<de+LUUNNIIT
panissiuimmat	panik+SIUR-VIP<Causativ<han
panissiuimmalluunniit	panik+SIUR-VIP<Causativ<han+LUUNNIIT
panissiuikkatta	panik+SIUR-VIP<Causativ<vi
panissiuikkattaluunniit	panik+SIUR-VIP<Causativ<vi+LUUNNIIT
panissiuippoq	panik+SIUR-VIP<Indikativ<han
panissiuipporluunniit	panik+SIUR-VIP<Indikativ<han+LUUNNIIT
panittaarmata	panik+TAAR<Causativ<de
panittaarmat	panik+TAAR<Causativ<han
panittaarmalluunniit	panik+TAAR<Causativ<han+LUUNNIIT
panittaarattaluunniit	panik+TAAR<Causativ<vi+LUUNNIIT
panittaarunnaarpoq	panik+TAAR+GUNNAAR<Indikativ<han
panittaarunnaarporluunniit	panik+TAAR+GUNNAAR<Indikativ<han+LUUNNIIT
panittaarusummata	panik+TAAR+GUSUP<Causativ<de
panittaarusummalluunniit	panik+TAAR+GUSUP<Causativ<han+LUUNNIIT
panittaarusukkatta	panik+TAAR+GUSUP<Causativ<vi
panittaarusukkattaluunniit	panik+TAAR+GUSUP<Causativ<vi+LUUNNIIT
panittaarusuppoq	panik+TAAR+GUSUP<Indikativ<han
panittaarusupporluunniit	panik+TAAR+GUSUP<Indikativ<han+LUUNNIIT
panittaarpoq	panik+TAAR<Indikativ<han
panittaarporluunniit	panik+TAAR<Indikativ<han+LUUNNIIT
panittaarluarmalluunniit	panik+TAAR+LUAR<Causativ<han+LUUNNIIT
panittaarluarporluunniit	panik+TAAR+LUAR<Indikativ<han+LUUNNIIT
panittaavimmata	panik+TAAR-VIP<Causativ<de
panittaavimmataluunniit	panik+TAAR-VIP<Causativ<de+LUUNNIIT
panittaavimmat	panik+TAAR-VIP<Causativ<han
panittaavimmalluunniit	panik+TAAR-VIP<Causativ<han+LUUNNIIT
panittaavikkatta	panik+TAAR-VIP<Causativ<vi
panittaavikkattaluunniit	panik+TAAR-VIP<Causativ<vi+LUUNNIIT
panittaavippoq	panik+TAAR-VIP<Indikativ<han
panittaavipporluunniit	panik+TAAR-VIP<Indikativ<han+LUUNNIIT
pissut	pissut<ental<Absolut
pissulluunniit	pissut<ental<Absolut+LUUNNIIT
pissutikkut	pissut<ental<Vialis
pissutikkulluunniit	pissut<ental<Vialis+LUUNNIIT
pissutima	pissut<flertal<min>Relativ
pissutimaluunniit	pissut<flertal<min>Relativ+LUUNNIIT
pissutikkut	pissut-KKUT<flertal<Absolut
pissutikkulluunniit	pissut-KKUT<flertal<Absolut+LUUNNIIT
pissutisiormataluunniit	pissut+SIUR<Causativ<de+LUUNNIIT
pissutisioratta	pissut+SIUR<Causativ<vi
pissutisiorattaluunniit	pissut+SIUR<Causativ<vi+LUUNNIIT
pissutisiorunnaarmata	pissut+SIUR+GUNNAAR<Causativ<de
pissutisiorunnaarmalluunniit	pissut+SIUR+GUNNAAR<Causativ<han+LUUNNIIT
pissutisiorunnaarpoq	pissut+SIUR+GUNNAAR<Indikativ<han
pissutisiorusummataluunniit	pissut+SIUR+GUSUP<Causativ<de+LUUNNIIT
pissutisiorusukkatta	pissut+SIUR+GUSUP<Causativ<vi
pissutisiorusupporluunniit	pissut+SIUR+GUSUP<Indikativ<han+LUUNNIIT
pissutisiorpoq	pissut+SIUR<Indikativ<han
pissutisiorluaratta	pissut+SIUR+LUAR<Causativ<vi
pissutisiuimmataluunniit	pissut+SIUR-VIP<Causativ<de+LUUNNIIT
pissutisiuimmat	pissut+SIUR-VIP<Causativ<han
pissutisiuimmalluunniit	pissut+SIUR-VIP<Causativ<han+LUUNNIIT
pissutisiuikkatta	pissut+SIUR-VIP<Causativ<vi
pissutisiuikkattaluunniit	pissut+SIUR-VIP<Causativ<vi+LUUNNIIT
pissutisiuippoq	pissut+SIUR-VIP<Indikativ<han
pissutisiuipporluunniit	pissut+SIUR-VIP<Indikativ<han+LUUNNIIT
pissutitaarmata	pissut+TAAR<Causativ<de
pissutitaarmataluunniit	pissut+TAAR<Causativ<de+LUUNNIIT
pissutitaarmalluunniit	pissut+TAAR<Causativ<han+LUUNNIIT
pissutitaarattaluunniit	pissut+TAAR<Causativ<vi+LUUNNIIT
pissutitaarunnaarmataluunniit	pissut+TAAR+GUNNAAR<Causativ<de+LUUNNIIT
pissutitaarunnaaratta	pissut+TAAR+GUNNAAR<Causativ<vi
pissutitaarusummat	pissut+TAAR+GUSUP<Causativ<han
pissutitaarusummalluunniit	pissut+TAAR+GUSUP<Causativ<han+LUUNNIIT
pissutitaarusukkatta	pissut+TAAR+GUSUP<Causativ<vi
pissutitaarusuppoq	pissut+TAAR+GUSUP<Indikativ<han
pissutitaarusupporluunniit	pissut+TAAR+GUSUP<Indikativ<han+LUUNNIIT
pissutitaarpoq	pissut+TAAR<Indikativ<han
pissutitaarporluunniit	pissut+TAAR<Indikativ<han+LUUNNIIT
pissutitaarluarmalluunniit	pissut+TAAR+LUAR<Causativ<han+LUUNNIIT
pissutitaarluarpoq	pissut+TAAR+LUAR<Indikativ<han
pissutitaavimmataluunniit	pissut+TAAR-VIP<Causativ<de+LUUNNIIT
pissutitaavimmat	pissut+TAAR-VIP<Causativ<han
pissutitaavimmalluunniit	pissut+TAAR-VIP<Causativ<han+LUUNNIIT
pissutitaavikkatta	pissut+TAAR-VIP<Causativ<vi
pissutitaavikkattaluunniit	pissut+TAAR-VIP<Causativ<vi+LUUNNIIT
pissutitaavippoq	pissut+TAAR-VIP<Indikativ<han
pissutitaavipporluunniit	pissut+TAAR-VIP<Indikativ<han+LUUNNIIT
qaangiummata	qaangiup<Causativ<de
qaangiummataluunniit	qaangiup<Causativ<de+LUUNNIIT
qaangiummat	qaangiup<Causativ<han
qaangiummalluunniit	qaangiup<Causativ<han+LUUNNIIT
qaangiukkatta	qaangiup<Causativ<vi
qaangiukkattaluunniit	qaangiup<Causativ<vi+LUUNNIIT
qaangiukkunnaarmata	qaangiup+GUNNAAR<Causativ<de
qaangiukkunnaaratta	qaangiup+GUNNAAR<Causativ<vi
qaangiukkunnaarpoq	qaangiup+GUNNAAR<Indikativ<han
qaangiukkusummata	qaangiup+GUSUP<Causativ<de
qaangiukkusummat	qaangiup+GUSUP<Causativ<han
qaangiukkusummalluunniit	qaangiup+GUSUP<Causativ<han+LUUNNIIT
qaangiukkusukkatta	qaangiup+GUSUP<Causativ<vi
qaangiukkusukkattaluunniit	qaangiup+GUSUP<Causativ<vi+LUUNNIIT
qaangiukkusuppoq	qaangiup+GUSUP<Indikativ<han
qaangiukkusupporluunniit	qaangiup+GUSUP<Indikativ<han+LUUNNIIT
qaangiuppoq	qaangiup<Indikativ<han
qaangiupporluunniit	qaangiup<Indikativ<han+LUUNNIIT
qaangiulluarmata	qaangiup+LUAR<Causativ<de
qaangiulluarmataluunniit	qaangiup+LUAR<Causativ<de+LUUNNIIT
qaangiulluarmat	qaangiup+LUAR<Causativ<han
qaangiulluarmalluunniit	qaangiup+LUAR<Causativ<han+LUUNNIIT
qaangiulluaratta	qaangiup+LUAR<Causativ<vi
qaangiulluarattaluunniit	qaangiup+LUAR<Causativ<vi+LUUNNIIT
qaangiulluarpoq	qaangiup+LUAR<Indikativ<han
qaangiulluarporluunniit	qaangiup+LUAR<Indikativ<han+LUUNNIIT
qaangiutivimmata	qaangiup-VIP<Causativ<de
qaangiutivimmataluunniit	qaangiup-VIP<Causativ<de+LUUNNIIT
qaangiutivimmat	qaangiup-VIP<Causativ<han
qaangiutivimmalluunniit	qaangiup-VIP<Causativ<han+LUUNNIIT
qaangiutivikkatta	qaangiup-VIP<Causativ<vi
qaangiutivikkattaluunniit	qaangiup-VIP<Causativ<vi+LUUNNIIT
qaangiutivippoq	qaangiup-VIP<Indikativ<han
qaangiutivipporluunniit	qaangiup-VIP<Indikativ<han+LUUNNIIT
qimakkunnaarpat	qimap+GUNNAAR<Indikativ<DuHam
qimakkunnaarpalluunniit	qimap+GUNNAAR<Indikativ<DuHam+LUUNNIIT
qimakkunnaarpaa	qimap+GUNNAAR<Indikativ<HanHam
qimakkunnaarpaaluunniit	qimap+GUNNAAR<Indikativ<HanHam+LUUNNIIT
qimakkunnaarlara	qimap+GUNNAAR<Optativ<JegHam
qimakkunnaarlaraluunniit	qimap+GUNNAAR<Optativ<JegHam+LUUNNIIT
qimakkusuppat	qimap+GUSUP<Indikativ<DuHam
qimakkusuppalluunniit	qimap+GUSUP<Indikativ<DuHam+LUUNNIIT
qimakkusuppaa	qimap+GUSUP<Indikativ<HanHam
qimakkusuppaaluunniit	qimap+GUSUP<Indikativ<HanHam+LUUNNIIT
qimakkusullara	qimap+GUSUP<Optativ<JegHam
qimakkusullaraluunniit	qimap+GUSUP<Optativ<JegHam+LUUNNIIT
qimappat	qimap<Indikativ<DuHam
qimappalluunniit	qimap<Indikativ<DuHam+LUUNNIIT
qimappaa	qimap<Indikativ<HanHam
qimappaaluunniit	qimap<Indikativ<HanHam+LUUNNIIT
qimalluarpat	qimap+LUAR<Indikativ<DuHam
qimalluarpalluunniit	qimap+LUAR<Indikativ<DuHam+LUUNNIIT
qimalluarpaa	qimap+LUAR<Indikativ<HanHam
qimalluarpaaluunniit	qimap+LUAR<Indikativ<HanHam+LUUNNIIT
qimalluarlara	qimap+LUAR<Optativ<JegHam
qimalluarlaraluunniit	qimap+LUAR<Optativ<JegHam+LUUNNIIT
qimallara	qimap<Optativ<JegHam
qimallaraluunniit	qimap<Optativ<JegHam+LUUNNIIT
qimavippat	qimap-VIP<Indikativ<DuHam
qimavippalluunniit	qimap-VIP<Indikativ<DuHam+LUUNNIIT
qimavippaa	qimap-VIP<Indikativ<HanHam
qimavippaaluunniit	qimap-VIP<Indikativ<HanHam+LUUNNIIT
qimavillara	qimap-VIP<Optativ<JegHam
qimavillaraluunniit	qimap-VIP<Optativ<JegHam+LUUNNIIT
sooq	sooq<Partikel
soorluunniit	sooq<Partikel+LUUNNIIT
soorunami	soorunami<Partikel
soorunamiluunniit	soorunami<Partikel+LUUNNIIT
soqutiginarmata	soqutiginar<Causativ<de
soqutiginarmataluunniit	soqutiginar<Causativ<de+LUUNNIIT
soqutiginarmat	soqutiginar<Causativ<han
soqutiginarmalluunniit	soqutiginar<Causativ<han+LUUNNIIT
soqutiginarattaluunniit	soqutiginar<Causativ<vi+LUUNNIIT
soqutiginarunnaarmata	soqutiginar+GUNNAAR<Causativ<de
soqutiginarunnaarmataluunniit	soqutiginar+GUNNAAR<Causativ<de+LUUNNIIT
soqutiginarunnaaratta	soqutiginar+GUNNAAR<Causativ<vi
soqutiginarunnaarpoq	soqutiginar+GUNNAAR<Indikativ<han
soqutiginarunnaarporluunniit	soqutiginar+GUNNAAR<Indikativ<han+LUUNNIIT
soqutiginarusummata	soqutiginar+GUSUP<Causativ<de
soqutiginarusummataluunniit	soqutiginar+GUSUP<Causativ<de+LUUNNIIT
soqutiginarusummat	soqutiginar+GUSUP<Causativ<han
soqutiginarusummalluunniit	soqutiginar+GUSUP<Causativ<han+LUUNNIIT
soqutiginarusukkatta	soqutiginar+GUSUP<Causativ<vi
soqutiginarusukkattaluunniit	soqutiginar+GUSUP<Causativ<vi+LUUNNIIT
soqutiginarusuppoq	soqutiginar+GUSUP<Indikativ<han
soqutiginarpoq	soqutiginar<Indikativ<han
soqutiginarporluunniit	soqutiginar<Indikativ<han+LUUNNIIT
soqutiginarluarmata	soqutiginar+LUAR<Causativ<de
soqutiginarluaratta	soqutiginar+LUAR<Causativ<vi
soqutiginarluarattaluunniit	soqutiginar+LUAR<Causativ<vi+LUUNNIIT
soqutiginarluarpoq	soqutiginar+LUAR<Indikativ<han
soqutiginarluarporluunniit	soqutiginar+LUAR<Indikativ<han+LUUNNIIT
soqutiginavimmata	soqutiginar-VIP<Causativ<de
soqutiginavimmataluunniit	soqutiginar-VIP<Causativ<de+LUUNNIIT
soqutiginavimmat	soqutiginar-VIP<Causativ<han
soqutiginavimmalluunniit	soqutiginar-VIP<Causativ<han+LUUNNIIT
soqutiginavikkatta	soqutiginar-VIP<Causativ<vi
soqutiginavikkattaluunniit	soqutiginar-VIP<Causativ<vi+LUUNNIIT
soqutiginavippoq	soqutiginar-VIP<Indikativ<han
soqutiginavipporluunniit	soqutiginar-VIP<Indikativ<han+LUUNNIIT
suliaq	suliaq<ental<Absolut
suliarluunniit	suliaq<ental<Absolut+LUUNNIIT
suliakkut	suliaq<ental<Vialis
suliakkulluunniit	suliaq<ental<Vialis+LUUNNIIT
suliama	suliaq<flertal<min>Relativ
suliamaluunniit	suliaq<flertal<min>Relativ+LUUNNIIT
suliakkut	suliaq-KKUT<flertal<Absolut
suliakkulluunniit	suliaq-KKUT<flertal<Absolut+LUUNNIIT
suliarsiormat	suliaq+SIUR<Causativ<han
suliarsiormalluunniit	suliaq+SIUR<Causativ<han+LUUNNIIT
suliarsioratta	suliaq+SIUR<Causativ<vi
suliarsiorunnaarmat	suliaq+SIUR+GUNNAAR<Causativ<han
suliarsiorunnaaratta	suliaq+SIUR+GUNNAAR<Causativ<vi
suliarsiorunnaarpoq	suliaq+SIUR+GUNNAAR<Indikativ<han
suliarsiorusuppoq	suliaq+SIUR+GUSUP<Indikativ<han
suliarsiorpoq	suliaq+SIUR<Indikativ<han
suliarsiorluarmat	suliaq+SIUR+LUAR<Causativ<han
suliarsiuimmalluunniit	suliaq+SIUR-VIP<Causativ<han+LUUNNIIT
suliarsiuikkatta	suliaq+SIUR-VIP<Causativ<vi
suliarsiuikkattaluunniit	suliaq+SIUR-VIP<Causativ<vi+LUUNNIIT
suliarsiuippoq	suliaq+SIUR-VIP<Indikativ<han
suliartaarmat	suliaq+TAAR<Causativ<han
suliartaarattaluunniit	suliaq+TAAR<Causativ<vi+LUUNNIIT
suliartaarunnaaratta	suliaq+TAAR+GUNNAAR<Causativ<vi
suliartaarunnaarattaluunniit	suliaq+TAAR+GUNNAAR<Causativ<vi+LUUNNIIT
suliartaarusummalluunniit	suliaq+TAAR+GUSUP<Causativ<han+LUUNNIIT
suliartaarpoq	suliaq+TAAR<Indikativ<han
suliartaarluarmata	suliaq+TAAR+LUAR<Causativ<de
suliartaavimmata	suliaq+TAAR-VIP<Causativ<de
suliartaavimmataluunniit	suliaq+TAAR-VIP<Causativ<de+LUUNNIIT
suliartaavimmat	suliaq+TAAR-VIP<Causativ<han
suliartaavimmalluunniit	suliaq+TAAR-VIP<Causativ<han+LUUNNIIT
suliartaavikkatta	suliaq+TAAR-VIP<Causativ<vi
suliartaavippoq	suliaq+TAAR-VIP<Indikativ<han
suliartaavipporluunniit	suliaq+TAAR-VIP<Indikativ<han+LUUNNIIT
suna	suna<Pronomen<Absolut<ental
sunaluunniit	suna<Pronomen<Absolut<ental+LUUNNIIT
sungiukkunnaarpat	sungiup+GUNNAAR<Indikativ<DuHam
sungiukkunnaarpalluunniit	sungiup+GUNNAAR<Indikativ<DuHam+LUUNNIIT
sungiukkunnaarpaa	sungiup+GUNNAAR<Indikativ<HanHam
sungiukkunnaarlaraluunniit	sungiup+GUNNAAR<Optativ<JegHam+LUUNNIIT
sungiukkusuppat	sungiup+GUSUP<Indikativ<DuHam
sungiukkusuppalluunniit	sungiup+GUSUP<Indikativ<DuHam+LUUNNIIT
sungiuppat	sungiup<Indikativ<DuHam
sungiuppalluunniit	sungiup<Indikativ<DuHam+LUUNNIIT
sungiuppaa	sungiup<Indikativ<HanHam
sungiuppaaluunniit	sungiup<Indikativ<HanHam+LUUNNIIT
sungiulluarpalluunniit	sungiup+LUAR<Indikativ<DuHam+LUUNNIIT
sungiulluarpaa	sungiup+LUAR<Indikativ<HanHam
sungiulluarpaaluunniit	sungiup+LUAR<Indikativ<HanHam+LUUNNIIT
sungiulluarlara	sungiup+LUAR<Optativ<JegHam
sungiulluarlaraluunniit	sungiup+LUAR<Optativ<JegHam+LUUNNIIT
sungiullara	sungiup<Optativ<JegHam
sungiullaraluunniit	sungiup<Optativ<JegHam+LUUNNIIT
sungiutivippalluunniit	sungiup-VIP<Indikativ<DuHam+LUUNNIIT
sungiutivippaa	sungiup-VIP<Indikativ<HanHam
sungiutivippaaluunniit	sungiup-VIP<Indikativ<HanHam+LUUNNIIT
sungiutivillara	sungiup-VIP<Optativ<JegHam
sungiutivillaraluunniit	sungiup-VIP<Optativ<JegHam+LUUNNIIT
taakku	taakku<Pronomen<flertal<Absolut
taakkuluunniit	taakku<Pronomen<flertal<Absolut+LUUNNIIT
taamaammata	taamaap<Causativ<de
taamaammalluunniit	taamaap<Causativ<han+LUUNNIIT
taamaappoq	taamaap<Indikativ<han
taamaalluarpoq	taamaap+LUAR<Indikativ<han
taamaavimmata	taamaap-VIP<Causativ<de
taamaavimmalluunniit	taamaap-VIP<Causativ<han+LUUNNIIT
taama	taama<Partikel
taamaluunniit	taama<Partikel+LUUNNIIT
takujunnaarpalluunniit	taku+GUNNAAR<Indikativ<DuHam+LUUNNIIT
takujunnaarlaraluunniit	taku+GUNNAAR<Optativ<JegHam+LUUNNIIT
takorusuppat	taku+GUSUP<Indikativ<DuHam
takorusuppalluunniit	taku+GUSUP<Indikativ<DuHam+LUUNNIIT
takorusuppaa	taku+GUSUP<Indikativ<HanHam
takorusullara	taku+GUSUP<Optativ<JegHam
takorusullaraluunniit	taku+GUSUP<Optativ<JegHam+LUUNNIIT
takuat	taku<Indikativ<DuHam
takualluunniit	taku<Indikativ<DuHam+LUUNNIIT
takuaa	taku<Indikativ<HanHam
takulluarlara	taku+LUAR<Optativ<JegHam
takulara	taku<Optativ<JegHam
takularaluunniit	taku<Optativ<JegHam+LUUNNIIT
takuippalluunniit	taku-VIP<Indikativ<DuHam+LUUNNIIT
takuippaa	taku-VIP<Indikativ<HanHam
takuippaaluunniit	taku-VIP<Indikativ<HanHam+LUUNNIIT
takuillara	taku-VIP<Optativ<JegHam
tamanna	tamanna<Pronomen<Absolut<ental
tamannaluunniit	tamanna<Pronomen<Absolut<ental+LUUNNIIT
tikikkunnaarpat	tikip+GUNNAAR<Indikativ<DuHam
tikikkunnaarpalluunniit	tikip+GUNNAAR<Indikativ<DuHam+LUUNNIIT
tikikkunnaarpaa	tikip+GUNNAAR<Indikativ<HanHam
tikikkunnaarpaaluunniit	tikip+GUNNAAR<Indikativ<HanHam+LUUNNIIT
tikikkunnaarlara	tikip+GUNNAAR<Optativ<JegHam
tikikkunnaarlaraluunniit	tikip+GUNNAAR<Optativ<JegHam+LUUNNIIT
tikikkusuppat	tikip+GUSUP<Indikativ<DuHam
tikikkusuppalluunniit	tikip+GUSUP<Indikativ<DuHam+LUUNNIIT
tikikkusuppaa	tikip+GUSUP<Indikativ<HanHam
tikikkusuppaaluunniit	tikip+GUSUP<Indikativ<HanHam+LUUNNIIT
tikikkusullara	tikip+GUSUP<Optativ<JegHam
tikikkusullaraluunniit	tikip+GUSUP<Optativ<JegHam+LUUNNIIT
tikippat	tikip<Indikativ<DuHam
tikippalluunniit	tikip<Indikativ<DuHam+LUUNNIIT
tikippaa	tikip<Indikativ<HanHam
tikippaaluunniit	tikip<Indikativ<HanHam+LUUNNIIT
tikilluarpat	tikip+LUAR<Indikativ<DuHam
tikilluarpalluunniit	tikip+LUAR<Indikativ<DuHam+LUUNNIIT
tikilluarpaa	tikip+LUAR<Indikativ<HanHam
tikilluarpaaluunniit	tikip+LUAR<Indikativ<HanHam+LUUNNIIT
tikilluarlara	tikip+LUAR<Optativ<JegHam
tikilluarlaraluunniit	tikip+LUAR<Optativ<JegHam+LUUNNIIT
tikillara	tikip<Optativ<JegHam
tikillaraluunniit	tikip<Optativ<JegHam+LUUNNIIT
tikivippat	tikip-VIP<Indikativ<DuHam
tikivippalluunniit	tikip-VIP<Indikativ<DuHam+LUUNNIIT
tikivippaa	tikip-VIP<Indikativ<HanHam
tikivippaaluunniit	tikip-VIP<Indikativ<HanHam+LUUNNIIT
tikivillara	tikip-VIP<Optativ<JegHam
tikivillaraluunniit	tikip-VIP<Optativ<JegHam+LUUNNIIT
tusarunnaarpat	tusar+GUNNAAR<Indikativ<DuHam
tusarunnaarpalluunniit	tusar+GUNNAAR<Indikativ<DuHam+LUUNNIIT
tusarunnaarpaa	tusar+GUNNAAR<Indikativ<HanHam
tusarunnaarpaaluunniit	tusar+GUNNAAR<Indikativ<HanHam+LUUNNIIT
tusarunnaarlara	tusar+GUNNAAR<Optativ<JegHam
tusarunnaarlaraluunniit	tusar+GUNNAAR<Optativ<JegHam+LUUNNIIT
tusarusuppat	tusar+GUSUP<Indikativ<DuHam
tusarusuppalluunniit	tusar+GUSUP<Indikativ<DuHam+LUUNNIIT
tusarusuppaa	tusar+GUSUP<Indikativ<HanHam
tusarusuppaaluunniit	tusar+GUSUP<Indikativ<HanHam+LUUNNIIT
tusarusullara	tusar+GUSUP<Optativ<JegHam
tusarusullaraluunniit	tusar+GUSUP<Optativ<JegHam+LUUNNIIT
tusarpat	tusar<Indikativ<DuHam
tusarpalluunniit	tusar<Indikativ<DuHam+LUUNNIIT
tusarpaa	tusar<Indikativ<HanHam
tusarpaaluunniit	tusar<Indikativ<HanHam+LUUNNIIT
tusarluarpat	tusar+LUAR<Indikativ<DuHam
tusarluarpalluunniit	tusar+LUAR<Indikativ<DuHam+LUUNNIIT
tusarluarpaa	tusar+LUAR<Indikativ<HanHam
tusarluarlara	tusar+LUAR<Optativ<JegHam
tusarluarlaraluunniit	tusar+LUAR<Optativ<JegHam+LUUNNIIT
tusarlaraluunniit	tusar<Optativ<JegHam+LUUNNIIT
tusavippat	tusar-VIP<Indikativ<DuHam
tusavippalluunniit	tusar-VIP<Indikativ<DuHam+LUUNNIIT
tusavippaa	tusar-VIP<Indikativ<HanHam
tusavippaaluunniit	tusar-VIP<Indikativ<HanHam+LUUNNIIT
tusavillara	tusar-VIP<Optativ<JegHam
tusavillaraluunniit	tusar-VIP<Optativ<JegHam+LUUNNIIT
uani	uani<Partikel
uaniluunniit	uani<Partikel+LUUNNIIT
ungasimmata	ungasip<Causativ<de
ungasimmataluunniit	ungasip<Causativ<de+LUUNNIIT
ungasimmat	ungasip<Causativ<han
ungasimmalluunniit	ungasip<Causativ<han+LUUNNIIT
ungasikkatta	ungasip<Causativ<vi
ungasikkattaluunniit	ungasip<Causativ<vi+LUUNNIIT
ungasikkunnaarmata	ungasip+GUNNAAR<Causativ<de
ungasikkunnaaratta	ungasip+GUNNAAR<Causativ<vi
ungasikkunnaarattaluunniit	ungasip+GUNNAAR<Causativ<vi+LUUNNIIT
ungasikkunnaarpoq	ungasip+GUNNAAR<Indikativ<han
ungasikkunnaarporluunniit	ungasip+GUNNAAR<Indikativ<han+LUUNNIIT
ungasikkusummata	ungasip+GUSUP<Causativ<de
ungasikkusuppoq	ungasip+GUSUP<Indikativ<han
ungasikkusupporluunniit	ungasip+GUSUP<Indikativ<han+LUUNNIIT
ungasippoq	ungasip<Indikativ<han
ungasipporluunniit	ungasip<Indikativ<han+LUUNNIIT
ungasilluarmata	ungasip+LUAR<Causativ<de
ungasilluarmataluunniit	ungasip+LUAR<Causativ<de+LUUNNIIT
ungasilluarmat	ungasip+LUAR<Causativ<han
ungasilluarmalluunniit	ungasip+LUAR<Causativ<han+LUUNNIIT
ungasilluaratta	ungasip+LUAR<Causativ<vi
ungasilluarattaluunniit	ungasip+LUAR<Causativ<vi+LUUNNIIT
ungasilluarpoq	ungasip+LUAR<Indikativ<han
ungasilluarporluunniit	ungasip+LUAR<Indikativ<han+LUUNNIIT
ungasitsigimmata	ungasip+TIGӘ<Causativ<de
ungasitsigimmat	ungasip+TIGӘ<Causativ<han
ungasitsigimmalluunniit	ungasip+TIGӘ<Causativ<han+LUUNNIIT
ungasitsigigatta	ungasip+TIGӘ<Causativ<vi
ungasitsigigattaluunniit	ungasip+TIGӘ<Causativ<vi+LUUNNIIT
ungasitsigivoq	ungasip+TIGӘ<Indikativ<han
ungasitsigivorluunniit	ungasip+TIGӘ<Indikativ<han+LUUNNIIT
ungasitsigisorluunniit	ungasip+TIGӘ+TUQ<ental<Absolut+LUUNNIIT
ungasitsigisumaluunniit	ungasip+TIGӘ+TUQ<flertal<min>Relativ+LUUNNIIT
ungasitsigisukkulluunniit	ungasip+TIGӘ+TUQ-KKUT<flertal<Absolut+LUUNNIIT
ungasitsigisorsiorunnaarmalluunniit	ungasip+TIGӘ+TUQ+SIUR+GUNNAAR<Causativ<han+LUUNNIIT
ungasitsigisorsiorpoq	ungasip+TIGӘ+TUQ+SIUR<Indikativ<han
ungasitsigisorsiuimmat	ungasip+TIGӘ+TUQ+SIUR-VIP<Causativ<han
ungasitsigisortaarunnaarporluunniit	ungasip+TIGӘ+TUQ+TAAR+GUNNAAR<Indikativ<han+LUUNNIIT
ungasitsigisortaarluarmalluunniit	ungasip+TIGӘ+TUQ+TAAR+LUAR<Causativ<han+LUUNNIIT
ungasitsigisortaavikkattaluunniit	ungasip+TIGӘ+TUQ+TAAR-VIP<Causativ<vi+LUUNNIIT
ungasivimmata	ungasip-VIP<Causativ<de
ungasivimmalluunniit	ungasip-VIP<Causativ<han+LUUNNIIT
ungasivikkatta	ungasip-VIP<Causativ<vi
ungasivikkattaluunniit	ungasip-VIP<Causativ<vi+LUUNNIIT
ungasivippoq	ungasip-VIP<Indikativ<han
ungasivipporluunniit	ungasip-VIP<Indikativ<han+LUUNNIIT
upernaaq	upernaaq<ental<Absolut
upernaarluunniit	upernaaq<ental<Absolut+LUUNNIIT
upernaakkut	upernaaq<ental<Vialis
upernaakkulluunniit	upernaaq<ental<Vialis+LUUNNIIT
upernaama	upernaaq<flertal<min>Relativ
upernaamaluunniit	upernaaq<flertal<min>Relativ+LUUNNIIT
upernaakkut	upernaaq-KKUT<flertal<Absolut
upernaakkulluunniit	upernaaq-KKUT<flertal<Absolut+LUUNNIIT
upernaarsiormalluunniit	upernaaq+SIUR<Causativ<han+LUUNNIIT
upernaarsioratta	upernaaq+SIUR<Causativ<vi
upernaarsiorattaluunniit	upernaaq+SIUR<Causativ<vi+LUUNNIIT
upernaarsiorunnaarmataluunniit	upernaaq+SIUR+GUNNAAR<Causativ<de+LUUNNIIT
upernaarsiorunnaarmalluunniit	upernaaq+SIUR+GUNNAAR<Causativ<han+LUUNNIIT
upernaarsiorunnaarattaluunniit	upernaaq+SIUR+GUNNAAR<Causativ<vi+LUUNNIIT
upernaarsiorunnaarporluunniit	upernaaq+SIUR+GUNNAAR<Indikativ<han+LUUNNIIT
upernaarsiorusukkatta	upernaaq+SIUR+GUSUP<Causativ<vi
upernaarsiorusukkattaluunniit	upernaaq+SIUR+GUSUP<Causativ<vi+LUUNNIIT
upernaarsiorusuppoq	upernaaq+SIUR+GUSUP<Indikativ<han
upernaarsiorpoq	upernaaq+SIUR<Indikativ<han
upernaarsiorporluunniit	upernaaq+SIUR<Indikativ<han+LUUNNIIT
upernaarsiorluarmalluunniit	upernaaq+SIUR+LUAR<Causativ<han+LUUNNIIT
upernaarsiorluarattaluunniit	upernaaq+SIUR+LUAR<Causativ<vi+LUUNNIIT
upernaarsiorluarporluunniit	upernaaq+SIUR+LUAR<Indikativ<han+LUUNNIIT
upernaarsiuimmataluunniit	upernaaq+SIUR-VIP<Causativ<de+LUUNNIIT
upernaarsiuimmalluunniit	upernaaq+SIUR-VIP<Causativ<han+LUUNNIIT
upernaarsiuikkatta	upernaaq+SIUR-VIP<Causativ<vi
upernaarsiuikkattaluunniit	upernaaq+SIUR-VIP<Causativ<vi+LUUNNIIT
upernaarsiuippoq	upernaaq+SIUR-VIP<Indikativ<han
upernaarsiuipporluunniit	upernaaq+SIUR-VIP<Indikativ<han+LUUNNIIT
upernaartaarattaluunniit	upernaaq+TAAR<Causativ<vi+LUUNNIIT
upernaartaarunnaarmata	upernaaq+TAAR+GUNNAAR<Causativ<de
upernaartaarunnaarmat	upernaaq+TAAR+GUNNAAR<Causativ<han
upernaartaarunnaaratta	upernaaq+TAAR+GUNNAAR<Causativ<vi
upernaartaarunnaarpoq	upernaaq+TAAR+GUNNAAR<Indikativ<han
upernaartaarusummataluunniit	upernaaq+TAAR+GUSUP<Causativ<de+LUUNNIIT
upernaartaarusummalluunniit	upernaaq+TAAR+GUSUP<Causativ<han+LUUNNIIT
upernaartaarusukkatta	upernaaq+TAAR+GUSUP<Causativ<vi
upernaartaarusukkattaluunniit	upernaaq+TAAR+GUSUP<Causativ<vi+LUUNNIIT
upernaartaarusuppoq	upernaaq+TAAR+GUSUP<Indikativ<han
upernaartaarusupporluunniit	upernaaq+TAAR+GUSUP<Indikativ<han+LUUNNIIT
upernaartaarpoq	upernaaq+TAAR<Indikativ<han
upernaartaarporluunniit	upernaaq+TAAR<Indikativ<han+LUUNNIIT
upernaartaarluarmata	upernaaq+TAAR+LUAR<Causativ<de
upernaartaarluarpoq	upernaaq+TAAR+LUAR<Indikativ<han
upernaartaavimmata	upernaaq+TAAR-VIP<Causativ<de
upernaartaavimmataluunniit	upernaaq+TAAR-VIP<Causativ<de+LUUNNIIT
upernaartaavimmat	upernaaq+TAAR-VIP<Causativ<han
upernaartaavikkatta	upernaaq+TAAR-VIP<Causativ<vi
upernaartaavikkattaluunniit	upernaaq+TAAR-VIP<Causativ<vi+LUUNNIIT
upernaartaavippoq	upernaaq+TAAR-VIP<Indikativ<han
upernaartaavipporluunniit	upernaaq+TAAR-VIP<Indikativ<han+LUUNNIIT
