aallalaartarpit	aallar-LAAR=TAR<Interrogativ<du
aallaqquara	aallar-QQU<Indikativ<JegHam
aallarsimasartunga	aallar+SIMA=TAR<Participium<jeg
aamma	aamma<Partikel
aapparmiuunikuusoqareermata	aappaq+MIU-U+NIKUU+TUQ-QAR-RIIR<Causativ<de
aappaalaarlutik	aappaq-U-LAAR<Ledsagemåde<de_selv
aalli	aap<Partikel+LI
aallu	aap<Partikel+LU
aasarpassuilli	aasaq+PASSUAQ<flertal<Absolut+LI
aasaammata	aasaq-U<Causativ<de
Aasiaat	Aasiaat<Absolut
Aasiaalli	Aasiaat<Absolut+LI
Aasiaallu	Aasiaat<Absolut+LU
Aasiaanuna	Aasiaat<Absolut+UNA
Aasiannik	Aasiaat<Instrumentalis
Aasiannilli	Aasiaat<Instrumentalis+LI
Aasianninguna	Aasiaat<Instrumentalis+UNA
Aasianni	Aasiaat<Lokalis
Aasianniinnginneruna	Aasiaat<Lokalis+IP-NNGIT+NIQ+UNA
Aasianneeqqaarmalli	Aasiaat<Lokalis+IP-QQAAR<Causativ<han+LI
Aasianneeqqaarpoq	Aasiaat<Lokalis+IP-QQAAR<Indikativ<han
Aasianneeqquaangaana	Aasiaat<Lokalis+IP-QQU<Indikativ<HanMig+UNA
Aasianneeqqulara	Aasiaat<Lokalis+IP-QQU<Optativ<JegHam
Aasianneeriaratta	Aasiaat<Lokalis+IP-RIAR<Causativ<vi
Aasianneereerpit	Aasiaat<Lokalis+IP-RIIR<Interrogativ<du
Aasiannilu	Aasiaat<Lokalis+LU
Aasiammiuni	Aasiaat+MIU<flertal<Lokalis
Aasiammiuniinngilarli	Aasiaat+MIU<flertal<Lokalis+IP-NNGIT<Indikativ<han+LI
Aasiammiuneeqqaarmata	Aasiaat+MIU<flertal<Lokalis+IP-QQAAR<Causativ<de
Aasiammiuneeqqugakku	Aasiaat+MIU<flertal<Lokalis+IP-QQU<Causativ<JegHam
Aasiammiulerigaluarlutillu	Aasiaat+MIU-LIRI+GALUAR<Ledsagemåde<de_selv+LU
Aasiammiulereriarpit	Aasiaat+MIU-LIRI-RIAR<Interrogativ<du
Aasiammiunnguinnarnini	Aasiaat+MIU-NNGUR-INNAR+NIQ<ental<sin<Absolut
Aasiammiunngunnginnatta	Aasiaat+MIU-NNGUR-NNGIT<Causativ<vi
Aasiammiunngoreerpugullu	Aasiaat+MIU-NNGUR-RIIR<Indikativ<vi+LU
Aasiammiunngoreertulli	Aasiaat+MIU-NNGUR-RIIR<Participium<de+LI
Aasiammioqarpoq	Aasiaat+MIU-QAR<Indikativ<han
Aasiammioqarneq	Aasiaat+MIU-QAR+NIQ
Aasiammioqarnerli	Aasiaat+MIU-QAR+NIQ+LI
Aasiammioqartoq	Aasiaat+MIU-QAR<Participium<han
Aasiammioqartoq	Aasiaat+MIU-QAR+TUQ
Aasiammioqartorli	Aasiaat+MIU-QAR+TUQ+LI
Aasiammioqartoruna	Aasiaat+MIU-QAR+TUQ+UNA
Aasiammioorusunninili	Aasiaat+MIU-U+GUSUP+NIQ<ental<sin<Absolut+LI
Aasiammioorusuttuinnaqalaartunngortaraluarpungali	Aasiaat+MIU-U+GUSUP+TUQ-INNAQ-QAR-LAAR+TUQ-NNGUR+TAR=GALUAR<Indikativ<jeg+LI
Aasiammiuuinnarlutilli	Aasiaat+MIU-U-INNAR<Ledsagemåde<de_selv+LI
Aasiammiuullutilli	Aasiaat+MIU-U<Ledsagemåde<de_selv+LI
Aasiammiooqqularali	Aasiaat+MIU-U-QQU<Optativ<JegHam+LI
Aasiammiooreertungali	Aasiaat+MIU-U-RIIR<Participium<jeg+LI
Aasiammiuuittungali	Aasiaat+MIU-U-VIP<Participium<jeg+LI
Aasiannut	Aasiaat<Terminalis
Aasiannukalaarama	Aasiaat<Terminalis-KAR-LAAR<Causativ<jeg
Aasiannukalaartoq	Aasiaat<Terminalis-KAR-LAAR<Participium<han
Aasiannukaqqugakkuli	Aasiaat<Terminalis-KAR-QQU<Causativ<JegHam+LI
Aasiannukaqquaa	Aasiaat<Terminalis-KAR-QQU<Indikativ<HanHam
Aasiannukaqquiuk	Aasiaat<Terminalis-KAR-QQU<Interrogativ<DuHam
Aasiannukariarpit	Aasiaat<Terminalis-KAR-RIAR<Interrogativ<du
Aasiannukassagama	Aasiaat<Terminalis-KAR-SSA<Causativ<jeg
Aasiannukassagaluarpunga	Aasiaat<Terminalis-KAR-SSA=GALUAR<Indikativ<jeg
Aasiannukassagaluartunga	Aasiaat<Terminalis-KAR-SSA=GALUAR<Participium<jeg
Aasiannulli	Aasiaat<Terminalis+LI
Aasiannullu	Aasiaat<Terminalis+LU
affaq	affaq<ental<Absolut
affamik	affaq<ental<Instrumentalis
affara	affaq<ental<min<Absolut
affaralu	affaq<ental<min<Absolut+LU
affaneeqquaajuna	affaq<flertal<Lokalis+IP-QQU<Indikativ<HanHam+UNA
affariittut	affaq+GIIT<flertal<Aequalis
affariikka	affaq+GIIT<flertal<min<Absolut
affariikkaana	affaq+GIIT<flertal<min<Absolut+UNA
affarerusummanga	affaq+GӘ+GUSUP<Causativ<HanMig
affarilaarlaraana	affaq+GӘ-LAAR<Optativ<JegHam+UNA
affaannaat	affaq-INNAQ<flertal<Absolut
affakkut	affaq-KKUT<flertal<Absolut
affalimmaana	affaq-LIK<ental<min>Relativ+UNA
affalererusullutinguna	affaq-LIRI+GUSUP<Ledsagemåde<de_selv+UNA
affarmiulerinerpunga	affaq+MIU-LIRI+NIR<Indikativ<jeg
affanngooqqaarpit	affaq-NNGUAQ-U-QQAAR<Interrogativ<du
affarpassui	affaq+PASSUAQ<flertal<hans<Absolut
affarpassuarnununa	affaq+PASSUAQ<flertal<Terminalis+UNA
affarsioqqaarnini	affaq+SIUR-QQAAR+NIQ<ental<sin<Absolut
affartaalaartulli	affaq+TAAR-LAAR<Participium<de+LI
affartaassagaluarpugununa	affaq+TAAR-SSA=GALUAR<Indikativ<vi+UNA
affaanikuusorli	affaq-U+NIKUU<Participium<han+LI
affaasaraluarama	affaq-U+TAR=GALUAR<Causativ<jeg
akisuuniissimasarneruna	akisooq<flertal<Lokalis+IP+SIMA=TAR+NIQ+UNA
akisooriikka	akisooq+GIIT<flertal<min<Absolut
akisooriit	akisooq+GIIT<flertal<Relativ
akisoorpassuakka	akisooq+PASSUAQ<flertal<min<Absolut
akisoorpassuakkaana	akisooq+PASSUAQ<flertal<min<Absolut+UNA
akisooqassaarli	akisooq-QAR-SSA<Indikativ<han+LI
akisuujugaluartuussagaluarpit	akisooq-U+GALUAR+TUQ-U-SSA=GALUAR<Interrogativ<du
akisuujusartuleriinnarniniuna	akisooq-U+TAR+TUQ-LIRI-INNAR+NIQ<ental<sin<Absolut+UNA
akueriunnaarpagullu	akuerә+GUNNAAR<Indikativ<ViDem+LU
akuererusullugu	akuerә+GUSUP<Ledsagemåde<ham
akuerivaallu	akuerә<Indikativ<DeHam+LU
akueriinnarmanga	akuerә-INNAR<Causativ<HanMig
akueriinnarmangaana	akuerә-INNAR<Causativ<HanMig+UNA
akueriinnarlugu	akuerә-INNAR<Ledsagemåde<ham
akuerilaartartigit	akuerә-LAAR=TAR<Imperativ<ViDem
akuerilaartarpiuk	akuerә-LAAR=TAR<Interrogativ<DuHam
akuerineqarneq	akuerә+NIQAR+NIQ<ental<Absolut
akuerisimaviuk	akuerә+SIMA<Interrogativ<DuHam
akuerisarakkuuna	akuerә+TAR<Causativ<JegHam+UNA
akuerivallaarlara	akuerә+VALLAAR<Optativ<JegHam
aleqagiittununa	aleqa+GIIT<flertal<Aequalis+UNA
aleqagineqarput	aleqa+GӘ+NIQAR<Indikativ<de
aleqagereerlara	aleqa+GӘ-RIIR<Optativ<JegHam
aleqagisaraluarmanga	aleqa+GӘ+TAR=GALUAR<Causativ<HanMig
aleqaannaqaqqaarpit	aleqa-INNAQ-QAR-QQAAR<Interrogativ<du
aleqakkunnilli	aleqa-KKUT<flertal<Instrumentalis+LI
aleqamiulerinerpugullu	aleqa+MIU-LIRI+NIR<Indikativ<vi+LU
aleqannguusimavit	aleqa-NNGUAQ-U+SIMA<Interrogativ<du
aleqanngorpallaanngitsussatulli	aleqa-NNGUR+VALLAAR=NNGIT+TUQ-SSAQ<ental<Aequalis+LI
aleqarpassui	aleqa+PASSUAQ<flertal<hans<Absolut
aleqaqalaarneralu	aleqa-QAR-LAAR+NIQ<ental<hans<Absolut+LU
aleqasioqqaartunga	aleqa+SIUR-QQAAR<Participium<jeg
aleqasiuimmalli	aleqa+SIUR-VIP<Causativ<han+LI
aleqassakka	aleqa-SSAQ<flertal<min<Absolut
aleqaagaluarmataana	aleqa-U+GALUAR<Causativ<de+UNA
aleqaavit	aleqa-U<Interrogativ<du
aleqaanernerallu	aleqa-U+NIR+NIQ<ental<deres+LU
allatullu	alla<ental<Aequalis+LU
allamilu	alla<ental<Lokalis+LU
allaannarsioqqaarpugulli	alla-INNAQ+SIUR-QQAAR<Indikativ<vi+LI
allakkut	alla-KKUT<flertal<Absolut
allakkunneeqqaarlutinguna	alla-KKUT<flertal<Lokalis+IP-QQAAR<Ledsagemåde<de_selv+UNA
allalimmununa	alla-LIK<ental<Terminalis+UNA
allalissiulaartulerinernini	alla-LIK+SIUR-LAAR+TUQ-LIRI+NIR+NIQ<ental<sin<Absolut
allanngua	alla-NNGUAQ<ental<hans<Absolut
allanngornikuuit	alla-NNGUR+NIKUU<Interrogativ<du
allarpassuarninguna	alla+PASSUAQ<flertal<Instrumentalis+UNA
allaqassasulli	alla-QAR-SSA<Participium<de+LI
allassaq	alla-SSAQ<ental<Absolut
anaanannguimmata	anaana-NNGUR-VIP<Causativ<de
anaanarpassui	anaana+PASSUAQ<flertal<hans<Absolut
anaanarpassuarnukaqqulara	anaana+PASSUAQ<flertal<Terminalis-KAR-QQU<Optativ<JegHam
angajorpassuartut	angaju+PASSUAQ<flertal<Aequalis
angajorpassui	angaju+PASSUAQ<flertal<hans<Absolut
angajoqaqqularali	angaju-QAR-QQU<Optativ<JegHam+LI
angajooreertungali	angaju-U-RIIR<Participium<jeg+LI
angummik	angut<ental<Instrumentalis
angutilerilaartarninilu	angut-LIRI-LAAR=TAR+NIQ<ental<sin<Absolut+LU
anillit	ani-LIK<flertal<Relativ
anillilli	ani-LIK<flertal<Relativ+LI
anilerisaraluarama	ani-LIRI+TAR=GALUAR<Causativ<jeg
animiunngoriartumilu	ani+MIU-NNGUR-RIAR+TUQ<ental<Lokalis+LU
anerpassuakkalu	ani+PASSUAQ<flertal<min<Absolut+LU
aneqalaartarporli	ani-QAR-LAAR=TAR<Indikativ<han+LI
aneqanngitsoqalaartarpugut	ani-QAR-NNGIT+TUQ-QAR-LAAR=TAR<Indikativ<vi
aneqaqqaarmata	ani-QAR-QQAAR<Causativ<de
aneqareermanuna	ani-QAR-RIIR<Causativ<han+UNA
aneqassagaluarama	ani-QAR-SSA=GALUAR<Causativ<jeg
anissaanikuuvugulli	ani-SSAQ-U+NIKUU<Indikativ<vi+LI
aqqaloqaannarneq	aqqalu-QAR-INNAR+NIQ<ental<Absolut
aqqalutaaqquiuk	aqqalu+TAAR-QQU<Interrogativ<DuHam
aqqalooriarpunga	aqqalu-U-RIAR<Indikativ<jeg
aqqanilittununa	aqqanillit<Talord<Aequalis+UNA
aqqanillilli	aqqanillit<Talord<flertal<Absolut+LI
aqqanillinuna	aqqanillit<Talord<flertal<Absolut+UNA
aqqanilinneeqqaartoq	aqqanillit<Talord<Lokalis+IP-QQAAR<Participium<han
aqqanilioqqummangali	aqqanillit-U-QQU<Causativ<HanMig+LI
aqqutigivaalu	aqqutigә<Indikativ<HanDem+LU
aqqutigilaarluginuna	aqqutigә-LAAR<Ledsagemåde<dem+UNA
aqqutigilluarlara	aqqutigә+LUAR<Optativ<JegHam
aqqutiginiarnagu	aqqutigә+NIAR=NNGIT<Ledsagemåde<ham
aqqutiginertigilli	aqqutigә+NIR<Imperativ<ViDem+LI
aqqutigeqqaarpiuk	aqqutigә-QQAAR<Interrogativ<DuHam
aqqutigereerluguuna	aqqutigә-RIIR<Ledsagemåde<ham+UNA
aqqutigereerlaralu	aqqutigә-RIIR<Optativ<JegHam+LU
aqqutigisimammangali	aqqutigә+SIMA<Causativ<HanMig+LI
aqqutigisimalara	aqqutigә+SIMA<Optativ<JegHam
aqqutigisinnaaviuk	aqqutigә+SINNAA<Interrogativ<DuHam
aqqutigissagaluarmanga	aqqutigә-SSA=GALUAR<Causativ<HanMig
aqqutigissaviuk	aqqutigә-SSA<Interrogativ<DuHam
aqqutigivallaarmanga	aqqutigә+VALLAAR<Causativ<HanMig
aqqutigivallaanngilarali	aqqutigә+VALLAAR=NNGIT<Indikativ<JegHam+LI
arnaq	arnaq<ental<Absolut
arnarli	arnaq<ental<Absolut+LI
arnariinnarlara	arnaq+GӘ-INNAR<Optativ<JegHam
arnarivallaanngiliuk	arnaq+GӘ+VALLAAR=NNGIT<Interrogativ<DuHam
arnaannaq	arnaq-INNAQ<ental<Absolut
arnaannakkullu	arnaq-INNAQ<ental<Vialis+LU
arnakkullu	arnaq-KKUT<flertal<Absolut+LU
arnakkunneeqqaarlutinguna	arnaq-KKUT<flertal<Lokalis+IP-QQAAR<Ledsagemåde<de_selv+UNA
arnarmiuneeqqulluguli	arnaq+MIU<flertal<Lokalis+IP-QQU<Ledsagemåde<ham+LI
arnarmioqarneq	arnaq+MIU-QAR+NIQ
arnannguanilu	arnaq-NNGUAQ<ental<sin<Absolut+LU
arnanngussagaluartoq	arnaq-NNGUR-SSA=GALUAR+TUQ<ental<Absolut
arnarpassuakka	arnaq+PASSUAQ<flertal<min<Absolut
arnarsiormata	arnaq+SIUR<Causativ<de
arnartaalaarmata	arnaq+TAAR-LAAR<Causativ<de
arnaasimasartullu	arnaq-U+SIMA=TAR<Participium<de+LU
assersuulli	assersuut<ental<Absolut+LI
assersuununa	assersuut<ental<Absolut+UNA
assersuummillu	assersuut<ental<Instrumentalis+LU
assersuummeereerpit	assersuut<ental<Lokalis+IP-RIIR<Interrogativ<du
assersuutikka	assersuut<flertal<min<Absolut
assersuutinngua	assersuut-NNGUAQ<ental<hans<Absolut
assersuutinngooriartorli	assersuut-NNGUAQ-U-RIAR<Participium<han+LI
assulli	assut<Partikel+LI
assullu	assut<Partikel+LU
assununa	assut<Partikel+UNA
ataatsitullu	ataaseq<Talord<ental<Aequalis+LU
ataatallillu	ataata-LIK<flertal<Absolut+LU
ataatalerisaraluarlutinguna	ataata-LIRI+TAR=GALUAR<Ledsagemåde<de_selv+UNA
atassulli	atassut<ental<Absolut+LI
atassununa	atassut<ental<Absolut+UNA
atassummiippallaanngitsoq	atassut<ental<Lokalis+IP+VALLAAR=NNGIT+TUQ
atassutinnguinneraana	atassut-NNGUR-VIP+NIQ<ental<hans<Absolut+UNA
ateq	ateq<ental<Absolut
aterni	ateq<ental<sin<Absolut
atiillu	ateq<flertal<Absolut+LU
atima	ateq<flertal<min>Relativ
aternununa	ateq<flertal<Terminalis+UNA
atereqqullugillu	ateq+GӘ-QQU<Ledsagemåde<dem+LU
atiliat	ateq-LIK<ental<deres
atilinnukareerpunga	ateq-LIK<flertal<Terminalis-KAR-RIIR<Indikativ<jeg
atinnguippulli	ateq-NNGUR-VIP<Indikativ<de+LI
ateqaqqaarpit	ateq-QAR-QQAAR<Interrogativ<du
atersiorunnaarama	ateq+SIUR+GUNNAAR<Causativ<jeg
atiusimasarpit	ateq-U+SIMA=TAR<Interrogativ<du
atuinnarlara	ator-INNAR<Optativ<JegHam
atulaartarakku	ator-LAAR=TAR<Causativ<JegHam
atulerpit	ator-LIR<Interrogativ<du
atornerugakku	ator+NIRU<Causativ<JegHam
atoriartunngua	ator-RIAR+TUQ-NNGUAQ<ental<hans<Absolut
atoreerlugilli	ator-RIIR<Ledsagemåde<dem+LI
atortarlara	ator+TAR<Optativ<JegHam
atorpallaanngitsungaana	ator+VALLAAR=NNGIT<Participium<jeg+UNA
atuakkialerinima	atuakkialerineq<flertal<min>Relativ
atuakkialerinimaana	atuakkialerineq<flertal<min>Relativ+UNA
atuakkialerinernulli	atuakkialerineq<flertal<Terminalis+LI
atuakkialerinermiuugaluarpit	atuakkialerineq+MIU-U+GALUAR<Interrogativ<du
atuarnerusunga	atuar+NIRU<Participium<jeg
Avanersuaq	Avanersuaq<Absolut
Avanersuarli	Avanersuaq<Absolut+LI
Avanersuarlu	Avanersuaq<Absolut+LU
Avanersuaruna	Avanersuaq<Absolut+UNA
Avanersuarmik	Avanersuaq<Instrumentalis
Avanersuarmilli	Avanersuaq<Instrumentalis+LI
Avanersuarminguna	Avanersuaq<Instrumentalis+UNA
Avanersuarmi	Avanersuaq<Lokalis
Avanersuarmeeqqaarmata	Avanersuaq<Lokalis+IP-QQAAR<Causativ<de
Avanersuarmeeqqaarmanuna	Avanersuaq<Lokalis+IP-QQAAR<Causativ<han+UNA
Avanersuarmeeqqaarporli	Avanersuaq<Lokalis+IP-QQAAR<Indikativ<han+LI
Avanersuarmeeriarmalli	Avanersuaq<Lokalis+IP-RIAR<Causativ<han+LI
Avanersuarmeeriaratta	Avanersuaq<Lokalis+IP-RIAR<Causativ<vi
Avanersuarmili	Avanersuaq<Lokalis+LI
Avanersuarmilu	Avanersuaq<Lokalis+LU
Avanersuarmiuninguna	Avanersuaq+MIU<flertal<Instrumentalis+UNA
Avanersuarmiuni	Avanersuaq+MIU<flertal<Lokalis
Avanersuarmioqarneq	Avanersuaq+MIU-QAR+NIQ
Avanersuarmioqartoq	Avanersuaq+MIU-QAR<Participium<han
Avanersuarmiuullutinguna	Avanersuaq+MIU-U<Ledsagemåde<de_selv+UNA
Avanersuarmiuusaraluarlutilli	Avanersuaq+MIU-U+TAR=GALUAR<Ledsagemåde<de_selv+LI
Avanersuarmut	Avanersuaq<Terminalis
Avanersuarmukalaartarpunga	Avanersuaq<Terminalis-KAR-LAAR=TAR<Indikativ<jeg
Avanersuarmukariarama	Avanersuaq<Terminalis-KAR-RIAR<Causativ<jeg
Avanersuarmukavinneq	Avanersuaq<Terminalis-KAR-VIP+NIQ
Avanersuarmulli	Avanersuaq<Terminalis+LI
Avanersuakkut	Avanersuaq<Vialis
Avanersuakkulli	Avanersuaq<Vialis+LI
Avanersuakkullu	Avanersuaq<Vialis+LU
Avanersuakkununa	Avanersuaq<Vialis+UNA
avimmata	avip<Causativ<de
avikkatta	avip<Causativ<vi
avilaartarpugut	avip-LAAR=TAR<Indikativ<vi
avilluarpugununa	avip+LUAR<Indikativ<vi+UNA
aveqqaaratta	avip-QQAAR<Causativ<vi
aveqqaartut	avip-QQAAR<Participium<de
aveqqaartullu	avip-QQAAR<Participium<de+LU
aveqqutigilli	avip-QQU<Imperativ<ViDem+LI
aveqquiuk	avip-QQU<Interrogativ<DuHam
avereerlutik	avip-RIIR<Ledsagemåde<de_selv
avereerninili	avip-RIIR+NIQ<ental<sin<Absolut+LI
avittaraluarlutillu	avip+TAR=GALUAR<Ledsagemåde<de_selv+LU
avippallaartuinnalereriarpit	avip+VALLAAR+TUQ-INNAQ-LIRI-RIAR<Interrogativ<du
eqqaamajartortigit	eqqaama+GIARTUR<Imperativ<ViDem
eqqaamarusutsiginuna	eqqaama+GUSUP<Imperativ<ViDem+UNA
eqqaamarusullarali	eqqaama+GUSUP<Optativ<JegHam+LI
eqqaamatigillu	eqqaama<Imperativ<ViDem+LU
eqqaamavaat	eqqaama<Indikativ<DeHam
eqqaamavaajuna	eqqaama<Indikativ<HanDem+UNA
eqqaamaannartigillu	eqqaama-INNAR<Imperativ<ViDem+LU
eqqaamalaarpiuk	eqqaama-LAAR<Interrogativ<DuHam
eqqaamallugulu	eqqaama<Ledsagemåde<ham+LU
eqqaamaniarpiuk	eqqaama+NIAR<Interrogativ<DuHam
eqqaamaniarnagu	eqqaama+NIAR=NNGIT<Ledsagemåde<ham
eqqaamanikuullugit	eqqaama+NIKUU<Ledsagemåde<dem
eqqaamanerlugillu	eqqaama+NIR<Ledsagemåde<dem+LU
eqqaamaneruakkaana	eqqaama+NIRU<Indikativ<JegDem+UNA
eqqaamanngilaalu	eqqaama-NNGIT<Indikativ<HanHam+LU
eqqaamasimatigillu	eqqaama+SIMA<Imperativ<ViDem+LU
eqqaamasimasarpiuk	eqqaama+SIMA=TAR<Interrogativ<DuHam
eqqaamasarpiuk	eqqaama+TAR<Interrogativ<DuHam
eqqaa	eqqaq<ental<hans<Absolut
eqqaaneereertut	eqqaq<ental<Lokalis<hans+IP-RIIR<Participium<de
eqqara	eqqaq<ental<min<Absolut
eqqarali	eqqaq<ental<min<Absolut+LI
eqqaralu	eqqaq<ental<min<Absolut+LU
eqqaraana	eqqaq<ental<min<Absolut+UNA
eqqama	eqqaq<ental<min>Relativ
eqqamaana	eqqaq<ental<min>Relativ+UNA
eqqaanukalaartaratta	eqqaq<ental<Terminalis<hans-KAR-LAAR=TAR<Causativ<vi
eqqaanununa	eqqaq<ental<Terminalis<hans+UNA
eqqannguaq	eqqaq-NNGUAQ<ental<Absolut
eqqanngui	eqqaq-NNGUAQ<flertal<hans<Absolut
eqqannguanik	eqqaq-NNGUAQ<flertal<Instrumentalis
eqqannguani	eqqaq-NNGUAQ<flertal<Lokalis
eqqanngualeriartorniniuna	eqqaq-NNGUAQ-LIRI+GIARTUR+NIQ<ental<sin<Absolut+UNA
eqqannguunatilli	eqqaq-NNGUAQ-U-NNGIT<Ledsagemåde<de_selv+LI
eqqanngooqqaarnerilli	eqqaq-NNGUAQ-U-QQAAR+NIQ<flertal<Relativ+LI
eqqanngooqqaartunga	eqqaq-NNGUAQ-U-QQAAR<Participium<jeg
eqqanngooqquakkalu	eqqaq-NNGUAQ-U-QQU<Indikativ<JegDem+LU
eqqanngooreermat	eqqaq-NNGUAQ-U-RIIR<Causativ<han
eqqannguusimavit	eqqaq-NNGUAQ-U+SIMA<Interrogativ<du
eqqannguuallaaratta	eqqaq-NNGUAQ-U+VALLAAR<Causativ<vi
eqqumiitsuliortoq	eqqumiitsuliortoq<ental<Absolut
eqqumiitsuliortutununa	eqqumiitsuliortoq<ental<Aequalis+UNA
eqqumiitsuliortuaana	eqqumiitsuliortoq<ental<hans<Absolut+UNA
eqqumiitsuliortumiilaartarnerli	eqqumiitsuliortoq<ental<Lokalis+IP-LAAR=TAR+NIQ+LI
eqqumiitsuliortumeeriartunga	eqqumiitsuliortoq<ental<Lokalis+IP-RIAR<Participium<jeg
eqqumiitsuliortora	eqqumiitsuliortoq<ental<min<Absolut
eqqumiitsuliortuni	eqqumiitsuliortoq<ental<sin<Absolut
eqqumiitsuliortukkullu	eqqumiitsuliortoq<ental<Vialis+LU
eqqumiitsuliortoriittut	eqqumiitsuliortoq+GIIT<flertal<Aequalis
eqqumiitsuliortorigaluartigilli	eqqumiitsuliortoq+GӘ+GALUAR<Imperativ<ViDem+LI
eqqumiitsuliortorisinnaatigit	eqqumiitsuliortoq+GӘ+SINNAA<Imperativ<ViDem
eqqumiitsuliortorivallaarakku	eqqumiitsuliortoq+GӘ+VALLAAR<Causativ<JegHam
eqqumiitsuliortuinnaa	eqqumiitsuliortoq-INNAQ<ental<hans<Absolut
eqqumiitsuliortuinnanngorlutik	eqqumiitsuliortoq-INNAQ-NNGUR<Ledsagemåde<de_selv
eqqumiitsuliortuinnaqassagaluarnerali	eqqumiitsuliortoq-INNAQ-QAR-SSA=GALUAR+NIQ<ental<hans<Absolut+LI
eqqumiitsuliortuinnaalertooriarnini	eqqumiitsuliortoq-INNAQ-U-LIR+TUQ-U-RIAR+NIQ<ental<sin<Absolut
eqqumiitsuliortukkulli	eqqumiitsuliortoq-KKUT<flertal<Absolut+LI
eqqumiitsuliortukkunneereerpit	eqqumiitsuliortoq-KKUT<flertal<Lokalis+IP-RIIR<Interrogativ<du
eqqumiitsuliortulik	eqqumiitsuliortoq-LIK<ental<Absolut
eqqumiitsuliortullinuna	eqqumiitsuliortoq-LIK<flertal<Absolut+UNA
eqqumiitsuliortulikka	eqqumiitsuliortoq-LIK<flertal<min<Absolut
eqqumiitsuliortullilli	eqqumiitsuliortoq-LIK<flertal<Relativ+LI
eqqumiitsuliortullinuna	eqqumiitsuliortoq-LIK<flertal<Relativ+UNA
eqqumiitsuliortulinngussagaluarnera	eqqumiitsuliortoq-LIK-NNGUR-SSA=GALUAR+NIQ<ental<hans<Absolut
eqqumiitsuliortormiunngulaartunga	eqqumiitsuliortoq+MIU-NNGUR-LAAR<Participium<jeg
eqqumiitsuliortormiunngortoq	eqqumiitsuliortoq+MIU-NNGUR+TUQ<ental<Absolut
eqqumiitsuliortunnguilu	eqqumiitsuliortoq-NNGUAQ<flertal<hans<Absolut+LU
eqqumiitsuliortunngooreertoq	eqqumiitsuliortoq-NNGUAQ-U-RIIR+TUQ<ental<Absolut
eqqumiitsuliortunngoqqaartuinnaqalerlutinguna	eqqumiitsuliortoq-NNGUR-QQAAR+TUQ-INNAQ-QAR-LIR<Ledsagemåde<de_selv+UNA
eqqumiitsuliortorpassuit	eqqumiitsuliortoq+PASSUAQ<flertal<Absolut
eqqumiitsuliortorpassuakka	eqqumiitsuliortoq+PASSUAQ<flertal<min<Absolut
eqqumiitsuliortorpassuakkali	eqqumiitsuliortoq+PASSUAQ<flertal<min<Absolut+LI
eqqumiitsuliortoqannginnama	eqqumiitsuliortoq-QAR-NNGIT<Causativ<jeg
eqqumiitsuliortoqaqqugakku	eqqumiitsuliortoq-QAR-QQU<Causativ<JegHam
eqqumiitsuliortoqaqqugakkuuna	eqqumiitsuliortoq-QAR-QQU<Causativ<JegHam+UNA
eqqumiitsuliortoqariarpit	eqqumiitsuliortoq-QAR-RIAR<Interrogativ<du
eqqumiitsuliortoqassagaluarlutillu	eqqumiitsuliortoq-QAR-SSA=GALUAR<Ledsagemåde<de_selv+LU
eqqumiitsuliortorsioqqaarpugulli	eqqumiitsuliortoq+SIUR-QQAAR<Indikativ<vi+LI
eqqumiitsuliortussatununa	eqqumiitsuliortoq-SSAQ<ental<Aequalis+UNA
eqqumiitsuliortussamilli	eqqumiitsuliortoq-SSAQ<ental<Instrumentalis+LI
eqqumiitsuliortussalerilaarpunga	eqqumiitsuliortoq-SSAQ-LIRI-LAAR<Indikativ<jeg
eqqumiitsuliortussaainnarpungaana	eqqumiitsuliortoq-SSAQ-U-INNAR<Indikativ<jeg+UNA
eqqumiitsuliortoorusukkatta	eqqumiitsuliortoq-U+GUSUP<Causativ<vi
eqqumiitsuliortuuvugullu	eqqumiitsuliortoq-U<Indikativ<vi+LU
eqqumiitsuliortuullutik	eqqumiitsuliortoq-U<Ledsagemåde<de_selv
eqqumiitsuliortooqqaarpoq	eqqumiitsuliortoq-U-QQAAR<Indikativ<han
eqqumiitsuliortooqqaarpunga	eqqumiitsuliortoq-U-QQAAR<Indikativ<jeg
eqqumiitsuliortooqqaarpit	eqqumiitsuliortoq-U-QQAAR<Interrogativ<du
eqqumiitsuliortooqqaartua	eqqumiitsuliortoq-U-QQAAR+TUQ<ental<hans<Absolut
eqqumiitsuliortooqqullugu	eqqumiitsuliortoq-U-QQU<Ledsagemåde<ham
eqqumiitsuliortooriartortaalaartarlutilli	eqqumiitsuliortoq-U-RIAR+TUQ+TAAR-LAAR=TAR<Ledsagemåde<de_selv+LI
eqqumiitsuliortooreerporuna	eqqumiitsuliortoq-U-RIIR<Indikativ<han+UNA
erniinnaq	erniinnaq<Partikel
erniinnarli	erniinnaq<Partikel+LI
erniinnarlu	erniinnaq<Partikel+LU
erniinnaruna	erniinnaq<Partikel+UNA
Esbjerg	Esbjerg<Absolut
Esbjergili	Esbjerg<Absolut+LI
Esbjergilu	Esbjerg<Absolut+LU
Esbjergiuna	Esbjerg<Absolut+UNA
Esbjergimik	Esbjerg<Instrumentalis
Esbjergimilli	Esbjerg<Instrumentalis+LI
Esbjergimillu	Esbjerg<Instrumentalis+LU
Esbjergiminguna	Esbjerg<Instrumentalis+UNA
Esbjergimi	Esbjerg<Lokalis
Esbjergimiikkusuttoqarpoq	Esbjerg<Lokalis+IP+GUSUP+TUQ-QAR<Indikativ<han
Esbjergimiilerput	Esbjerg<Lokalis+IP-LIR<Indikativ<de
Esbjergimiilerpit	Esbjerg<Lokalis+IP-LIR<Interrogativ<du
Esbjergimiilluarneq	Esbjerg<Lokalis+IP+LUAR+NIQ
Esbjergimiilluartoq	Esbjerg<Lokalis+IP+LUAR+TUQ
Esbjergimeeqqaarmata	Esbjerg<Lokalis+IP-QQAAR<Causativ<de
Esbjergimeeqqaarpit	Esbjerg<Lokalis+IP-QQAAR<Interrogativ<du
Esbjergimeeqqaarlutik	Esbjerg<Lokalis+IP-QQAAR<Ledsagemåde<de_selv
Esbjergimeeqqaarneq	Esbjerg<Lokalis+IP-QQAAR+NIQ
Esbjergimeeqqaarnerli	Esbjerg<Lokalis+IP-QQAAR+NIQ+LI
Esbjergimeeqqaartoqarpoq	Esbjerg<Lokalis+IP-QQAAR+TUQ-QAR<Indikativ<han
Esbjergimeeqqummanga	Esbjerg<Lokalis+IP-QQU<Causativ<HanMig
Esbjergimeeqqutigilli	Esbjerg<Lokalis+IP-QQU<Imperativ<ViDem+LI
Esbjergimeeqquallu	Esbjerg<Lokalis+IP-QQU<Indikativ<DuHam+LU
Esbjergimeeqquiuk	Esbjerg<Lokalis+IP-QQU<Interrogativ<DuHam
Esbjergimeeqqullugilli	Esbjerg<Lokalis+IP-QQU<Ledsagemåde<dem+LI
Esbjergimeeqqulluginuna	Esbjerg<Lokalis+IP-QQU<Ledsagemåde<dem+UNA
Esbjergimeeqqulluguli	Esbjerg<Lokalis+IP-QQU<Ledsagemåde<ham+LI
Esbjergimeeqqulara	Esbjerg<Lokalis+IP-QQU<Optativ<JegHam
Esbjergimeeqqularali	Esbjerg<Lokalis+IP-QQU<Optativ<JegHam+LI
Esbjergimeeriarpit	Esbjerg<Lokalis+IP-RIAR<Interrogativ<du
Esbjergimeeriarlutillu	Esbjerg<Lokalis+IP-RIAR<Ledsagemåde<de_selv+LU
Esbjergimeeriarlutinguna	Esbjerg<Lokalis+IP-RIAR<Ledsagemåde<de_selv+UNA
Esbjergimeeriarnerli	Esbjerg<Lokalis+IP-RIAR+NIQ+LI
Esbjergimeeriartut	Esbjerg<Lokalis+IP-RIAR<Participium<de
Esbjergimeeriartulli	Esbjerg<Lokalis+IP-RIAR<Participium<de+LI
Esbjergimeereerattalu	Esbjerg<Lokalis+IP-RIIR<Causativ<vi+LU
Esbjergimeereerlutinguna	Esbjerg<Lokalis+IP-RIIR<Ledsagemåde<de_selv+UNA
Esbjergimeereertulli	Esbjerg<Lokalis+IP-RIIR<Participium<de+LI
Esbjergimeereertoqanngilarli	Esbjerg<Lokalis+IP-RIIR+TUQ-QAR-NNGIT<Indikativ<han+LI
Esbjergimiittarlutinguna	Esbjerg<Lokalis+IP+TAR<Ledsagemåde<de_selv+UNA
Esbjergimiippallaartungalu	Esbjerg<Lokalis+IP+VALLAAR<Participium<jeg+LU
Esbjergimili	Esbjerg<Lokalis+LI
Esbjergimilu	Esbjerg<Lokalis+LU
Esbjergimiumilli	Esbjerg+MIU<ental<Instrumentalis+LI
Esbjergimiumi	Esbjerg+MIU<ental<Lokalis
Esbjergimiumiittaraluartunga	Esbjerg+MIU<ental<Lokalis+IP+TAR=GALUAR<Participium<jeg
Esbjergimiumukalaarlutik	Esbjerg+MIU<ental<Terminalis-KAR-LAAR<Ledsagemåde<de_selv
Esbjergimiuninguna	Esbjerg+MIU<flertal<Instrumentalis+UNA
Esbjergimiuneeqqularaana	Esbjerg+MIU<flertal<Lokalis+IP-QQU<Optativ<JegHam+UNA
Esbjergimiuneeriarlutilli	Esbjerg+MIU<flertal<Lokalis+IP-RIAR<Ledsagemåde<de_selv+LI
Esbjergimiuniuna	Esbjerg+MIU<flertal<Lokalis+UNA
Esbjergimiulerinatillu	Esbjerg+MIU-LIRI-NNGIT<Ledsagemåde<de_selv+LU
Esbjergimiunngulaartungalu	Esbjerg+MIU-NNGUR-LAAR<Participium<jeg+LU
Esbjergimioqarporuna	Esbjerg+MIU-QAR<Indikativ<han+UNA
Esbjergimioqarneq	Esbjerg+MIU-QAR+NIQ
Esbjergimioqarnerli	Esbjerg+MIU-QAR+NIQ+LI
Esbjergimioqarneruna	Esbjerg+MIU-QAR+NIQ+UNA
Esbjergimioqartoq	Esbjerg+MIU-QAR<Participium<han
Esbjergimioqartorli	Esbjerg+MIU-QAR<Participium<han+LI
Esbjergimioqartoruna	Esbjerg+MIU-QAR<Participium<han+UNA
Esbjergimioqartorli	Esbjerg+MIU-QAR+TUQ+LI
Esbjergimiuujunnaarmata	Esbjerg+MIU-U+GUNNAAR<Causativ<de
Esbjergimiuuit	Esbjerg+MIU-U<Interrogativ<du
Esbjergimiuulerput	Esbjerg+MIU-U-LIR<Indikativ<de
Esbjergimiuuniarnatilli	Esbjerg+MIU-U+NIAR=NNGIT<Ledsagemåde<de_selv+LI
Esbjergimiuuniartungali	Esbjerg+MIU-U+NIAR<Participium<jeg+LI
Esbjergimiuunertunngooqqaartoqassallutik	Esbjerg+MIU-U+NIR+TUQ-NNGUAQ-U-QQAAR+TUQ-QAR-SSA<Ledsagemåde<de_selv
Esbjergimiooreerattalu	Esbjerg+MIU-U-RIIR<Causativ<vi+LU
Esbjergimiooreerpunga	Esbjerg+MIU-U-RIIR<Indikativ<jeg
Esbjergimiooreerlutik	Esbjerg+MIU-U-RIIR<Ledsagemåde<de_selv
Esbjergimiooreertulli	Esbjerg+MIU-U-RIIR<Participium<de+LI
Esbjergimiooreertulilli	Esbjerg+MIU-U-RIIR+TUQ-LIK<ental<Absolut+LI
Esbjergimiuuallaarlutik	Esbjerg+MIU-U+VALLAAR<Ledsagemåde<de_selv
Esbjergimut	Esbjerg<Terminalis
Esbjergimukaannaramalu	Esbjerg<Terminalis-KAR-INNAR<Causativ<jeg+LU
Esbjergimukaannartoqarpoq	Esbjerg<Terminalis-KAR-INNAR+TUQ-QAR<Indikativ<han
Esbjergimukarpit	Esbjerg<Terminalis-KAR<Interrogativ<du
Esbjergimukalaarlutik	Esbjerg<Terminalis-KAR-LAAR<Ledsagemåde<de_selv
Esbjergimukalaartarmata	Esbjerg<Terminalis-KAR-LAAR=TAR<Causativ<de
Esbjergimukanngillalli	Esbjerg<Terminalis-KAR-NNGIT<Indikativ<de+LI
Esbjergimukanngillallu	Esbjerg<Terminalis-KAR-NNGIT<Indikativ<de+LU
Esbjergimukannginnerlu	Esbjerg<Terminalis-KAR-NNGIT+NIQ+LU
Esbjergimukariarpungaana	Esbjerg<Terminalis-KAR-RIAR<Indikativ<jeg+UNA
Esbjergimukareertoq	Esbjerg<Terminalis-KAR-RIIR+TUQ
Esbjergimukassagaluarpit	Esbjerg<Terminalis-KAR-SSA=GALUAR<Interrogativ<du
Esbjergimukassagaluartungaana	Esbjerg<Terminalis-KAR-SSA=GALUAR<Participium<jeg+UNA
Esbjergimukassaagullu	Esbjerg<Terminalis-KAR-SSA<Indikativ<vi+LU
Esbjergimukavimmallu	Esbjerg<Terminalis-KAR-VIP<Causativ<han+LU
Esbjergimukavippit	Esbjerg<Terminalis-KAR-VIP<Interrogativ<du
Esbjergimulli	Esbjerg<Terminalis+LI
Esbjergimullu	Esbjerg<Terminalis+LU
Esbjergimununa	Esbjerg<Terminalis+UNA
Esbjergikkut	Esbjerg<Vialis
Esbjergikkulli	Esbjerg<Vialis+LI
Esbjergikkullu	Esbjerg<Vialis+LU
Esbjergikkununa	Esbjerg<Vialis+UNA
fiistermallu	fiister<Causativ<han+LU
fiistermanuna	fiister<Causativ<han+UNA
fiisterama	fiister<Causativ<jeg
fiisteratta	fiister<Causativ<vi
fiisterattali	fiister<Causativ<vi+LI
fiisteraluarpit	fiister+GALUAR<Interrogativ<du
fiisteraluarlutik	fiister+GALUAR<Ledsagemåde<de_selv
fiisteriartorpunga	fiister+GIARTUR<Indikativ<jeg
fiisteriartorpugullu	fiister+GIARTUR<Indikativ<vi+LU
fiisteriartornera	fiister+GIARTUR+NIQ<ental<hans<Absolut
fiisteriartortussarsiulertulli	fiister+GIARTUR+TUQ-SSAQ+SIUR-LIR<Participium<de+LI
fiisterunnaarmalli	fiister+GUNNAAR<Causativ<han+LI
fiisterunnaartoorusukkamali	fiister+GUNNAAR+TUQ-U+GUSUP<Causativ<jeg+LI
fiisterunnaartuussagaluarnini	fiister+GUNNAAR+TUQ-U-SSA=GALUAR+NIQ<ental<sin<Absolut
fiisterusummat	fiister+GUSUP<Causativ<han
fiisterusukkattali	fiister+GUSUP<Causativ<vi+LI
fiisterpoq	fiister<Indikativ<han
fiistiinnarmat	fiister-INNAR<Causativ<han
fiistiinnarpugulli	fiister-INNAR<Indikativ<vi+LI
fiistiinnarpugullu	fiister-INNAR<Indikativ<vi+LU
fiistiinnarpit	fiister-INNAR<Interrogativ<du
fiistiinnarlutik	fiister-INNAR<Ledsagemåde<de_selv
fiistiinnartoq	fiister-INNAR<Participium<han
fiistiinnartunga	fiister-INNAR<Participium<jeg
fiistiinnartulereqqaartuinnaat	fiister-INNAR+TUQ-LIRI-QQAAR+TUQ-INNAQ<ental<deres<Absolut
fiistiinnartooriarpit	fiister-INNAR+TUQ-U-RIAR<Interrogativ<du
fiistilaarama	fiister-LAAR<Causativ<jeg
fiistilaarpunga	fiister-LAAR<Indikativ<jeg
fiistilaarpit	fiister-LAAR<Interrogativ<du
fiistilaarlutilli	fiister-LAAR<Ledsagemåde<de_selv+LI
fiistilaarnerali	fiister-LAAR+NIQ<ental<hans<Absolut+LI
fiistilaarnini	fiister-LAAR+NIQ<ental<sin<Absolut
fiistilaarninili	fiister-LAAR+NIQ<ental<sin<Absolut+LI
fiistilaartullu	fiister-LAAR<Participium<de+LU
fiistilaartarpunga	fiister-LAAR=TAR<Indikativ<jeg
fiistilaartarlutik	fiister-LAAR=TAR<Ledsagemåde<de_selv
fiistilaartarnini	fiister-LAAR=TAR+NIQ<ental<sin<Absolut
fiistilaartarninilu	fiister-LAAR=TAR+NIQ<ental<sin<Absolut+LU
fiistilaartarniniuna	fiister-LAAR=TAR+NIQ<ental<sin<Absolut+UNA
fiistilaartarnerneeqqaarpugut	fiister-LAAR=TAR+NIQ<flertal<Lokalis+IP-QQAAR<Indikativ<vi
fiistilaartartut	fiister-LAAR=TAR<Participium<de
fiistilaartartoorusunnermukarnerutoqarpoq	fiister-LAAR=TAR+TUQ-U+GUSUP+NIQ<ental<Terminalis-KAR+NIRU+TUQ-QAR<Indikativ<han
fiistilaartartuusarlutik	fiister-LAAR=TAR+TUQ-U+TAR<Ledsagemåde<de_selv
fiistilaartumalu	fiister-LAAR+TUQ<flertal<min>Relativ+LU
fiistilaartukkunnillu	fiister-LAAR+TUQ-KKUT<flertal<Instrumentalis+LU
fiistilaartoqalaaratta	fiister-LAAR+TUQ-QAR-LAAR<Causativ<vi
fiistilaartooqquiuk	fiister-LAAR+TUQ-U-QQU<Interrogativ<DuHam
fiisterlutillu	fiister<Ledsagemåde<de_selv+LU
fiistilerpunga	fiister-LIR<Indikativ<jeg
fiistilerpugut	fiister-LIR<Indikativ<vi
fiistilerpit	fiister-LIR<Interrogativ<du
fiistilerlutilli	fiister-LIR<Ledsagemåde<de_selv+LI
fiistilerlutinguna	fiister-LIR<Ledsagemåde<de_selv+UNA
fiistilernera	fiister-LIR+NIQ<ental<min<Absolut
fiistilernini	fiister-LIR+NIQ<ental<sin<Absolut
fiistilernerilli	fiister-LIR+NIQ<flertal<Relativ+LI
fiistilernerillu	fiister-LIR+NIQ<flertal<Relativ+LU
fiistilertoraana	fiister-LIR+TUQ<ental<min<Absolut+UNA
fiistilertulerereertorlu	fiister-LIR+TUQ-LIRI-RIIR<Participium<han+LU
fiistilertorpassuarnik	fiister-LIR+TUQ+PASSUAQ<flertal<Instrumentalis
fiistilertoqalermatali	fiister-LIR+TUQ-QAR-LIR<Causativ<de+LI
fiistilertorsiulerpit	fiister-LIR+TUQ+SIUR-LIR<Interrogativ<du
fiisterluarmallu	fiister+LUAR<Causativ<han+LU
fiisterluarpit	fiister+LUAR<Interrogativ<du
fiisternianngilatit	fiister+NIAR=NNGIT<Interrogativ<du
fiisterniannginnerit	fiister+NIAR=NNGIT+NIQ<flertal<Absolut
fiisternerilli	fiister+NIQ<flertal<Absolut+LI
fiisternerillu	fiister+NIQ<flertal<Absolut+LU
fiistinnginnama	fiister-NNGIT<Causativ<jeg
fiistinnginnatta	fiister-NNGIT<Causativ<vi
fiistinngilaq	fiister-NNGIT<Indikativ<han
fiistinngilagut	fiister-NNGIT<Indikativ<vi
fiistinngilatit	fiister-NNGIT<Interrogativ<du
fiisternatik	fiister-NNGIT<Ledsagemåde<de_selv
fiisternatillu	fiister-NNGIT<Ledsagemåde<de_selv+LU
fiisternatinguna	fiister-NNGIT<Ledsagemåde<de_selv+UNA
fiistinnginnerit	fiister-NNGIT+NIQ<flertal<Absolut
fiistinngitsoruna	fiister-NNGIT<Participium<han+UNA
fiistinngitsunga	fiister-NNGIT<Participium<jeg
fiistinngitsora	fiister-NNGIT+TUQ<ental<min<Absolut
fiistinngitsullilli	fiister-NNGIT+TUQ-LIK<flertal<Absolut+LI
fiistinngitsoqaannartumukaannarmat	fiister-NNGIT+TUQ-QAR-INNAR+TUQ<ental<Terminalis-KAR-INNAR<Causativ<han
fiistinngitsoqaqqugakku	fiister-NNGIT+TUQ-QAR-QQU<Causativ<JegHam
fiistinngitsoqavikkatta	fiister-NNGIT+TUQ-QAR-VIP<Causativ<vi
fiistinngitsorsiuippugununa	fiister-NNGIT+TUQ+SIUR-VIP<Indikativ<vi+UNA
fiistertullu	fiister<Participium<de+LU
fiisteqqaarmatalu	fiister-QQAAR<Causativ<de+LU
fiisteqqaaratta	fiister-QQAAR<Causativ<vi
fiisteqqaarput	fiister-QQAAR<Indikativ<de
fiisteqqaarpullu	fiister-QQAAR<Indikativ<de+LU
fiisteqqaarpoq	fiister-QQAAR<Indikativ<han
fiisteqqaarpungaana	fiister-QQAAR<Indikativ<jeg+UNA
fiisteqqaarpugullu	fiister-QQAAR<Indikativ<vi+LU
fiisteqqaarpit	fiister-QQAAR<Interrogativ<du
fiisteqqaartorlu	fiister-QQAAR<Participium<han+LU
fiisteqqaartungali	fiister-QQAAR<Participium<jeg+LI
fiisteqqaartukkunni	fiister-QQAAR+TUQ-KKUT<flertal<Lokalis
fiisteqqaartoqavittulerigaluarnera	fiister-QQAAR+TUQ-QAR-VIP+TUQ-LIRI+GALUAR+NIQ<ental<hans<Absolut
fiisteqqaartoorusuppoq	fiister-QQAAR+TUQ-U+GUSUP<Indikativ<han
fiisteqqaartooriaramali	fiister-QQAAR+TUQ-U-RIAR<Causativ<jeg+LI
fiisteqqummanga	fiister-QQU<Causativ<HanMig
fiisteqquaannga	fiister-QQU<Indikativ<DeMig
fiisteqquassili	fiister-QQU<Indikativ<JegJer+LI
fiisteqquiuk	fiister-QQU<Interrogativ<DuHam
fiisteqqullugit	fiister-QQU<Ledsagemåde<dem
fiisteqqullugilli	fiister-QQU<Ledsagemåde<dem+LI
fiisteqqullugu	fiister-QQU<Ledsagemåde<ham
fiisteqqulara	fiister-QQU<Optativ<JegHam
fiisteriarmalli	fiister-RIAR<Causativ<han+LI
fiisteriarpoq	fiister-RIAR<Indikativ<han
fiisteriarpugulli	fiister-RIAR<Indikativ<vi+LI
fiisteriarlutilli	fiister-RIAR<Ledsagemåde<de_selv+LI
fiisteriarnini	fiister-RIAR+NIQ<ental<sin<Absolut
fiisteriartoq	fiister-RIAR<Participium<han
fiisteriartungalu	fiister-RIAR<Participium<jeg+LU
fiisteriartooqqaartussalereriartorpassuakka	fiister-RIAR+TUQ-U-QQAAR+TUQ-SSAQ-LIRI-RIAR+TUQ+PASSUAQ<flertal<min<Absolut
fiisteriartooqquiuk	fiister-RIAR+TUQ-U-QQU<Interrogativ<DuHam
fiistereermallu	fiister-RIIR<Causativ<han+LU
fiistereerama	fiister-RIIR<Causativ<jeg
fiistereeratta	fiister-RIIR<Causativ<vi
fiistereerpunga	fiister-RIIR<Indikativ<jeg
fiistereerpugulli	fiister-RIIR<Indikativ<vi+LI
fiistereerpit	fiister-RIIR<Interrogativ<du
fiistereerlutik	fiister-RIIR<Ledsagemåde<de_selv
fiistereerlutillu	fiister-RIIR<Ledsagemåde<de_selv+LU
fiistereernini	fiister-RIIR+NIQ<ental<sin<Absolut
fiistereernerilli	fiister-RIIR+NIQ<flertal<Relativ+LI
fiistereertununa	fiister-RIIR<Participium<de+UNA
fiistereertungalu	fiister-RIIR<Participium<jeg+LU
fiistereertui	fiister-RIIR+TUQ<flertal<hans<Absolut
fiistersimagamalu	fiister+SIMA<Causativ<jeg+LU
fiistersimavugullu	fiister+SIMA<Indikativ<vi+LU
fiistersimasarpulli	fiister+SIMA=TAR<Indikativ<de+LI
fiistersimasarnerli	fiister+SIMA=TAR+NIQ<ental<Absolut+LI
fiistersimasarnertullu	fiister+SIMA=TAR+NIQ<ental<Aequalis+LU
fiistersimasarnini	fiister+SIMA=TAR+NIQ<ental<sin<Absolut
fiistersimasartungali	fiister+SIMA=TAR<Participium<jeg+LI
fiistersinnaagattaana	fiister+SINNAA<Causativ<vi+UNA
fiistersinnaavoq	fiister+SINNAA<Indikativ<han
fiistissagamaana	fiister-SSA<Causativ<jeg+UNA
fiistissagattalu	fiister-SSA<Causativ<vi+LU
fiistissagaluaramali	fiister-SSA=GALUAR<Causativ<jeg+LI
fiistissagaluarpugut	fiister-SSA=GALUAR<Indikativ<vi
fiistissagaluarpit	fiister-SSA=GALUAR<Interrogativ<du
fiistissagaluarlutik	fiister-SSA=GALUAR<Ledsagemåde<de_selv
fiistissagaluarlutilli	fiister-SSA=GALUAR<Ledsagemåde<de_selv+LI
fiistissagaluarnertut	fiister-SSA=GALUAR+NIQ<ental<Aequalis
fiistissagaluarnini	fiister-SSA=GALUAR+NIQ<ental<sin<Absolut
fiistissagaluartullu	fiister-SSA=GALUAR<Participium<de+LU
fiistissagaluartussaq	fiister-SSA=GALUAR+TUQ-SSAQ<ental<Absolut
fiistissagaluartoorusullutinguna	fiister-SSA=GALUAR+TUQ-U+GUSUP<Ledsagemåde<de_selv+UNA
fiistissavit	fiister-SSA<Interrogativ<du
fiistissallutik	fiister-SSA<Ledsagemåde<de_selv
fiistissasulli	fiister-SSA<Participium<de+LI
fiistertaraluartussarli	fiister+TAR=GALUAR+TUQ-SSAQ<ental<Absolut+LI
fiistertarlutik	fiister+TAR<Ledsagemåde<de_selv
fiistertartunngussagaluarlutinguna	fiister+TAR+TUQ-NNGUR-SSA=GALUAR<Ledsagemåde<de_selv+UNA
fiistertoq	fiister+TUQ<ental<Absolut
fiistertunngussagaluarpungalu	fiister+TUQ-NNGUR-SSA=GALUAR<Indikativ<jeg+LU
fiisterpallaarpugut	fiister+VALLAAR<Indikativ<vi
fiisterpallaarpit	fiister+VALLAAR<Interrogativ<du
fiisterpallaanngillat	fiister+VALLAAR=NNGIT<Indikativ<de
fiisterpallaannginneralli	fiister+VALLAAR=NNGIT+NIQ<ental<deres+LI
fiisterpallaannginnini	fiister+VALLAAR=NNGIT+NIQ<ental<sin<Absolut
fiisterpallaanngitsullu	fiister+VALLAAR=NNGIT<Participium<de+LU
fiisterpallaanngitsorlu	fiister+VALLAAR=NNGIT<Participium<han+LU
fiistivimmatali	fiister-VIP<Causativ<de+LI
fiistivimmat	fiister-VIP<Causativ<han
fiistivimmanuna	fiister-VIP<Causativ<han+UNA
fiistivikkama	fiister-VIP<Causativ<jeg
fiistivikkamali	fiister-VIP<Causativ<jeg+LI
fiistivikkattali	fiister-VIP<Causativ<vi+LI
fiistivillutik	fiister-VIP<Ledsagemåde<de_selv
fiistivillutinguna	fiister-VIP<Ledsagemåde<de_selv+UNA
fiistivittuinnarsiulerpungali	fiister-VIP+TUQ-INNAQ+SIUR-LIR<Indikativ<jeg+LI
Finland	Finland<Absolut
Finlandili	Finland<Absolut+LI
Finlandilu	Finland<Absolut+LU
Finlandiuna	Finland<Absolut+UNA
Finlandimik	Finland<Instrumentalis
Finlandimilli	Finland<Instrumentalis+LI
Finlandimillu	Finland<Instrumentalis+LU
Finlandiminguna	Finland<Instrumentalis+UNA
Finlandimi	Finland<Lokalis
Finlandimiilaarnerli	Finland<Lokalis+IP-LAAR+NIQ+LI
Finlandimiilaartoq	Finland<Lokalis+IP-LAAR+TUQ
Finlandimiilernerlu	Finland<Lokalis+IP-LIR+NIQ+LU
Finlandimeeqqaarmatali	Finland<Lokalis+IP-QQAAR<Causativ<de+LI
Finlandimeeqqaarlutilli	Finland<Lokalis+IP-QQAAR<Ledsagemåde<de_selv+LI
Finlandimeeqqaarlutinguna	Finland<Lokalis+IP-QQAAR<Ledsagemåde<de_selv+UNA
Finlandimeeqqaarneruna	Finland<Lokalis+IP-QQAAR+NIQ+UNA
Finlandimeeqqaartullu	Finland<Lokalis+IP-QQAAR<Participium<de+LU
Finlandimeeqqaartoqarporuna	Finland<Lokalis+IP-QQAAR+TUQ-QAR<Indikativ<han+UNA
Finlandimeeqqaartoqanngilarli	Finland<Lokalis+IP-QQAAR+TUQ-QAR-NNGIT<Indikativ<han+LI
Finlandimeeqqutigilli	Finland<Lokalis+IP-QQU<Imperativ<ViDem+LI
Finlandimeeqquaannga	Finland<Lokalis+IP-QQU<Indikativ<DeMig
Finlandimeeqquiuk	Finland<Lokalis+IP-QQU<Interrogativ<DuHam
Finlandimeeqqullugulu	Finland<Lokalis+IP-QQU<Ledsagemåde<ham+LU
Finlandimeeqqulara	Finland<Lokalis+IP-QQU<Optativ<JegHam
Finlandimeeqqularaana	Finland<Lokalis+IP-QQU<Optativ<JegHam+UNA
Finlandimeeriarnerli	Finland<Lokalis+IP-RIAR+NIQ+LI
Finlandimeereerpoq	Finland<Lokalis+IP-RIIR<Indikativ<han
Finlandimeereerpugullu	Finland<Lokalis+IP-RIIR<Indikativ<vi+LU
Finlandimeereerpit	Finland<Lokalis+IP-RIIR<Interrogativ<du
Finlandimeereerlutilli	Finland<Lokalis+IP-RIIR<Ledsagemåde<de_selv+LI
Finlandimeereerlutinguna	Finland<Lokalis+IP-RIIR<Ledsagemåde<de_selv+UNA
Finlandimiissaagulli	Finland<Lokalis+IP-SSA<Indikativ<vi+LI
Finlandimiissasoruna	Finland<Lokalis+IP-SSA<Participium<han+UNA
Finlandimilu	Finland<Lokalis+LU
Finlandimiuna	Finland<Lokalis+UNA
Finlandimiumillu	Finland+MIU<ental<Instrumentalis+LU
Finlandimiumeeriarlutik	Finland+MIU<ental<Lokalis+IP-RIAR<Ledsagemåde<de_selv
Finlandimiumeereerpit	Finland+MIU<ental<Lokalis+IP-RIIR<Interrogativ<du
Finlandimiuneeqqaarneq	Finland+MIU<flertal<Lokalis+IP-QQAAR+NIQ
Finlandimiuneeqquiuk	Finland+MIU<flertal<Lokalis+IP-QQU<Interrogativ<DuHam
Finlandimiulerilluartunngortaraluartorli	Finland+MIU-LIRI+LUAR+TUQ-NNGUR+TAR=GALUAR<Participium<han+LI
Finlandimiulerinerlutilli	Finland+MIU-LIRI+NIR<Ledsagemåde<de_selv+LI
Finlandimiulereqqaartullu	Finland+MIU-LIRI-QQAAR<Participium<de+LU
Finlandimioqarpoq	Finland+MIU-QAR<Indikativ<han
Finlandimioqarporli	Finland+MIU-QAR<Indikativ<han+LI
Finlandimioqarporuna	Finland+MIU-QAR<Indikativ<han+UNA
Finlandimioqarneq	Finland+MIU-QAR+NIQ
Finlandimioqartoq	Finland+MIU-QAR<Participium<han
Finlandimioqartorli	Finland+MIU-QAR<Participium<han+LI
Finlandimioqartoq	Finland+MIU-QAR+TUQ
Finlandimiuugaluarpungalu	Finland+MIU-U+GALUAR<Indikativ<jeg+LU
Finlandimioorusummat	Finland+MIU-U+GUSUP<Causativ<han
Finlandimiooqqutigilli	Finland+MIU-U-QQU<Imperativ<ViDem+LI
Finlandimiooqquat	Finland+MIU-U-QQU<Indikativ<DuHam
Finlandimiooqquiuk	Finland+MIU-U-QQU<Interrogativ<DuHam
Finlandimiooriarnera	Finland+MIU-U-RIAR+NIQ<ental<hans<Absolut
Finlandimut	Finland<Terminalis
Finlandimukaannarpunga	Finland<Terminalis-KAR-INNAR<Indikativ<jeg
Finlandimukaannarpit	Finland<Terminalis-KAR-INNAR<Interrogativ<du
Finlandimukalaartarmatalu	Finland<Terminalis-KAR-LAAR=TAR<Causativ<de+LU
Finlandimukalaartartoqanngilaq	Finland<Terminalis-KAR-LAAR=TAR+TUQ-QAR-NNGIT<Indikativ<han
Finlandimukalerneq	Finland<Terminalis-KAR-LIR+NIQ
Finlandimukarnianngilatit	Finland<Terminalis-KAR+NIAR=NNGIT<Interrogativ<du
Finlandimukaqqaartut	Finland<Terminalis-KAR-QQAAR<Participium<de
Finlandimukaqqaartunga	Finland<Terminalis-KAR-QQAAR<Participium<jeg
Finlandimukariarmata	Finland<Terminalis-KAR-RIAR<Causativ<de
Finlandimukariarmataana	Finland<Terminalis-KAR-RIAR<Causativ<de+UNA
Finlandimukassagaluarpugulli	Finland<Terminalis-KAR-SSA=GALUAR<Indikativ<vi+LI
Finlandimukassagaluarneq	Finland<Terminalis-KAR-SSA=GALUAR+NIQ
Finlandimukartarlutik	Finland<Terminalis-KAR+TAR<Ledsagemåde<de_selv
Finlandimukavimmata	Finland<Terminalis-KAR-VIP<Causativ<de
Finlandimulli	Finland<Terminalis+LI
Finlandimullu	Finland<Terminalis+LU
Finlandimununa	Finland<Terminalis+UNA
Finlandikkut	Finland<Vialis
Finlandikkulli	Finland<Vialis+LI
Finlandikkullu	Finland<Vialis+LU
Finlandikkununa	Finland<Vialis+UNA
Gentofte	Gentofte<Absolut
Gentofteli	Gentofte<Absolut+LI
Gentoftelu	Gentofte<Absolut+LU
Gentofteuna	Gentofte<Absolut+UNA
Gentoftemik	Gentofte<Instrumentalis
Gentoftemilli	Gentofte<Instrumentalis+LI
Gentoftemillu	Gentofte<Instrumentalis+LU
Gentofteminguna	Gentofte<Instrumentalis+UNA
Gentoftemi	Gentofte<Lokalis
Gentoftemiiginnarlutilli	Gentofte<Lokalis+IP-INNAR<Ledsagemåde<de_selv+LI
Gentoftemiilaarlutik	Gentofte<Lokalis+IP-LAAR<Ledsagemåde<de_selv
Gentoftemiilerneq	Gentofte<Lokalis+IP-LIR+NIQ
Gentoftemiinneq	Gentofte<Lokalis+IP+NIQ
Gentoftemeeqqaarpununa	Gentofte<Lokalis+IP-QQAAR<Indikativ<de+UNA
Gentoftemeeqqaarpit	Gentofte<Lokalis+IP-QQAAR<Interrogativ<du
Gentoftemeeqqaarlutik	Gentofte<Lokalis+IP-QQAAR<Ledsagemåde<de_selv
Gentoftemeeqqullugillu	Gentofte<Lokalis+IP-QQU<Ledsagemåde<dem+LU
Gentoftemeeqqullugu	Gentofte<Lokalis+IP-QQU<Ledsagemåde<ham
Gentoftemeeqqulara	Gentofte<Lokalis+IP-QQU<Optativ<JegHam
Gentoftemeeqqularaana	Gentofte<Lokalis+IP-QQU<Optativ<JegHam+UNA
Gentoftemeeriarpunga	Gentofte<Lokalis+IP-RIAR<Indikativ<jeg
Gentoftemeeriarnerli	Gentofte<Lokalis+IP-RIAR+NIQ+LI
Gentoftemeeriartulli	Gentofte<Lokalis+IP-RIAR<Participium<de+LI
Gentoftemeeriartunga	Gentofte<Lokalis+IP-RIAR<Participium<jeg
Gentoftemeeriartoqarpoq	Gentofte<Lokalis+IP-RIAR+TUQ-QAR<Indikativ<han
Gentoftemeereermalli	Gentofte<Lokalis+IP-RIIR<Causativ<han+LI
Gentoftemeereerpunga	Gentofte<Lokalis+IP-RIIR<Indikativ<jeg
Gentoftemeereerpungali	Gentofte<Lokalis+IP-RIIR<Indikativ<jeg+LI
Gentoftemeereerpit	Gentofte<Lokalis+IP-RIIR<Interrogativ<du
Gentoftemeereerneq	Gentofte<Lokalis+IP-RIIR+NIQ
Gentoftemeereertut	Gentofte<Lokalis+IP-RIIR<Participium<de
Gentoftemeereertoqanngilaq	Gentofte<Lokalis+IP-RIIR+TUQ-QAR-NNGIT<Indikativ<han
Gentoftemiissallutinguna	Gentofte<Lokalis+IP-SSA<Ledsagemåde<de_selv+UNA
Gentoftemili	Gentofte<Lokalis+LI
Gentoftemilu	Gentofte<Lokalis+LU
Gentoftemiuna	Gentofte<Lokalis+UNA
Gentoftemiuat	Gentofte+MIU<ental<deres<Absolut
Gentoftemiumukaqqaarneruna	Gentofte+MIU<ental<Terminalis-KAR-QQAAR+NIQ+UNA
Gentoftemiumukavimmallu	Gentofte+MIU<ental<Terminalis-KAR-VIP<Causativ<han+LU
Gentoftemiumullu	Gentofte+MIU<ental<Terminalis+LU
Gentoftemiuneeriarneq	Gentofte+MIU<flertal<Lokalis+IP-RIAR+NIQ
Gentoftemiunukavillutinguna	Gentofte+MIU<flertal<Terminalis-KAR-VIP<Ledsagemåde<de_selv+UNA
Gentoftemiunngoqqaarpoq	Gentofte+MIU-NNGUR-QQAAR<Indikativ<han
Gentoftemiunngoreerporlu	Gentofte+MIU-NNGUR-RIIR<Indikativ<han+LU
Gentoftemiunngorpallaanngitsoq	Gentofte+MIU-NNGUR+VALLAAR=NNGIT<Participium<han
Gentoftemioqarunnaartoq	Gentofte+MIU-QAR+GUNNAAR<Participium<han
Gentoftemioqaqqutiginuna	Gentofte+MIU-QAR-QQU<Imperativ<ViDem+UNA
Gentoftemioqaqquassili	Gentofte+MIU-QAR-QQU<Indikativ<JegJer+LI
Gentoftemioqartoq	Gentofte+MIU-QAR+TUQ
Gentoftemiusioqqaartorlu	Gentofte+MIU+SIUR-QQAAR+TUQ+LU
Gentoftemiusiussasorli	Gentofte+MIU+SIUR-SSA<Participium<han+LI
Gentoftemiutaareerneq	Gentofte+MIU+TAAR-RIIR+NIQ
Gentoftemiutaareertoq	Gentofte+MIU+TAAR-RIIR<Participium<han
Gentoftemioorusukkama	Gentofte+MIU-U+GUSUP<Causativ<jeg
Gentoftemioorusuppit	Gentofte+MIU-U+GUSUP<Interrogativ<du
Gentoftemioorusunnini	Gentofte+MIU-U+GUSUP+NIQ<ental<sin<Absolut
Gentoftemioorusuttunga	Gentofte+MIU-U+GUSUP<Participium<jeg
Gentoftemiuunianngimmallu	Gentofte+MIU-U+NIAR=NNGIT<Causativ<han+LU
Gentoftemiooqqutigillu	Gentofte+MIU-U-QQU<Imperativ<ViDem+LU
Gentoftemiooqquaralu	Gentofte+MIU-U-QQU<Indikativ<JegHam+LU
Gentoftemiooriartorli	Gentofte+MIU-U-RIAR<Participium<han+LI
Gentoftemiooriartunga	Gentofte+MIU-U-RIAR<Participium<jeg
Gentoftemiooreerlutillu	Gentofte+MIU-U-RIIR<Ledsagemåde<de_selv+LU
Gentoftemiooreertukka	Gentofte+MIU-U-RIIR+TUQ<flertal<min<Absolut
Gentoftemiuusimavoruna	Gentofte+MIU-U+SIMA<Indikativ<han+UNA
Gentoftemut	Gentofte<Terminalis
Gentoftemukaraluarmata	Gentofte<Terminalis-KAR+GALUAR<Causativ<de
Gentoftemukalaarlutillu	Gentofte<Terminalis-KAR-LAAR<Ledsagemåde<de_selv+LU
Gentoftemukalaartaratta	Gentofte<Terminalis-KAR-LAAR=TAR<Causativ<vi
Gentoftemukalaartarlutik	Gentofte<Terminalis-KAR-LAAR=TAR<Ledsagemåde<de_selv
Gentoftemukalaartartunga	Gentofte<Terminalis-KAR-LAAR=TAR<Participium<jeg
Gentoftemukalermallu	Gentofte<Terminalis-KAR-LIR<Causativ<han+LU
Gentoftemukalertut	Gentofte<Terminalis-KAR-LIR<Participium<de
Gentoftemukanngilatit	Gentofte<Terminalis-KAR-NNGIT<Interrogativ<du
Gentoftemukanngitsoruna	Gentofte<Terminalis-KAR-NNGIT+TUQ+UNA
Gentoftemukaqqaarpungalu	Gentofte<Terminalis-KAR-QQAAR<Indikativ<jeg+LU
Gentoftemukaqqaarpugununa	Gentofte<Terminalis-KAR-QQAAR<Indikativ<vi+UNA
Gentoftemukaqqullugu	Gentofte<Terminalis-KAR-QQU<Ledsagemåde<ham
Gentoftemukaqqulara	Gentofte<Terminalis-KAR-QQU<Optativ<JegHam
Gentoftemukareerlutillu	Gentofte<Terminalis-KAR-RIIR<Ledsagemåde<de_selv+LU
Gentoftemukassagaluarpugullu	Gentofte<Terminalis-KAR-SSA=GALUAR<Indikativ<vi+LU
Gentoftemukassaagununa	Gentofte<Terminalis-KAR-SSA<Indikativ<vi+UNA
Gentoftemukassasorlu	Gentofte<Terminalis-KAR-SSA<Participium<han+LU
Gentoftemukarpallaarmanuna	Gentofte<Terminalis-KAR+VALLAAR<Causativ<han+UNA
Gentoftemukavinneruna	Gentofte<Terminalis-KAR-VIP+NIQ+UNA
Gentoftemulli	Gentofte<Terminalis+LI
Gentoftemullu	Gentofte<Terminalis+LU
Gentoftemununa	Gentofte<Terminalis+UNA
Gentoftekkut	Gentofte<Vialis
Gentoftekkulli	Gentofte<Vialis+LI
Gentoftekkullu	Gentofte<Vialis+LU
Gentoftekkununa	Gentofte<Vialis+UNA
guitarermata	guitarer<Causativ<de
guitareraluarpit	guitarer+GALUAR<Interrogativ<du
guitareriartorlutilli	guitarer+GIARTUR<Ledsagemåde<de_selv+LI
guitarerunnaartoq	guitarer+GUNNAAR<Participium<han
guitarerunnaartuinnanngoreernini	guitarer+GUNNAAR+TUQ-INNAQ-NNGUR-RIIR+NIQ<ental<sin<Absolut
guitarerunnaartukkunneeqqaarpit	guitarer+GUNNAAR+TUQ-KKUT<flertal<Lokalis+IP-QQAAR<Interrogativ<du
guitarerusummat	guitarer+GUSUP<Causativ<han
guitarerusukkama	guitarer+GUSUP<Causativ<jeg
guitarerpullu	guitarer<Indikativ<de+LU
guitariinnarmataana	guitarer-INNAR<Causativ<de+UNA
guitariinnarpullu	guitarer-INNAR<Indikativ<de+LU
guitariinnarpugut	guitarer-INNAR<Indikativ<vi
guitariinnarpit	guitarer-INNAR<Interrogativ<du
guitariinnarlutik	guitarer-INNAR<Ledsagemåde<de_selv
guitariinnarnerali	guitarer-INNAR+NIQ<ental<hans<Absolut+LI
guitariinnarninili	guitarer-INNAR+NIQ<ental<sin<Absolut+LI
guitariinnartoq	guitarer-INNAR+TUQ<ental<Absolut
guitariinnartormioqarpoq	guitarer-INNAR+TUQ+MIU-QAR<Indikativ<han
guitariinnartoqalaartarpit	guitarer-INNAR+TUQ-QAR-LAAR=TAR<Interrogativ<du
guitariinnartoqalerpit	guitarer-INNAR+TUQ-QAR-LIR<Interrogativ<du
guitariinnartuulaarlutillu	guitarer-INNAR+TUQ-U-LAAR<Ledsagemåde<de_selv+LU
guitariinnartuusinnaasoruna	guitarer-INNAR+TUQ-U+SINNAA+TUQ<ental<Absolut+UNA
guitarilaarmataana	guitarer-LAAR<Causativ<de+UNA
guitarilaarama	guitarer-LAAR<Causativ<jeg
guitarilaarput	guitarer-LAAR<Indikativ<de
guitarilaarpunga	guitarer-LAAR<Indikativ<jeg
guitarilaarpit	guitarer-LAAR<Interrogativ<du
guitarilaarnini	guitarer-LAAR+NIQ<ental<sin<Absolut
guitarilaarninilu	guitarer-LAAR+NIQ<ental<sin<Absolut+LU
guitarilaarniniuna	guitarer-LAAR+NIQ<ental<sin<Absolut+UNA
guitarilaartut	guitarer-LAAR<Participium<de
guitarilaartununa	guitarer-LAAR<Participium<de+UNA
guitarilaartungali	guitarer-LAAR<Participium<jeg+LI
guitarilaartungalu	guitarer-LAAR<Participium<jeg+LU
guitarilaartungaana	guitarer-LAAR<Participium<jeg+UNA
guitarilaartarmat	guitarer-LAAR=TAR<Causativ<han
guitarilaartaratta	guitarer-LAAR=TAR<Causativ<vi
guitarilaartarattali	guitarer-LAAR=TAR<Causativ<vi+LI
guitarilaartarpugulli	guitarer-LAAR=TAR<Indikativ<vi+LI
guitarilaartarpit	guitarer-LAAR=TAR<Interrogativ<du
guitarilaartarnertullu	guitarer-LAAR=TAR+NIQ<ental<Aequalis+LU
guitarilaartarniniuna	guitarer-LAAR=TAR+NIQ<ental<sin<Absolut+UNA
guitarilaartarnernillu	guitarer-LAAR=TAR+NIQ<flertal<Instrumentalis+LU
guitarilaartarnerilli	guitarer-LAAR=TAR+NIQ<flertal<Relativ+LI
guitarilaartartunga	guitarer-LAAR=TAR<Participium<jeg
guitarilaartartullit	guitarer-LAAR=TAR+TUQ-LIK<flertal<Absolut
guitarilaartartussaalaartaratta	guitarer-LAAR=TAR+TUQ-SSAQ-U-LAAR=TAR<Causativ<vi
guitarilaartartoorusuppugut	guitarer-LAAR=TAR+TUQ-U+GUSUP<Indikativ<vi
guitarilaartartuuinnarlutinguna	guitarer-LAAR=TAR+TUQ-U-INNAR<Ledsagemåde<de_selv+UNA
guitarilaartartooqqulara	guitarer-LAAR=TAR+TUQ-U-QQU<Optativ<JegHam
guitarilaartoqalerama	guitarer-LAAR+TUQ-QAR-LIR<Causativ<jeg
guitarilaartoqanngitsoq	guitarer-LAAR+TUQ-QAR-NNGIT<Participium<han
guitarerlutik	guitarer<Ledsagemåde<de_selv
guitarilermallu	guitarer-LIR<Causativ<han+LU
guitarilermanuna	guitarer-LIR<Causativ<han+UNA
guitarilerpoq	guitarer-LIR<Indikativ<han
guitarilerpungaana	guitarer-LIR<Indikativ<jeg+UNA
guitarilerpugulli	guitarer-LIR<Indikativ<vi+LI
guitarilerpugullu	guitarer-LIR<Indikativ<vi+LU
guitarilerpugununa	guitarer-LIR<Indikativ<vi+UNA
guitarilerpit	guitarer-LIR<Interrogativ<du
guitarilerlutilli	guitarer-LIR<Ledsagemåde<de_selv+LI
guitarilernerali	guitarer-LIR+NIQ<ental<hans<Absolut+LI
guitarilerneraana	guitarer-LIR+NIQ<ental<hans<Absolut+UNA
guitarilertoq	guitarer-LIR<Participium<han
guitarilertungalu	guitarer-LIR<Participium<jeg+LU
guitarilertukkui	guitarer-LIR+TUQ-KKUT<flertal<hans<Absolut
guitarilertoqalaartarninili	guitarer-LIR+TUQ-QAR-LAAR=TAR+NIQ<ental<sin<Absolut+LI
guitarilertoqaqqummangali	guitarer-LIR+TUQ-QAR-QQU<Causativ<HanMig+LI
guitarerluarama	guitarer+LUAR<Causativ<jeg
guitarerluartortaannarpit	guitarer+LUAR+TUQ+TAAR-INNAR<Interrogativ<du
guitarernianngimmallu	guitarer+NIAR=NNGIT<Causativ<han+LU
guitarernikuummallu	guitarer+NIKUU<Causativ<han+LU
guitarerninilu	guitarer+NIQ<ental<sin<Absolut+LU
guitarernerni	guitarer+NIQ<flertal<Lokalis
guitarernerit	guitarer+NIQ<flertal<Relativ
guitarernerlutik	guitarer+NIR<Ledsagemåde<de_selv
guitarernerlutinguna	guitarer+NIR<Ledsagemåde<de_selv+UNA
guitarernertunga	guitarer+NIR<Participium<jeg
guitarerneruneq	guitarer+NIRU+NIQ<ental<Absolut
guitarinngimmalli	guitarer-NNGIT<Causativ<han+LI
guitarinnginnattali	guitarer-NNGIT<Causativ<vi+LI
guitarinngillalli	guitarer-NNGIT<Indikativ<de+LI
guitarinngilanga	guitarer-NNGIT<Indikativ<jeg
guitarinnginninili	guitarer-NNGIT+NIQ<ental<sin<Absolut+LI
guitarinngitsut	guitarer-NNGIT<Participium<de
guitarinngitsorli	guitarer-NNGIT<Participium<han+LI
guitarinngitsussaqalertussaqaannarmat	guitarer-NNGIT+TUQ-SSAQ-QAR-LIR+TUQ-SSAQ-QAR-INNAR<Causativ<han
guitarertunga	guitarer<Participium<jeg
guitareqqaarmataana	guitarer-QQAAR<Causativ<de+UNA
guitareqqaarattali	guitarer-QQAAR<Causativ<vi+LI
guitareqqaarpununa	guitarer-QQAAR<Indikativ<de+UNA
guitareqqaarlutilli	guitarer-QQAAR<Ledsagemåde<de_selv+LI
guitareqqaarneq	guitarer-QQAAR+NIQ<ental<Absolut
guitareqqaarneralu	guitarer-QQAAR+NIQ<ental<hans<Absolut+LU
guitareqqaartorsiuinnarpugut	guitarer-QQAAR+TUQ+SIUR-INNAR<Indikativ<vi
guitareqqaartooqqularaana	guitarer-QQAAR+TUQ-U-QQU<Optativ<JegHam+UNA
guitareqqugakkulu	guitarer-QQU<Causativ<JegHam+LU
guitareqqutigit	guitarer-QQU<Imperativ<ViDem
guitareqqutigilli	guitarer-QQU<Imperativ<ViDem+LI
guitareqqutiginuna	guitarer-QQU<Imperativ<ViDem+UNA
guitareqquaalli	guitarer-QQU<Indikativ<DeHam+LI
guitareqquarali	guitarer-QQU<Indikativ<JegHam+LI
guitareqquassi	guitarer-QQU<Indikativ<JegJer
guitareqqulluguuna	guitarer-QQU<Ledsagemåde<ham+UNA
guitareqqulara	guitarer-QQU<Optativ<JegHam
guitareqqularaana	guitarer-QQU<Optativ<JegHam+UNA
guitareriarmata	guitarer-RIAR<Causativ<de
guitareriarattali	guitarer-RIAR<Causativ<vi+LI
guitareriarpulli	guitarer-RIAR<Indikativ<de+LI
guitareriarnini	guitarer-RIAR+NIQ<ental<sin<Absolut
guitarereermata	guitarer-RIIR<Causativ<de
guitarereermat	guitarer-RIIR<Causativ<han
guitarereerama	guitarer-RIIR<Causativ<jeg
guitarereerattaana	guitarer-RIIR<Causativ<vi+UNA
guitarereerpununa	guitarer-RIIR<Indikativ<de+UNA
guitarereerpunga	guitarer-RIIR<Indikativ<jeg
guitarereerpit	guitarer-RIIR<Interrogativ<du
guitarereernerilli	guitarer-RIIR+NIQ<flertal<Absolut+LI
guitarereernerninguna	guitarer-RIIR+NIQ<flertal<Instrumentalis+UNA
guitarereertuili	guitarer-RIIR+TUQ<flertal<hans<Absolut+LI
guitarereertorsiorneruvugut	guitarer-RIIR+TUQ+SIUR+NIRU<Indikativ<vi
guitarereertuusimasooriartoq	guitarer-RIIR+TUQ-U+SIMA+TUQ-U-RIAR<Participium<han
guitarersimagama	guitarer+SIMA<Causativ<jeg
guitarersimasarpit	guitarer+SIMA=TAR<Interrogativ<du
guitarersinnaagama	guitarer+SINNAA<Causativ<jeg
guitarersinnaasulli	guitarer+SINNAA<Participium<de+LI
guitarissammata	guitarer-SSA<Causativ<de
guitarissagaluarmatali	guitarer-SSA=GALUAR<Causativ<de+LI
guitarissagaluarmat	guitarer-SSA=GALUAR<Causativ<han
guitarissagaluaramalu	guitarer-SSA=GALUAR<Causativ<jeg+LU
guitarissagaluarlutinguna	guitarer-SSA=GALUAR<Ledsagemåde<de_selv+UNA
guitarissagaluarnera	guitarer-SSA=GALUAR+NIQ<ental<min<Absolut
guitarissagaluarnini	guitarer-SSA=GALUAR+NIQ<ental<sin<Absolut
guitarissagaluarnerneeqqaarpit	guitarer-SSA=GALUAR+NIQ<flertal<Lokalis+IP-QQAAR<Interrogativ<du
guitarissagaluarnerilli	guitarer-SSA=GALUAR+NIQ<flertal<Relativ+LI
guitarissagaluartuneeqqulara	guitarer-SSA=GALUAR+TUQ<flertal<Lokalis+IP-QQU<Optativ<JegHam
guitarissagaluartoqassappulli	guitarer-SSA=GALUAR+TUQ-QAR-SSA<Indikativ<de+LI
guitarissappulli	guitarer-SSA<Indikativ<de+LI
guitarissaanga	guitarer-SSA<Indikativ<jeg
guitarissaangali	guitarer-SSA<Indikativ<jeg+LI
guitarissavit	guitarer-SSA<Interrogativ<du
guitarissallutik	guitarer-SSA<Ledsagemåde<de_selv
guitarissasulli	guitarer-SSA<Participium<de+LI
guitarertaraluarnerinuna	guitarer+TAR=GALUAR+NIQ<flertal<Relativ+UNA
guitarertaraluartulli	guitarer+TAR=GALUAR<Participium<de+LI
guitarertaraluartorpassuarnukanngitsungali	guitarer+TAR=GALUAR+TUQ+PASSUAQ<flertal<Terminalis-KAR-NNGIT<Participium<jeg+LI
guitarertarpungali	guitarer+TAR<Indikativ<jeg+LI
guitarertarlutilli	guitarer+TAR<Ledsagemåde<de_selv+LI
guitarertartormiulerigamali	guitarer+TAR+TUQ+MIU-LIRI<Causativ<jeg+LI
guitarertuinnaqalaartulli	guitarer+TUQ-INNAQ-QAR-LAAR<Participium<de+LI
guitarertoqaqqulara	guitarer+TUQ-QAR-QQU<Optativ<JegHam
guitarerpallaarpununa	guitarer+VALLAAR<Indikativ<de+UNA
guitarerpallaannginnamaana	guitarer+VALLAAR=NNGIT<Causativ<jeg+UNA
guitarivimmat	guitarer-VIP<Causativ<han
guitarivimmallu	guitarer-VIP<Causativ<han+LU
guitarivimmanuna	guitarer-VIP<Causativ<han+UNA
guitarivipporlu	guitarer-VIP<Indikativ<han+LU
guitarivippunga	guitarer-VIP<Indikativ<jeg
guitarivillutinguna	guitarer-VIP<Ledsagemåde<de_selv+UNA
guitarivinnerali	guitarer-VIP+NIQ<ental<hans<Absolut+LI
guitarivinnini	guitarer-VIP+NIQ<ental<sin<Absolut
guitarivittut	guitarer-VIP<Participium<de
guitarivittunngussallutilli	guitarer-VIP+TUQ-NNGUR-SSA<Ledsagemåde<de_selv+LI
ikiortili	ikiurtә<ental<Absolut+LI
ikiortiuna	ikiurtә<ental<Absolut+UNA
ikiortaali	ikiurtә<ental<hans<Absolut+LI
ikiortiniuna	ikiurtә<ental<sin<Absolut+UNA
ikiortigineqartoriivi	ikiurtә+GӘ+NIQAR+TUQ+GIIT<flertal<hans<Absolut
ikiortigereertigilli	ikiurtә+GӘ-RIIR<Imperativ<ViDem+LI
ikiortigisimavakka	ikiurtә+GӘ+SIMA<Indikativ<JegDem
ikiortigivallaannginagu	ikiurtә+GӘ+VALLAAR=NNGIT<Ledsagemåde<ham
ikiortikkuiuna	ikiurtә-KKUT<flertal<hans<Absolut+UNA
ikiortikkunni	ikiurtә-KKUT<flertal<Lokalis
ikiortikkunneeqqutigillu	ikiurtә-KKUT<flertal<Lokalis+IP-QQU<Imperativ<ViDem+LU
ikiortillinuna	ikiurtә-LIK<flertal<Absolut+UNA
ikiortilerissagaluartoqaannartuuallaanngilagununa	ikiurtә-LIRI-SSA=GALUAR+TUQ-QAR-INNAR+TUQ-U+VALLAAR=NNGIT<Indikativ<vi+UNA
ikiortinnguulluaratta	ikiurtә-NNGUAQ-U+LUAR<Causativ<vi
ikiortinnguusaraluartooqquassi	ikiurtә-NNGUAQ-U+TAR=GALUAR+TUQ-U-QQU<Indikativ<JegJer
ikiortinngoriartut	ikiurtә-NNGUR-RIAR<Participium<de
ikiorterpassui	ikiurtә+PASSUAQ<flertal<hans<Absolut
ikiorterpassuakkaana	ikiurtә+PASSUAQ<flertal<min<Absolut+UNA
ikiorterpassuarnullu	ikiurtә+PASSUAQ<flertal<Terminalis+LU
ikiorteqanngitsullu	ikiurtә-QAR-NNGIT<Participium<de+LU
ikiorteqariarnerneeqqaarnerlu	ikiurtә-QAR-RIAR+NIQ<flertal<Lokalis+IP-QQAAR+NIQ+LU
ikiorteqassallutinguna	ikiurtә-QAR-SSA<Ledsagemåde<de_selv+UNA
ikiortisiulaartarnerneeqqaartulli	ikiurtә+SIUR-LAAR=TAR+NIQ<flertal<Lokalis+IP-QQAAR<Participium<de+LI
ikiortisioriarmalli	ikiurtә+SIUR-RIAR<Causativ<han+LI
ikiortissamununa	ikiurtә-SSAQ<ental<Terminalis+UNA
ikiortissanilli	ikiurtә-SSAQ<flertal<Instrumentalis+LI
ikiortissama	ikiurtә-SSAQ<flertal<min>Relativ
ikiortissalereriarpit	ikiurtә-SSAQ-LIRI-RIAR<Interrogativ<du
ikiortissanngulertukkunninguna	ikiurtә-SSAQ-NNGUR-LIR+TUQ-KKUT<flertal<Instrumentalis+UNA
ikiortitaalertoriinnarlugulu	ikiurtә+TAAR-LIR+TUQ+GӘ-INNAR<Ledsagemåde<ham+LU
ilaajuna	ilaa<Partikel+UNA
ilamili	ila<ental<Lokalis+LI
ilaannaalli	ila-INNAQ<ental<deres<Absolut+LI
ilaannanngoqqaarneq	ila-INNAQ-NNGUR-QQAAR+NIQ<ental<Absolut
ilalererusunneq	ila-LIRI+GUSUP+NIQ<ental<Absolut
ilannguili	ila-NNGUAQ<flertal<hans<Absolut+LI
ilannguanngoriartulimmut	ila-NNGUAQ-NNGUR-RIAR+TUQ-LIK<ental<Terminalis
ilanngooqquassi	ila-NNGUAQ-U-QQU<Indikativ<JegJer
ilaqareertoorusummatali	ila-QAR-RIIR+TUQ-U+GUSUP<Causativ<de+LI
ilataaqquaanga	ila+TAAR-QQU<Indikativ<HanMig
ilataaqquarali	ila+TAAR-QQU<Indikativ<JegHam+LI
ilaasinnaasullilli	ila-U+SINNAA+TUQ-LIK<flertal<Relativ+LI
ilinniariartorpit	ilinniar+GIARTUR<Interrogativ<du
ilinniarunnaarlutik	ilinniar+GUNNAAR<Ledsagemåde<de_selv
ilinniarusummatali	ilinniar+GUSUP<Causativ<de+LI
ilinniarusukkamalu	ilinniar+GUSUP<Causativ<jeg+LU
ilinniarnerpungalu	ilinniar+NIR<Indikativ<jeg+LU
ilinniarnatilli	ilinniar-NNGIT<Ledsagemåde<de_selv+LI
ilinniaqqaarporlu	ilinniar-QQAAR<Indikativ<han+LU
ilinniaqqulluguli	ilinniar-QQU<Ledsagemåde<ham+LI
ilinniariarmalli	ilinniar-RIAR<Causativ<han+LI
ilinniareerpullu	ilinniar-RIIR<Indikativ<de+LU
ilinniassagaluarmata	ilinniar-SSA=GALUAR<Causativ<de
Ilisimatusarfillu	Ilisimatusarfik<ental<Absolut+LU
Ilisimatusarfimmi	Ilisimatusarfik<ental<Lokalis
Ilisimatusarfimmiinneq	Ilisimatusarfik<ental<Lokalis+IP+NIQ
Ilisimatusarfimmeeriarpit	Ilisimatusarfik<ental<Lokalis+IP-RIAR<Interrogativ<du
Ilisimatusarfii	Ilisimatusarfik<flertal<hans<Absolut
Ilisimatusarfinni	Ilisimatusarfik<flertal<Lokalis
Ilisimatusarfigilaarpiuk	Ilisimatusarfik+GӘ-LAAR<Interrogativ<DuHam
Ilisimatusarfigisinnaallugu	Ilisimatusarfik+GӘ+SINNAA<Ledsagemåde<ham
Ilisimatusarfikkuili	Ilisimatusarfik-KKUT<flertal<hans<Absolut+LI
Ilisimatusarfillillu	Ilisimatusarfik-LIK<flertal<Relativ+LU
Ilisimatusarfippassuartullu	Ilisimatusarfik+PASSUAQ<flertal<Aequalis+LU
Ilisimatusarfeqaannarpoq	Ilisimatusarfik-QAR-INNAR<Indikativ<han
Ilisimatusarfeqaannarneq	Ilisimatusarfik-QAR-INNAR+NIQ
Ilisimatusarfeqaannarnerlu	Ilisimatusarfik-QAR-INNAR+NIQ+LU
Ilisimatusarfeqaannartorli	Ilisimatusarfik-QAR-INNAR<Participium<han+LI
Ilisimatusarfeqalaarneq	Ilisimatusarfik-QAR-LAAR+NIQ
Ilisimatusarfeqalaartarneq	Ilisimatusarfik-QAR-LAAR=TAR+NIQ
Ilisimatusarfeqanngilaq	Ilisimatusarfik-QAR-NNGIT<Indikativ<han
Ilisimatusarfeqanngitsoruna	Ilisimatusarfik-QAR-NNGIT<Participium<han+UNA
Ilisimatusarfeqariarnerli	Ilisimatusarfik-QAR-RIAR+NIQ+LI
Ilisimatusarfeqareerporli	Ilisimatusarfik-QAR-RIIR<Indikativ<han+LI
Ilisimatusarfeqareertorlu	Ilisimatusarfik-QAR-RIIR+TUQ+LU
Ilisimatusarfeqarsimasarnerli	Ilisimatusarfik-QAR+SIMA=TAR+NIQ+LI
Ilisimatusarfeqassaaq	Ilisimatusarfik-QAR-SSA<Indikativ<han
Ilisimatusarfeqassasoq	Ilisimatusarfik-QAR-SSA<Participium<han
Ilisimatusarfissioreertunga	Ilisimatusarfik+SIUR-RIIR<Participium<jeg
Ilisimatusarfissiuipporli	Ilisimatusarfik+SIUR-VIP<Indikativ<han+LI
illoqarfimmukareerama	illoqarfik<ental<Terminalis-KAR-RIIR<Causativ<jeg
illoqarfimmiulerivallaannginatik	illoqarfik+MIU-LIRI+VALLAAR=NNGIT<Ledsagemåde<de_selv
illoqarfeqanngitsoq	illoqarfik-QAR-NNGIT<Participium<han
illoqarfeqaqquiuk	illoqarfik-QAR-QQU<Interrogativ<DuHam
illoqarfeqassaangalu	illoqarfik-QAR-SSA<Indikativ<jeg+LU
illoqarfittaareerlutik	illoqarfik+TAAR-RIIR<Ledsagemåde<de_selv
Illoqqortoormiulli	Illoqqortoormiut<Absolut+LI
Illoqqortoormiullu	Illoqqortoormiut<Absolut+LU
Illoqqortoormiununa	Illoqqortoormiut<Absolut+UNA
Illoqqortoormiuni	Illoqqortoormiut<Lokalis
Illoqqortoormiuniippit	Illoqqortoormiut<Lokalis+IP<Interrogativ<du
Illoqqortoormiuneeqqummanga	Illoqqortoormiut<Lokalis+IP-QQU<Causativ<HanMig
Illoqqortoormiormiumillu	Illoqqortoormiut+MIU<ental<Instrumentalis+LU
Illoqqortoormiormiumeereertoqanngilaruna	Illoqqortoormiut+MIU<ental<Lokalis+IP-RIIR+TUQ-QAR-NNGIT<Indikativ<han+UNA
Illoqqortoormiormiunnguinnarlutik	Illoqqortoormiut+MIU-NNGUR-INNAR<Ledsagemåde<de_selv
Illoqqortoormiormiunnguinnarnera	Illoqqortoormiut+MIU-NNGUR-INNAR+NIQ<ental<hans<Absolut
Illoqqortoormiormiunngulerpit	Illoqqortoormiut+MIU-NNGUR-LIR<Interrogativ<du
Illoqqortoormiormioqarneq	Illoqqortoormiut+MIU-QAR+NIQ
Illoqqortoormiormioqartoq	Illoqqortoormiut+MIU-QAR+TUQ
Illoqqortoormiormiuulaartullu	Illoqqortoormiut+MIU-U-LAAR<Participium<de+LU
Illoqqortoormiormiuulaartartussamali	Illoqqortoormiut+MIU-U-LAAR=TAR+TUQ-SSAQ<flertal<min>Relativ+LI
Illoqqortoormiormiooqqaarmatali	Illoqqortoormiut+MIU-U-QQAAR<Causativ<de+LI
Illoqqortoormiormiooqqaartoqassagatta	Illoqqortoormiut+MIU-U-QQAAR+TUQ-QAR-SSA<Causativ<vi
Illoqqortoormiunut	Illoqqortoormiut<Terminalis
Illoqqortoormiunukaannarama	Illoqqortoormiut<Terminalis-KAR-INNAR<Causativ<jeg
Illoqqortoormiunukaqqaartoqarporuna	Illoqqortoormiut<Terminalis-KAR-QQAAR+TUQ-QAR<Indikativ<han+UNA
Illoqqortoormiunulli	Illoqqortoormiut<Terminalis+LI
Illoqqortoormiunullu	Illoqqortoormiut<Terminalis+LU
illugiit	illu+GIIT<flertal<Absolut
illunngoriarlutilli	illu-NNGUR-RIAR<Ledsagemåde<de_selv+LI
illorpassuit	illu+PASSUAQ<flertal<Absolut
illorpassuarniilermallu	illu+PASSUAQ<flertal<Lokalis+IP-LIR<Causativ<han+LU
illorpassuakkalu	illu+PASSUAQ<flertal<min<Absolut+LU
illoqavikkama	illu-QAR-VIP<Causativ<jeg
illutaariarnini	illu+TAAR-RIAR+NIQ<ental<sin<Absolut
illooriartoq	illu-U-RIAR<Participium<han
illooreerninili	illu-U-RIIR+NIQ<ental<sin<Absolut+LI
Ilulissallu	Ilulissat<Absolut+LU
Ilulissanillu	Ilulissat<Instrumentalis+LU
Ilulissaneeqqulara	Ilulissat<Lokalis+IP-QQU<Optativ<JegHam
Iluliarmiumik	Ilulissat+MIU<ental<Instrumentalis
Iluliarmiuniuna	Ilulissat+MIU<flertal<Lokalis+UNA
Iluliarmioqarpoq	Ilulissat+MIU-QAR<Indikativ<han
Iluliarmioqarporli	Ilulissat+MIU-QAR<Indikativ<han+LI
Iluliarmioqarporlu	Ilulissat+MIU-QAR<Indikativ<han+LU
Iluliarmioqarnerlu	Ilulissat+MIU-QAR+NIQ+LU
Iluliarmioqartoq	Ilulissat+MIU-QAR+TUQ
Iluliarmiuugaluarmata	Ilulissat+MIU-U+GALUAR<Causativ<de
Iluliarmiuunianngilagut	Ilulissat+MIU-U+NIAR=NNGIT<Indikativ<vi
Iluliarmiooqqaarmata	Ilulissat+MIU-U-QQAAR<Causativ<de
Iluliarmiuusarlutinguna	Ilulissat+MIU-U+TAR<Ledsagemåde<de_selv+UNA
Iluliarmiuusarnerilli	Ilulissat+MIU-U+TAR+NIQ<flertal<Absolut+LI
Ilulissanukalaartartoq	Ilulissat<Terminalis-KAR-LAAR=TAR+TUQ
Ilulissanukartartoq	Ilulissat<Terminalis-KAR+TAR+TUQ
Ilulissanununa	Ilulissat<Terminalis+UNA
imaalluarpugulli	imaap+LUAR<Indikativ<vi+LI
imaannermulli	imaap+NIQ<ental<Terminalis+LI
imaattarlutillu	imaap+TAR<Ledsagemåde<de_selv+LU
imatullu	imatut<Partikel+LU
imatununa	imatut<Partikel+UNA
imiinnarattalu	imer-INNAR<Causativ<vi+LU
imiinnarpoq	imer-INNAR<Indikativ<han
imiinnarpit	imer-INNAR<Interrogativ<du
imiinnartungali	imer-INNAR<Participium<jeg+LI
imiinnartoqarsinnaavunga	imer-INNAR+TUQ-QAR+SINNAA<Indikativ<jeg
imilaarpugununa	imer-LAAR<Indikativ<vi+UNA
imilaartarpit	imer-LAAR=TAR<Interrogativ<du
imilaartarlutilli	imer-LAAR=TAR<Ledsagemåde<de_selv+LI
imerluarnerneeqqaaratta	imer+LUAR+NIQ<flertal<Lokalis+IP-QQAAR<Causativ<vi
iminnginnatta	imer-NNGIT<Causativ<vi
imertorli	imer<Participium<han+LI
imeqqaarnini	imer-QQAAR+NIQ<ental<sin<Absolut
imeqquassi	imer-QQU<Indikativ<JegJer
imeqqulara	imer-QQU<Optativ<JegHam
imeqqularali	imer-QQU<Optativ<JegHam+LI
imeriarpit	imer-RIAR<Interrogativ<du
imereermatali	imer-RIIR<Causativ<de+LI
imissallutik	imer-SSA<Ledsagemåde<de_selv
imertarninilu	imer+TAR+NIQ<ental<sin<Absolut+LU
imivittulereqquiuk	imer-VIP+TUQ-LIRI-QQU<Interrogativ<DuHam
immaqa	immaqa<Partikel
immikkut	immikkut<Partikel
immiussilaartunngoorusunnini	immiussi-LAAR+TUQ-NNGUAQ-U+GUSUP+NIQ<ental<sin<Absolut
immiussissallutik	immiussi-SSA<Ledsagemåde<de_selv
inersimasoq	inersimasoq<ental<Absolut
inersimasunik	inersimasoq<flertal<Instrumentalis
inersimasunilli	inersimasoq<flertal<Instrumentalis+LI
inersimasuinnaat	inersimasoq-INNAQ<flertal<Relativ
inersimasukkununa	inersimasoq-KKUT<flertal<Absolut+UNA
inersimasukkunninguna	inersimasoq-KKUT<flertal<Instrumentalis+UNA
inersimasunngussaaq	inersimasoq-NNGUR-SSA<Indikativ<han
inersimasorpassui	inersimasoq+PASSUAQ<flertal<hans<Absolut
inersimasorsiunngitsorlu	inersimasoq+SIUR-NNGIT+TUQ+LU
inersimasussakkaana	inersimasoq-SSAQ<flertal<min<Absolut+UNA
inersimasortaarpoq	inersimasoq+TAAR<Indikativ<han
inersimasooqqugakku	inersimasoq-U-QQU<Causativ<JegHam
ingerlagattalu	ingerla<Causativ<vi+LU
ingerlalernini	ingerla-LIR+NIQ<ental<sin<Absolut
ingerlalertuinnaqanngilatit	ingerla-LIR+TUQ-INNAQ-QAR-NNGIT<Interrogativ<du
ingerlanikuuvorlu	ingerla+NIKUU<Indikativ<han+LU
ingerlaneruninili	ingerla+NIRU+NIQ<ental<sin<Absolut+LI
ingerlassagattali	ingerla-SSA<Causativ<vi+LI
inulli	inuk<ental<Absolut+LI
inunguna	inuk<ental<Absolut+UNA
inummik	inuk<ental<Instrumentalis
inummeeqqaarama	inuk<ental<Lokalis+IP-QQAAR<Causativ<jeg
inuppassui	inuk+PASSUAQ<flertal<hans<Absolut
inuppassuakkali	inuk+PASSUAQ<flertal<min<Absolut+LI
inoqaannarnerli	inuk-QAR-INNAR+NIQ+LI
inoqalaartoruna	inuk-QAR-LAAR+TUQ+UNA
inoqalernerli	inuk-QAR-LIR+NIQ+LI
inoqalertoruna	inuk-QAR-LIR+TUQ+UNA
inooqqullugit	inuk-U-QQU<Ledsagemåde<dem
inunnguinnartununa	inunngor-INNAR<Participium<de+UNA
inunngulaartarlutik	inunngor-LAAR=TAR<Ledsagemåde<de_selv
inoorusummat	inuu+GUSUP<Causativ<han
inoorusummallu	inuu+GUSUP<Causativ<han+LU
inooriarpunga	inuu-RIAR<Indikativ<jeg
inooreerpit	inuu-RIIR<Interrogativ<du
isumamalu	isuma<ental<min>Relativ+LU
isumaali	isuma<flertal<hans<Absolut+LI
isumaauna	isuma<flertal<hans<Absolut+UNA
isumanik	isuma<flertal<Instrumentalis
isumani	isuma<flertal<Lokalis
isumakkali	isuma<flertal<min<Absolut+LI
isumama	isuma<flertal<min>Relativ
isumagiilerivallaanngilatit	isuma+GIIT-LIRI+VALLAAR=NNGIT<Interrogativ<du
isumagiinnguinnaratta	isuma+GIIT-NNGUR-INNAR<Causativ<vi
isumagiinngoqqaarmataana	isuma+GIIT-NNGUR-QQAAR<Causativ<de+UNA
isumagivikkakku	isuma+GӘ-VIP<Causativ<JegHam
isumaannanngulaarlutinguna	isuma-INNAQ-NNGUR-LAAR<Ledsagemåde<de_selv+UNA
isumaannanngoqqaartunga	isuma-INNAQ-NNGUR-QQAAR<Participium<jeg
isumaannaqassagaluarlutik	isuma-INNAQ-QAR-SSA=GALUAR<Ledsagemåde<de_selv
isumakkui	isuma-KKUT<flertal<hans<Absolut
isumallit	isuma-LIK<flertal<Absolut
isumallillu	isuma-LIK<flertal<Absolut+LU
isumalilerereertunga	isuma-LIK-LIRI-RIIR<Participium<jeg
isumaleriniarnini	isuma-LIRI+NIAR+NIQ<ental<sin<Absolut
isumalereqqaarnerilli	isuma-LIRI-QQAAR+NIQ<flertal<Absolut+LI
isumamiooreermata	isuma+MIU-U-RIIR<Causativ<de
isumanngooqqaartoqavimmalli	isuma-NNGUAQ-U-QQAAR+TUQ-QAR-VIP<Causativ<han+LI
isumanngulaartarpungalu	isuma-NNGUR-LAAR=TAR<Indikativ<jeg+LU
isumanngoqqaartunga	isuma-NNGUR-QQAAR<Participium<jeg
isumarpassuilli	isuma+PASSUAQ<flertal<Absolut+LI
isumarpassuakka	isuma+PASSUAQ<flertal<min<Absolut
isumaqarnatinguna	isumaqar-NNGIT<Ledsagemåde<de_selv+UNA
isumasiorluartunga	isuma+SIUR+LUAR<Participium<jeg
isumasiuinnerallu	isuma+SIUR-VIP+NIQ<ental<deres+LU
isumassatulli	isuma-SSAQ<ental<Aequalis+LI
isumassalerillutilli	isuma-SSAQ-LIRI<Ledsagemåde<de_selv+LI
isumataassasut	isuma+TAAR-SSA<Participium<de
isumataavimmata	isuma+TAAR-VIP<Causativ<de
Ivittuut	Ivittuut<Absolut
Ivittuulli	Ivittuut<Absolut+LI
Ivittuullu	Ivittuut<Absolut+LU
Ivittuununa	Ivittuut<Absolut+UNA
Ivittuunik	Ivittuut<Instrumentalis
Ivittuunilli	Ivittuut<Instrumentalis+LI
Ivittuunillu	Ivittuut<Instrumentalis+LU
Ivittuuni	Ivittuut<Lokalis
Ivittuuniilluarlutik	Ivittuut<Lokalis+IP+LUAR<Ledsagemåde<de_selv
Ivittuuneeqqaarnerli	Ivittuut<Lokalis+IP-QQAAR+NIQ+LI
Ivittuuneeqquassilu	Ivittuut<Lokalis+IP-QQU<Indikativ<JegJer+LU
Ivittuuneeriarlutik	Ivittuut<Lokalis+IP-RIAR<Ledsagemåde<de_selv
Ivittuuneereerpit	Ivittuut<Lokalis+IP-RIIR<Interrogativ<du
Ivittuuneereerlutik	Ivittuut<Lokalis+IP-RIIR<Ledsagemåde<de_selv
Ivittuuneereerlutilli	Ivittuut<Lokalis+IP-RIIR<Ledsagemåde<de_selv+LI
Ivittuuniissimasunga	Ivittuut<Lokalis+IP+SIMA<Participium<jeg
Ivittuunili	Ivittuut<Lokalis+LI
Ivittuunilu	Ivittuut<Lokalis+LU
Ivittuuniuna	Ivittuut<Lokalis+UNA
Ivittoormiumullu	Ivittuut+MIU<ental<Terminalis+LU
Ivittoormiumununa	Ivittuut+MIU<ental<Terminalis+UNA
Ivittoormiunik	Ivittuut+MIU<flertal<Instrumentalis
Ivittoormiuniilaartartoqarporuna	Ivittuut+MIU<flertal<Lokalis+IP-LAAR=TAR+TUQ-QAR<Indikativ<han+UNA
Ivittoormiuneeqqularaana	Ivittuut+MIU<flertal<Lokalis+IP-QQU<Optativ<JegHam+UNA
Ivittoormiulerivit	Ivittuut+MIU-LIRI<Interrogativ<du
Ivittoormiulereriarattali	Ivittuut+MIU-LIRI-RIAR<Causativ<vi+LI
Ivittoormiulerisinnaanernukassagaluarnerli	Ivittuut+MIU-LIRI+SINNAA+NIQ<flertal<Terminalis-KAR-SSA=GALUAR+NIQ+LI
Ivittoormiulerisaraluarpit	Ivittuut+MIU-LIRI+TAR=GALUAR<Interrogativ<du
Ivittoormiunngoqqaarpungalu	Ivittuut+MIU-NNGUR-QQAAR<Indikativ<jeg+LU
Ivittoormiunngussagaluarniniuna	Ivittuut+MIU-NNGUR-SSA=GALUAR+NIQ<ental<sin<Absolut+UNA
Ivittoormioqarneq	Ivittuut+MIU-QAR+NIQ
Ivittoormioqarneruna	Ivittuut+MIU-QAR+NIQ+UNA
Ivittoormioqartorli	Ivittuut+MIU-QAR<Participium<han+LI
Ivittoormioqartoq	Ivittuut+MIU-QAR+TUQ
Ivittoormioqartorlu	Ivittuut+MIU-QAR+TUQ+LU
Ivittoormiuugamali	Ivittuut+MIU-U<Causativ<jeg+LI
Ivittoormiuujunnaartuinnaaniartut	Ivittuut+MIU-U+GUNNAAR+TUQ-INNAQ-U+NIAR<Participium<de
Ivittoormioorusummat	Ivittuut+MIU-U+GUSUP<Causativ<han
Ivittoormioorusummanuna	Ivittuut+MIU-U+GUSUP<Causativ<han+UNA
Ivittoormioorusuppulli	Ivittuut+MIU-U+GUSUP<Indikativ<de+LI
Ivittoormiuupput	Ivittuut+MIU-U<Indikativ<de
Ivittoormiuulaarlutilli	Ivittuut+MIU-U-LAAR<Ledsagemåde<de_selv+LI
Ivittoormiuunikuuniniuna	Ivittuut+MIU-U+NIKUU+NIQ<ental<sin<Absolut+UNA
Ivittoormiuunera	Ivittuut+MIU-U+NIQ<ental<hans<Absolut
Ivittoormiuunernera	Ivittuut+MIU-U+NIR+NIQ<ental<hans<Absolut
Ivittoormiooqqaarpit	Ivittuut+MIU-U-QQAAR<Interrogativ<du
Ivittoormiooriarama	Ivittuut+MIU-U-RIAR<Causativ<jeg
Ivittoormiooriarnerit	Ivittuut+MIU-U-RIAR+NIQ<flertal<Relativ
Ivittoormiooriartunga	Ivittuut+MIU-U-RIAR<Participium<jeg
Ivittoormiooreertuma	Ivittuut+MIU-U-RIIR+TUQ<flertal<min>Relativ
Ivittoormiuusinnaavit	Ivittuut+MIU-U+SINNAA<Interrogativ<du
Ivittoormiuuallaanngitsoq	Ivittuut+MIU-U+VALLAAR=NNGIT<Participium<han
Ivittoormiuuippulli	Ivittuut+MIU-U-VIP<Indikativ<de+LI
Ivittuunukaqqulara	Ivittuut<Terminalis-KAR-QQU<Optativ<JegHam
Ivittuunukareerpit	Ivittuut<Terminalis-KAR-RIIR<Interrogativ<du
Ivittuunukareertoqarpoq	Ivittuut<Terminalis-KAR-RIIR+TUQ-QAR<Indikativ<han
Ivittuunukassallutik	Ivittuut<Terminalis-KAR-SSA<Ledsagemåde<de_selv
Ivittuunulli	Ivittuut<Terminalis+LI
Ivittuunullu	Ivittuut<Terminalis+LU
Ivittuunununa	Ivittuut<Terminalis+UNA
kalaaleq	kalaaleq<ental<Absolut
kalaallimik	kalaaleq<ental<Instrumentalis
kalaallimillu	kalaaleq<ental<Instrumentalis+LU
kalaallimi	kalaaleq<ental<Lokalis
kalaallimiinnerullutik	kalaaleq<ental<Lokalis+IP+NIRU<Ledsagemåde<de_selv
kalaallimeeqqutigilli	kalaaleq<ental<Lokalis+IP-QQU<Imperativ<ViDem+LI
kalaallimeereernerli	kalaaleq<ental<Lokalis+IP-RIIR+NIQ+LI
kalaallikkulli	kalaaleq<ental<Vialis+LI
kalaallikkununa	kalaaleq<ental<Vialis+UNA
kalaallinik	kalaaleq<flertal<Instrumentalis
kalaallininguna	kalaaleq<flertal<Instrumentalis+UNA
kalaaliinnalererusuppit	kalaaleq-INNAQ-LIRI+GUSUP<Interrogativ<du
kalaalillilli	kalaaleq-LIK<flertal<Relativ+LI
kalaalinnguunertut	kalaaleq-NNGUAQ-U+NIR<Participium<de
kalaalinngorniannginneranuna	kalaaleq-NNGUR+NIAR=NNGIT+NIQ<ental<deres+UNA
kalaaleqalaartartoq	kalaaleq-QAR-LAAR=TAR<Participium<han
kalaaleqaqqutigilli	kalaaleq-QAR-QQU<Imperativ<ViDem+LI
kalaaleqassagaluarneq	kalaaleq-QAR-SSA=GALUAR+NIQ
kalaaleqassagaluartoq	kalaaleq-QAR-SSA=GALUAR<Participium<han
kalaalissaaqqullugu	kalaaleq-SSAQ-U-QQU<Ledsagemåde<ham
kalaalertaalaartarlutillu	kalaaleq+TAAR-LAAR=TAR<Ledsagemåde<de_selv+LU
kalaaliorusullutilli	kalaaleq-U+GUSUP<Ledsagemåde<de_selv+LI
kalaalioqqaarnerma	kalaaleq-U-QQAAR+NIQ<ental<min>Relativ
kalaallisulli	kalaallisut<Partikel+LI
kalaallisullu	kalaallisut<Partikel+LU
kalaallisununa	kalaallisut<Partikel+UNA
Kangaatsiaq	Kangaatsiaq<Absolut
Kangaatsiarli	Kangaatsiaq<Absolut+LI
Kangaatsiarlu	Kangaatsiaq<Absolut+LU
Kangaatsiaruna	Kangaatsiaq<Absolut+UNA
Kangaatsiamik	Kangaatsiaq<Instrumentalis
Kangaatsiamilli	Kangaatsiaq<Instrumentalis+LI
Kangaatsiaminguna	Kangaatsiaq<Instrumentalis+UNA
Kangaatsiami	Kangaatsiaq<Lokalis
Kangaatsiameeqqaarlutillu	Kangaatsiaq<Lokalis+IP-QQAAR<Ledsagemåde<de_selv+LU
Kangaatsiameeqqaartoq	Kangaatsiaq<Lokalis+IP-QQAAR+TUQ
Kangaatsiameereerpit	Kangaatsiaq<Lokalis+IP-RIIR<Interrogativ<du
Kangaatsiamiissimasulli	Kangaatsiaq<Lokalis+IP+SIMA<Participium<de+LI
Kangaatsiamilu	Kangaatsiaq<Lokalis+LU
Kangaatsiarmiumik	Kangaatsiaq+MIU<ental<Instrumentalis
Kangaatsiarmiunilli	Kangaatsiaq+MIU<flertal<Instrumentalis+LI
Kangaatsiarmiuniiginnarneq	Kangaatsiaq+MIU<flertal<Lokalis+IP-INNAR+NIQ
Kangaatsiarmiuneereerpunga	Kangaatsiaq+MIU<flertal<Lokalis+IP-RIIR<Indikativ<jeg
Kangaatsiarmiunngornatik	Kangaatsiaq+MIU-NNGUR-NNGIT<Ledsagemåde<de_selv
Kangaatsiarmioqarpoq	Kangaatsiaq+MIU-QAR<Indikativ<han
Kangaatsiarmioqarporlu	Kangaatsiaq+MIU-QAR<Indikativ<han+LU
Kangaatsiarmioqarnerli	Kangaatsiaq+MIU-QAR+NIQ+LI
Kangaatsiarmioqartoq	Kangaatsiaq+MIU-QAR<Participium<han
Kangaatsiarmioqartorli	Kangaatsiaq+MIU-QAR+TUQ+LI
Kangaatsiarmiuullutilli	Kangaatsiaq+MIU-U<Ledsagemåde<de_selv+LI
Kangaatsiarmiooqqutiginuna	Kangaatsiaq+MIU-U-QQU<Imperativ<ViDem+UNA
Kangaatsiarmiooriarlutik	Kangaatsiaq+MIU-U-RIAR<Ledsagemåde<de_selv
Kangaatsiarmiooreertoqalaarpugulli	Kangaatsiaq+MIU-U-RIIR+TUQ-QAR-LAAR<Indikativ<vi+LI
Kangaatsiamukaannarlutik	Kangaatsiaq<Terminalis-KAR-INNAR<Ledsagemåde<de_selv
Kangaatsiamukanngillallu	Kangaatsiaq<Terminalis-KAR-NNGIT<Indikativ<de+LU
Kangaatsiamukareertungali	Kangaatsiaq<Terminalis-KAR-RIIR<Participium<jeg+LI
Kangaatsiamukassagatta	Kangaatsiaq<Terminalis-KAR-SSA<Causativ<vi
Kangaatsiamulli	Kangaatsiaq<Terminalis+LI
Kangaatsiamullu	Kangaatsiaq<Terminalis+LU
Kangaatsiakkulli	Kangaatsiaq<Vialis+LI
Kangaatsiakkullu	Kangaatsiaq<Vialis+LU
Kangaatsiakkununa	Kangaatsiaq<Vialis+UNA
Kangerlussuaq	Kangerlussuaq<Absolut
Kangerlussuaruna	Kangerlussuaq<Absolut+UNA
Kangerlussuarmik	Kangerlussuaq<Instrumentalis
Kangerlussuarmilli	Kangerlussuaq<Instrumentalis+LI
Kangerlussuarmi	Kangerlussuaq<Lokalis
Kangerlussuarmiillutik	Kangerlussuaq<Lokalis+IP<Ledsagemåde<de_selv
Kangerlussuarmeeqqaartunga	Kangerlussuaq<Lokalis+IP-QQAAR<Participium<jeg
Kangerlussuarmeeqqaartungaana	Kangerlussuaq<Lokalis+IP-QQAAR<Participium<jeg+UNA
Kangerlussuarmeereerpit	Kangerlussuaq<Lokalis+IP-RIIR<Interrogativ<du
Kangerlussuarmeereerneq	Kangerlussuaq<Lokalis+IP-RIIR+NIQ
Kangerlussuarmiuni	Kangerlussuaq+MIU<flertal<Lokalis
Kangerlussuarmiuleriniarnini	Kangerlussuaq+MIU-LIRI+NIAR+NIQ<ental<sin<Absolut
Kangerlussuarmiulerisaraluarpullu	Kangerlussuaq+MIU-LIRI+TAR=GALUAR<Indikativ<de+LU
Kangerlussuarmiulerisooqquiuk	Kangerlussuaq+MIU-LIRI+TUQ-U-QQU<Interrogativ<DuHam
Kangerlussuarmioqarporuna	Kangerlussuaq+MIU-QAR<Indikativ<han+UNA
Kangerlussuarmioqartoq	Kangerlussuaq+MIU-QAR<Participium<han
Kangerlussuarmiooreerpit	Kangerlussuaq+MIU-U-RIIR<Interrogativ<du
Kangerlussuarmiuusinnaagamaana	Kangerlussuaq+MIU-U+SINNAA<Causativ<jeg+UNA
Kangerlussuarmiuusarmata	Kangerlussuaq+MIU-U+TAR<Causativ<de
Kangerlussuarmukalertorli	Kangerlussuaq<Terminalis-KAR-LIR<Participium<han+LI
Kangerlussuarmukarnikuutoqanngilaq	Kangerlussuaq<Terminalis-KAR+NIKUU+TUQ-QAR-NNGIT<Indikativ<han
Kangerlussuarmulli	Kangerlussuaq<Terminalis+LI
Kangerlussuarmununa	Kangerlussuaq<Terminalis+UNA
Kangerlussuakkut	Kangerlussuaq<Vialis
Kangerlussuakkulli	Kangerlussuaq<Vialis+LI
Kangerlussuakkullu	Kangerlussuaq<Vialis+LU
Kangerlussuakkununa	Kangerlussuaq<Vialis+UNA
kapitaliiuna	kapitali<flertal<hans<Absolut+UNA
kapitaligiittununa	kapitali+GIIT<flertal<Aequalis+UNA
kapitaligiilerivallaanngilanga	kapitali+GIIT-LIRI+VALLAAR=NNGIT<Indikativ<jeg
kapitalilerisimasartukkui	kapitali-LIRI+SIMA=TAR+TUQ-KKUT<flertal<hans<Absolut
kapitalinngoorusullutik	kapitali-NNGUAQ-U+GUSUP<Ledsagemåde<de_selv
kapitalinngooriartooqqugakku	kapitali-NNGUAQ-U-RIAR+TUQ-U-QQU<Causativ<JegHam
kapitalinngulaartarpulli	kapitali-NNGUR-LAAR=TAR<Indikativ<de+LI
kapitalinngoqqaarninilu	kapitali-NNGUR-QQAAR+NIQ<ental<sin<Absolut+LU
kapitalinnguinnerillu	kapitali-NNGUR-VIP+NIQ<flertal<Relativ+LU
kapitalerpassuilli	kapitali+PASSUAQ<flertal<Absolut+LI
kapitalerpassui	kapitali+PASSUAQ<flertal<hans<Absolut
kapitalerpassuili	kapitali+PASSUAQ<flertal<hans<Absolut+LI
kapitalerpassuilu	kapitali+PASSUAQ<flertal<hans<Absolut+LU
kapitalerpassuarnukaqqaartoq	kapitali+PASSUAQ<flertal<Terminalis-KAR-QQAAR+TUQ
kapitaleqavimmata	kapitali-QAR-VIP<Causativ<de
kapitalisiuinnaramali	kapitali+SIUR-INNAR<Causativ<jeg+LI
kapitalisiulaartorlu	kapitali+SIUR-LAAR<Participium<han+LU
kapitalisioqquaa	kapitali+SIUR-QQU<Indikativ<HanHam
kapitalisiorsimanini	kapitali+SIUR+SIMA+NIQ<ental<sin<Absolut
kapitalissara	kapitali-SSAQ<ental<min<Absolut
kapitalissamalu	kapitali-SSAQ<flertal<min>Relativ+LU
kapitaliunerullutilli	kapitali-U+NIRU<Ledsagemåde<de_selv+LI
kapitaliunerusoq	kapitali-U+NIRU<Participium<han
kiisa	kiisa<Partikel
kiisali	kiisa<Partikel+LI
kiisalu	kiisa<Partikel+LU
kiisaana	kiisa<Partikel+UNA
kingullialli	kingulleq<ental<deres<Absolut+LI
kingulliali	kingulleq<ental<hans<Absolut+LI
kingullerminguna	kingulleq<ental<Instrumentalis+UNA
kingulliit	kingulleq<flertal<Absolut
kingullerinermangali	kingulleq+GӘ+NIR<Causativ<HanMig+LI
kingullerinerullugu	kingulleq+GӘ+NIRU<Ledsagemåde<ham
kingullerissaviuk	kingulleq+GӘ-SSA<Interrogativ<DuHam
kingullerivallaarlara	kingulleq+GӘ+VALLAAR<Optativ<JegHam
kingullilissiussagaluarpoq	kingulleq-LIK+SIUR-SSA=GALUAR<Indikativ<han
kingullinngulaartarnertut	kingulleq-NNGUR-LAAR=TAR+NIQ<ental<Aequalis
kingullinngunngitsooqqutigit	kingulleq-NNGUR-NNGIT+TUQ-U-QQU<Imperativ<ViDem
kingullinngoreermatalu	kingulleq-NNGUR-RIIR<Causativ<de+LU
kingulleqalaartarmat	kingulleq-QAR-LAAR=TAR<Causativ<han
kingulleqalaartartununa	kingulleq-QAR-LAAR=TAR<Participium<de+UNA
kingulleqarniarpunga	kingulleq-QAR+NIAR<Indikativ<jeg
kingulleqanngillalli	kingulleq-QAR-NNGIT<Indikativ<de+LI
kingulleqannginneq	kingulleq-QAR-NNGIT+NIQ<ental<Absolut
kingulleqaqqaarpullu	kingulleq-QAR-QQAAR<Indikativ<de+LU
kingulleqaqqugakku	kingulleq-QAR-QQU<Causativ<JegHam
kingulleqaqqutiginuna	kingulleq-QAR-QQU<Imperativ<ViDem+UNA
kingullertaaqqaarlutilli	kingulleq+TAAR-QQAAR<Ledsagemåde<de_selv+LI
kingullertaavinninilu	kingulleq+TAAR-VIP+NIQ<ental<sin<Absolut+LU
kisimi	kisimi<Adjektiv
kisimili	kisimi<Adjektiv+LI
kisimiuna	kisimi<Adjektiv+UNA
kitiga	kitә<ental<min<Absolut
kitima	kitә<ental<min>Relativ
kitini	kitә<ental<sin<Absolut
kitaanulli	kitә<ental<Terminalis<hans+LI
kitaanununa	kitә<ental<Terminalis<hans+UNA
kitinngualu	kitә-NNGUAQ<ental<hans<Absolut+LU
kitinngui	kitә-NNGUAQ<flertal<hans<Absolut
kitinnguili	kitә-NNGUAQ<flertal<hans<Absolut+LI
kitinngualereqqullugilli	kitә-NNGUAQ-LIRI-QQU<Ledsagemåde<dem+LI
kitinnguaqaannartoriunnaartigit	kitә-NNGUAQ-QAR-INNAR+TUQ+GӘ+GUNNAAR<Imperativ<ViDem
kitinngoorusukkama	kitә-NNGUAQ-U+GUSUP<Causativ<jeg
kitinngooqqaarpungaana	kitә-NNGUAQ-U-QQAAR<Indikativ<jeg+UNA
kitinngooqqaarninili	kitә-NNGUAQ-U-QQAAR+NIQ<ental<sin<Absolut+LI
kitinngooqqaartoorusummalli	kitә-NNGUAQ-U-QQAAR+TUQ-U+GUSUP<Causativ<han+LI
kitinngooriartoruna	kitә-NNGUAQ-U-RIAR<Participium<han+UNA
kitissaq	kitә-SSAQ<ental<Absolut
kitissatut	kitә-SSAQ<ental<Aequalis
kitissamali	kitә-SSAQ<ental<min>Relativ+LI
kitissannguinnarpoq	kitә-SSAQ-NNGUR-INNAR<Indikativ<han
kitissanngussagaluarmata	kitә-SSAQ-NNGUR-SSA=GALUAR<Causativ<de
kitissaqalaartartorpassui	kitә-SSAQ-QAR-LAAR=TAR+TUQ+PASSUAQ<flertal<hans<Absolut
kunngigali	kunngi<ental<min<Absolut+LI
kunngimaana	kunngi<ental<min>Relativ+UNA
kunngikkut	kunngi<ental<Vialis
kunngikkullu	kunngi<ental<Vialis+LU
kunngima	kunngi<flertal<min>Relativ
kunngigiinnilu	kunngi+GIIT<flertal<Lokalis+LU
kunngigiilerisaraluartorisimalara	kunngi+GIIT-LIRI+TAR=GALUAR+TUQ+GӘ+SIMA<Optativ<JegHam
kunngigiinnguinnartoriunnaartigit	kunngi+GIIT-NNGUR-INNAR+TUQ+GӘ+GUNNAAR<Imperativ<ViDem
kunngigivakka	kunngi+GӘ<Indikativ<JegDem
kunngiginikuugakku	kunngi+GӘ+NIKUU<Causativ<JegHam
kunngigisinnaavagulli	kunngi+GӘ+SINNAA<Indikativ<ViDem+LI
kunngigissalara	kunngi+GӘ-SSA<Optativ<JegHam
kunngiinnaq	kunngi-INNAQ<ental<Absolut
kunngikkunneeqquaalu	kunngi-KKUT<flertal<Lokalis+IP-QQU<Indikativ<HanHam+LU
kunngilik	kunngi-LIK<ental<Absolut
kunngillinuna	kunngi-LIK<flertal<Relativ+UNA
kunngilereriartut	kunngi-LIRI-RIAR<Participium<de
kunngimiunngulertorlu	kunngi+MIU-NNGUR-LIR<Participium<han+LU
kunngimioqarnerli	kunngi+MIU-QAR+NIQ+LI
kunngimioqartorli	kunngi+MIU-QAR<Participium<han+LI
kunnginngooreertungalu	kunngi-NNGUAQ-U-RIIR<Participium<jeg+LU
kunnginnguinnarlutik	kunngi-NNGUR-INNAR<Ledsagemåde<de_selv
kunnginngoqqaartuma	kunngi-NNGUR-QQAAR+TUQ<flertal<min>Relativ
kunnginngussaaq	kunngi-NNGUR-SSA<Indikativ<han
kunngerpassuillu	kunngi+PASSUAQ<flertal<Absolut+LU
kunngerpassuinuna	kunngi+PASSUAQ<flertal<Absolut+UNA
kunngerpassuartut	kunngi+PASSUAQ<flertal<Aequalis
kunngerpassui	kunngi+PASSUAQ<flertal<hans<Absolut
kunngerpassuili	kunngi+PASSUAQ<flertal<hans<Absolut+LI
kunngerpassuarnik	kunngi+PASSUAQ<flertal<Instrumentalis
kunngerpassuarneeqquara	kunngi+PASSUAQ<flertal<Lokalis+IP-QQU<Indikativ<JegHam
kunngerpassuarneeqqulara	kunngi+PASSUAQ<flertal<Lokalis+IP-QQU<Optativ<JegHam
kunngerpassuakkali	kunngi+PASSUAQ<flertal<min<Absolut+LI
kunngerpassuakkaana	kunngi+PASSUAQ<flertal<min<Absolut+UNA
kunngerpassuarnut	kunngi+PASSUAQ<flertal<Terminalis
kunngeqaannarnini	kunngi-QAR-INNAR+NIQ<ental<sin<Absolut
kunngeqaannartoqareertunngoqqummangali	kunngi-QAR-INNAR+TUQ-QAR-RIIR+TUQ-NNGUR-QQU<Causativ<HanMig+LI
kunngeqalaartarmatali	kunngi-QAR-LAAR=TAR<Causativ<de+LI
kunngeqalaartartoq	kunngi-QAR-LAAR=TAR<Participium<han
kunngeqarluartorpassuiuna	kunngi-QAR+LUAR+TUQ+PASSUAQ<flertal<hans<Absolut+UNA
kunngeqarnerullutik	kunngi-QAR+NIRU<Ledsagemåde<de_selv
kunngeqanngimmallu	kunngi-QAR-NNGIT<Causativ<han+LU
kunngeqaqqaartununa	kunngi-QAR-QQAAR<Participium<de+UNA
kunngeqaqqaartunngunngitsoq	kunngi-QAR-QQAAR+TUQ-NNGUR-NNGIT<Participium<han
kunngeqaqqullugillu	kunngi-QAR-QQU<Ledsagemåde<dem+LU
kunngeqareermatali	kunngi-QAR-RIIR<Causativ<de+LI
kunngeqareerpit	kunngi-QAR-RIIR<Interrogativ<du
kunngeqareernini	kunngi-QAR-RIIR+NIQ<ental<sin<Absolut
kunngeqarpallaanngilatit	kunngi-QAR+VALLAAR=NNGIT<Interrogativ<du
kunngeqavikkamali	kunngi-QAR-VIP<Causativ<jeg+LI
kunngissakkulli	kunngi-SSAQ<ental<Vialis+LI
kunngissaqalertunga	kunngi-SSAQ-QAR-LIR<Participium<jeg
kunngitaalaartungaana	kunngi+TAAR-LAAR<Participium<jeg+UNA
kunngitaareerpunga	kunngi+TAAR-RIIR<Indikativ<jeg
kunngiulaarmata	kunngi-U-LAAR<Causativ<de
kunngioqqutigilli	kunngi-U-QQU<Imperativ<ViDem+LI
maani	maani<Partikel
maanili	maani<Partikel+LI
maanilu	maani<Partikel+LU
makku	makku<Pronomen<flertal<Absolut
makkuli	makku<Pronomen<flertal<Absolut+LI
makkunani	makku<Pronomen<flertal<Lokalis
makkunaniiginnarpit	makku<Pronomen<flertal<Lokalis+IP-INNAR<Interrogativ<du
makkunaneeqqaartungalu	makku<Pronomen<flertal<Lokalis+IP-QQAAR<Participium<jeg+LU
makkunaneeqqutiginuna	makku<Pronomen<flertal<Lokalis+IP-QQU<Imperativ<ViDem+UNA
makkunaneeriarmata	makku<Pronomen<flertal<Lokalis+IP-RIAR<Causativ<de
makkunaniittartoqarporuna	makku<Pronomen<flertal<Lokalis+IP+TAR+TUQ-QAR<Indikativ<han+UNA
makkunaniuna	makku<Pronomen<flertal<Lokalis+UNA
Maniitsoq	Maniitsoq<Absolut
Maniitsorli	Maniitsoq<Absolut+LI
Maniitsorlu	Maniitsoq<Absolut+LU
Maniitsoruna	Maniitsoq<Absolut+UNA
Maniitsumik	Maniitsoq<Instrumentalis
Maniitsumilli	Maniitsoq<Instrumentalis+LI
Maniitsumillu	Maniitsoq<Instrumentalis+LU
Maniitsuminguna	Maniitsoq<Instrumentalis+UNA
Maniitsumi	Maniitsoq<Lokalis
Maniitsumiimmalli	Maniitsoq<Lokalis+IP<Causativ<han+LI
Maniitsumiiginnaratta	Maniitsoq<Lokalis+IP-INNAR<Causativ<vi
Maniitsumiilerlutik	Maniitsoq<Lokalis+IP-LIR<Ledsagemåde<de_selv
Maniitsumeeqqaarpoq	Maniitsoq<Lokalis+IP-QQAAR<Indikativ<han
Maniitsumeeqqaarlutinguna	Maniitsoq<Lokalis+IP-QQAAR<Ledsagemåde<de_selv+UNA
Maniitsumeeqqaarnerlu	Maniitsoq<Lokalis+IP-QQAAR+NIQ+LU
Maniitsumeeqqummanga	Maniitsoq<Lokalis+IP-QQU<Causativ<HanMig
Maniitsumeeqquiuk	Maniitsoq<Lokalis+IP-QQU<Interrogativ<DuHam
Maniitsumeeqqullugit	Maniitsoq<Lokalis+IP-QQU<Ledsagemåde<dem
Maniitsumeeriarmatalu	Maniitsoq<Lokalis+IP-RIAR<Causativ<de+LU
Maniitsumeeriarpungali	Maniitsoq<Lokalis+IP-RIAR<Indikativ<jeg+LI
Maniitsumeeriarlutillu	Maniitsoq<Lokalis+IP-RIAR<Ledsagemåde<de_selv+LU
Maniitsumeeriarlutinguna	Maniitsoq<Lokalis+IP-RIAR<Ledsagemåde<de_selv+UNA
Maniitsumeeriarneq	Maniitsoq<Lokalis+IP-RIAR+NIQ
Maniitsumeeriartoq	Maniitsoq<Lokalis+IP-RIAR<Participium<han
Maniitsumeeriartorlu	Maniitsoq<Lokalis+IP-RIAR+TUQ+LU
Maniitsumeereerpununa	Maniitsoq<Lokalis+IP-RIIR<Indikativ<de+UNA
Maniitsumeereerpugut	Maniitsoq<Lokalis+IP-RIIR<Indikativ<vi
Maniitsumeereertunga	Maniitsoq<Lokalis+IP-RIIR<Participium<jeg
Maniitsumiippallaartunga	Maniitsoq<Lokalis+IP+VALLAAR<Participium<jeg
Maniitsumili	Maniitsoq<Lokalis+LI
Maniitsumilu	Maniitsoq<Lokalis+LU
Maniitsormiumilli	Maniitsoq+MIU<ental<Instrumentalis+LI
Maniitsormiumut	Maniitsoq+MIU<ental<Terminalis
Maniitsormiunilli	Maniitsoq+MIU<flertal<Instrumentalis+LI
Maniitsormiuninguna	Maniitsoq+MIU<flertal<Instrumentalis+UNA
Maniitsormiuni	Maniitsoq+MIU<flertal<Lokalis
Maniitsormiuniilerpit	Maniitsoq+MIU<flertal<Lokalis+IP-LIR<Interrogativ<du
Maniitsormiuneereertoq	Maniitsoq+MIU<flertal<Lokalis+IP-RIIR+TUQ
Maniitsormiulerinianngimmata	Maniitsoq+MIU-LIRI+NIAR=NNGIT<Causativ<de
Maniitsormiuleriniarnatik	Maniitsoq+MIU-LIRI+NIAR=NNGIT<Ledsagemåde<de_selv
Maniitsormiulerissappulli	Maniitsoq+MIU-LIRI-SSA<Indikativ<de+LI
Maniitsormiulerisaraluarpit	Maniitsoq+MIU-LIRI+TAR=GALUAR<Interrogativ<du
Maniitsormiunngoqqugakku	Maniitsoq+MIU-NNGUR-QQU<Causativ<JegHam
Maniitsormiunngoreerpungalu	Maniitsoq+MIU-NNGUR-RIIR<Indikativ<jeg+LU
Maniitsormiunngoreerpit	Maniitsoq+MIU-NNGUR-RIIR<Interrogativ<du
Maniitsormiunngussagaluaramali	Maniitsoq+MIU-NNGUR-SSA=GALUAR<Causativ<jeg+LI
Maniitsormioqarporuna	Maniitsoq+MIU-QAR<Indikativ<han+UNA
Maniitsormioqarneq	Maniitsoq+MIU-QAR+NIQ
Maniitsormioqarneruna	Maniitsoq+MIU-QAR+NIQ+UNA
Maniitsormioqartoq	Maniitsoq+MIU-QAR<Participium<han
Maniitsormioqartorli	Maniitsoq+MIU-QAR<Participium<han+LI
Maniitsormioqartoq	Maniitsoq+MIU-QAR+TUQ
Maniitsormioqartorli	Maniitsoq+MIU-QAR+TUQ+LI
Maniitsormioqartoruna	Maniitsoq+MIU-QAR+TUQ+UNA
Maniitsormiuummallu	Maniitsoq+MIU-U<Causativ<han+LU
Maniitsormiuujunnaartoqalaartunngoorusuttorlu	Maniitsoq+MIU-U+GUNNAAR+TUQ-QAR-LAAR+TUQ-NNGUAQ-U+GUSUP<Participium<han+LU
Maniitsormioorusummalli	Maniitsoq+MIU-U+GUSUP<Causativ<han+LI
Maniitsormioorusukkama	Maniitsoq+MIU-U+GUSUP<Causativ<jeg
Maniitsormiuuniartunga	Maniitsoq+MIU-U+NIAR<Participium<jeg
Maniitsormiuunikuunerit	Maniitsoq+MIU-U+NIKUU+NIQ<flertal<Relativ
Maniitsormiuusaraluarmata	Maniitsoq+MIU-U+TAR=GALUAR<Causativ<de
Maniitsormiuuimmat	Maniitsoq+MIU-U-VIP<Causativ<han
Maniitsumut	Maniitsoq<Terminalis
Maniitsumukaannarpit	Maniitsoq<Terminalis-KAR-INNAR<Interrogativ<du
Maniitsumukalaarneq	Maniitsoq<Terminalis-KAR-LAAR+NIQ
Maniitsumukalaartarama	Maniitsoq<Terminalis-KAR-LAAR=TAR<Causativ<jeg
Maniitsumukalaartarpunga	Maniitsoq<Terminalis-KAR-LAAR=TAR<Indikativ<jeg
Maniitsumukalaartarpit	Maniitsoq<Terminalis-KAR-LAAR=TAR<Interrogativ<du
Maniitsumukanngitsorlu	Maniitsoq<Terminalis-KAR-NNGIT+TUQ+LU
Maniitsumukaqqaartoq	Maniitsoq<Terminalis-KAR-QQAAR+TUQ
Maniitsumukareerpit	Maniitsoq<Terminalis-KAR-RIIR<Interrogativ<du
Maniitsumukassagaluarput	Maniitsoq<Terminalis-KAR-SSA=GALUAR<Indikativ<de
Maniitsumukassagaluartoq	Maniitsoq<Terminalis-KAR-SSA=GALUAR+TUQ
Maniitsumukassasunga	Maniitsoq<Terminalis-KAR-SSA<Participium<jeg
Maniitsumulli	Maniitsoq<Terminalis+LI
Maniitsumullu	Maniitsoq<Terminalis+LU
Maniitsumununa	Maniitsoq<Terminalis+UNA
Maniitsukkut	Maniitsoq<Vialis
Maniitsukkulli	Maniitsoq<Vialis+LI
Maniitsukkullu	Maniitsoq<Vialis+LU
Maniitsukkununa	Maniitsoq<Vialis+UNA
manna	manna<Pronomen<Absolut<ental
mannali	manna<Pronomen<Absolut<ental+LI
mannalu	manna<Pronomen<Absolut<ental+LU
marluinnaanuna	marluk-INNAQ<flertal<Absolut+UNA
marluinnalereriarattaana	marluk-INNAQ-LIRI-RIAR<Causativ<vi+UNA
marluinnanngortunngoreerpullu	marluk-INNAQ-NNGUR+TUQ-NNGUR-RIIR<Indikativ<de+LU
marluinnarsiuinnarnera	marluk-INNAQ+SIUR-INNAR+NIQ<ental<hans<Absolut
marlussaqaraluartunnguali	marluk-SSAQ-QAR+GALUAR+TUQ-NNGUAQ<ental<hans<Absolut+LI
marlutut	marluk<Talord<Aequalis
marluk	marluk<Talord<flertal<Absolut
marlunguna	marluk<Talord<flertal<Absolut+UNA
marlunukanngillalli	marluk<Talord<flertal<Terminalis-KAR-NNGIT<Indikativ<de+LI
marlunik	marluk<Talord<Instrumentalis
marluliarlu	marluliaq<ental<Absolut+LU
marlulissakka	marluliaq<flertal<min<Absolut
marlulianngooriartunik	marluliaq-NNGUAQ-U-RIAR+TUQ<flertal<Instrumentalis
massakkullu	massakkut<Partikel+LU
massakkununa	massakkut<Partikel+UNA
meeraq	meeraq<ental<Absolut
meeqqatut	meeraq<ental<Aequalis
meeqqatullu	meeraq<ental<Aequalis+LU
meeraalu	meeraq<ental<hans<Absolut+LU
meeqqama	meeraq<ental<min>Relativ
meeqqamali	meeraq<ental<min>Relativ+LI
meeqqamalu	meeraq<ental<min>Relativ+LU
meeqqanili	meeraq<ental<sin<Absolut+LI
meeqqamullu	meeraq<ental<Terminalis+LU
meeqqakkut	meeraq<ental<Vialis
meeqqakkulli	meeraq<ental<Vialis+LI
meeqqakkununa	meeraq<ental<Vialis+UNA
meeraa	meeraq<flertal<hans<Absolut
meeqqanilli	meeraq<flertal<Instrumentalis+LI
meeqqanillu	meeraq<flertal<Instrumentalis+LU
meeqqaninguna	meeraq<flertal<Instrumentalis+UNA
meeqqaneeqqaarpoq	meeraq<flertal<Lokalis+IP-QQAAR<Indikativ<han
meeqqaneereerpugununa	meeraq<flertal<Lokalis+IP-RIIR<Indikativ<vi+UNA
meeqqaneereerlutik	meeraq<flertal<Lokalis+IP-RIIR<Ledsagemåde<de_selv
meeqqanilu	meeraq<flertal<Lokalis+LU
meeqqakkali	meeraq<flertal<min<Absolut+LI
meeqqakkaana	meeraq<flertal<min<Absolut+UNA
meeqqanukaqqaarnerlu	meeraq<flertal<Terminalis-KAR-QQAAR+NIQ+LU
meeqqanulli	meeraq<flertal<Terminalis+LI
meerariittullu	meeraq+GIIT<flertal<Aequalis+LU
meerariikka	meeraq+GIIT<flertal<min<Absolut
meerarigaluarlaraana	meeraq+GӘ+GALUAR<Optativ<JegHam+UNA
meerarartorlugilli	meeraq+GӘ+GIARTUR<Ledsagemåde<dem+LI
meeraannaanuna	meeraq-INNAQ<flertal<Absolut+UNA
meeralii	meeraq-LIK<flertal<hans<Absolut
meeralileriunnaarlutillu	meeraq-LIK-LIRI+GUNNAAR<Ledsagemåde<de_selv+LU
meeralerillutik	meeraq-LIRI<Ledsagemåde<de_selv
meeralereqqaarama	meeraq-LIRI-QQAAR<Causativ<jeg
meerarmiunngoriarninili	meeraq+MIU-NNGUR-RIAR+NIQ<ental<sin<Absolut+LI
meerarmioqarneq	meeraq+MIU-QAR+NIQ
meerarmiuullutinguna	meeraq+MIU-U<Ledsagemåde<de_selv+UNA
meeranngulaartarpungaana	meeraq-NNGUR-LAAR=TAR<Indikativ<jeg+UNA
meeranngoriarpugullu	meeraq-NNGUR-RIAR<Indikativ<vi+LU
meeranngussagaluartoq	meeraq-NNGUR-SSA=GALUAR<Participium<han
meerarpassuiuna	meeraq+PASSUAQ<flertal<hans<Absolut+UNA
meerarpassuakka	meeraq+PASSUAQ<flertal<min<Absolut
meerarpassuarnukaqqullugillu	meeraq+PASSUAQ<flertal<Terminalis-KAR-QQU<Ledsagemåde<dem+LU
meerarsioreerlutinguna	meeraq+SIUR-RIIR<Ledsagemåde<de_selv+UNA
meerassakkalu	meeraq-SSAQ<flertal<min<Absolut+LU
meerassanngoqqaartullu	meeraq-SSAQ-NNGUR-QQAAR<Participium<de+LU
meerartaalertunga	meeraq+TAAR-LIR<Participium<jeg
meerartaavimmat	meeraq+TAAR-VIP<Causativ<han
mittarfilli	mittarfik<ental<Absolut+LI
mittarfillu	mittarfik<ental<Absolut+LU
mittarfimmilli	mittarfik<ental<Instrumentalis+LI
mittarfimmi	mittarfik<ental<Lokalis
mittarfinnili	mittarfik<ental<sin<Absolut+LI
mittarfimmununa	mittarfik<ental<Terminalis+UNA
mittarfinnillu	mittarfik<flertal<Instrumentalis+LU
mittarfigiinnilli	mittarfik+GIIT<flertal<Instrumentalis+LI
mittarfigivallaarpiuk	mittarfik+GӘ+VALLAAR<Interrogativ<DuHam
mittarfillilli	mittarfik-LIK<flertal<Relativ+LI
mittarfileriniarmata	mittarfik-LIRI+NIAR<Causativ<de
mittarfimmiuneeqqummanga	mittarfik+MIU<flertal<Lokalis+IP-QQU<Causativ<HanMig
mittarfinnguujartorninili	mittarfik-NNGUAQ-U+GIARTUR+NIQ<ental<sin<Absolut+LI
mittarfippassuillu	mittarfik+PASSUAQ<flertal<Absolut+LU
mittarfippassuinuna	mittarfik+PASSUAQ<flertal<Absolut+UNA
mittarfippassui	mittarfik+PASSUAQ<flertal<hans<Absolut
mittarfippassuakka	mittarfik+PASSUAQ<flertal<min<Absolut
mittarfippassuakkali	mittarfik+PASSUAQ<flertal<min<Absolut+LI
mittarfeqaannarnini	mittarfik-QAR-INNAR+NIQ<ental<sin<Absolut
mittarfeqaannartoq	mittarfik-QAR-INNAR<Participium<han
mittarfeqalaarpoq	mittarfik-QAR-LAAR<Indikativ<han
mittarfeqalaartarpungali	mittarfik-QAR-LAAR=TAR<Indikativ<jeg+LI
mittarfeqalaartarpugununa	mittarfik-QAR-LAAR=TAR<Indikativ<vi+UNA
mittarfeqalaartartungali	mittarfik-QAR-LAAR=TAR<Participium<jeg+LI
mittarfeqaleramali	mittarfik-QAR-LIR<Causativ<jeg+LI
mittarfeqalernerat	mittarfik-QAR-LIR+NIQ<ental<deres
mittarfeqalertoruna	mittarfik-QAR-LIR<Participium<han+UNA
mittarfeqalertuunianngimmatalu	mittarfik-QAR-LIR+TUQ-U+NIAR=NNGIT<Causativ<de+LU
mittarfeqarnianngillallu	mittarfik-QAR+NIAR=NNGIT<Indikativ<de+LU
mittarfeqaqqummanga	mittarfik-QAR-QQU<Causativ<HanMig
mittarfeqaqqugakku	mittarfik-QAR-QQU<Causativ<JegHam
mittarfeqaqqutigilli	mittarfik-QAR-QQU<Imperativ<ViDem+LI
mittarfeqariarmata	mittarfik-QAR-RIAR<Causativ<de
mittarfeqariartunga	mittarfik-QAR-RIAR<Participium<jeg
mittarfeqareertut	mittarfik-QAR-RIIR<Participium<de
mittarfeqareertullu	mittarfik-QAR-RIIR<Participium<de+LU
mittarfeqareertuujartornini	mittarfik-QAR-RIIR+TUQ-U+GIARTUR+NIQ<ental<sin<Absolut
mittarfeqarsimasoq	mittarfik-QAR+SIMA<Participium<han
mittarfeqassagaluarnini	mittarfik-QAR-SSA=GALUAR+NIQ<ental<sin<Absolut
mittarfeqassaangali	mittarfik-QAR-SSA<Indikativ<jeg+LI
mittarfeqavippit	mittarfik-QAR-VIP<Interrogativ<du
mittarfeqavinneralu	mittarfik-QAR-VIP+NIQ<ental<hans<Absolut+LU
mittarfissiunnginnama	mittarfik+SIUR-NNGIT<Causativ<jeg
mittarfissiunngitsunngulerama	mittarfik+SIUR-NNGIT+TUQ-NNGUR-LIR<Causativ<jeg
mittarfissioqquaanga	mittarfik+SIUR-QQU<Indikativ<HanMig
mittarfissioreernini	mittarfik+SIUR-RIIR+NIQ<ental<sin<Absolut
mittarfissiussagaluarpit	mittarfik+SIUR-SSA=GALUAR<Interrogativ<du
mittarfissiussagaluarnini	mittarfik+SIUR-SSA=GALUAR+NIQ<ental<sin<Absolut
mittarfissiussagaluartunnguaq	mittarfik+SIUR-SSA=GALUAR+TUQ-NNGUAQ<ental<Absolut
mittarfissiussallutik	mittarfik+SIUR-SSA<Ledsagemåde<de_selv
mittarfittaannarnermununa	mittarfik+TAAR-INNAR+NIQ<ental<Terminalis+UNA
naammassitigilli	naammassi<Imperativ<ViDem+LI
naammassinerugakkuli	naammassi+NIRU<Causativ<JegHam+LI
naammassilara	naammassi<Optativ<JegHam
naammassilarali	naammassi<Optativ<JegHam+LI
naammasseqquassiuna	naammassi-QQU<Indikativ<JegJer+UNA
najali	naja<ental<Absolut+LI
najakkullu	naja<ental<Vialis+LU
najallit	naja-LIK<flertal<Relativ
najalerisaraluarlutik	naja-LIRI+TAR=GALUAR<Ledsagemåde<de_selv
najaasunngooreernerninguna	naja-U+TUQ-NNGUAQ-U-RIIR+NIQ<flertal<Instrumentalis+UNA
najugaqalaarninilu	najugaqar-LAAR+NIQ<ental<sin<Absolut+LU
najukkamik	najugaq<ental<Instrumentalis
najukkamulli	najugaq<ental<Terminalis+LI
najugaannalereriartunga	najugaq-INNAQ-LIRI-RIAR<Participium<jeg
nalorusuppiuk	nalu+GUSUP<Interrogativ<DuHam
nalorusullugit	nalu+GUSUP<Ledsagemåde<dem
naloqqaarpara	nalu-QQAAR<Indikativ<JegHam
naloqqaarlara	nalu-QQAAR<Optativ<JegHam
naloqqummanga	nalu-QQU<Causativ<HanMig
naloriarpakka	nalu-RIAR<Indikativ<JegDem
naloriarpiuk	nalu-RIAR<Interrogativ<DuHam
naloriarlara	nalu-RIAR<Optativ<JegHam
naloreerlara	nalu-RIIR<Optativ<JegHam
naligali	nalә<ental<min<Absolut+LI
nalinngui	nalә-NNGUAQ<flertal<hans<Absolut
nalinngoorusuppungalu	nalә-NNGUAQ-U+GUSUP<Indikativ<jeg+LU
nalinnguuniarpit	nalә-NNGUAQ-U+NIAR<Interrogativ<du
nalissanngoqqutigilli	nalә-SSAQ-NNGUR-QQU<Imperativ<ViDem+LI
nammineq	nammineq<Adjektiv
namminerli	nammineq<Adjektiv+LI
namminerlu	nammineq<Adjektiv+LU
nammineruna	nammineq<Adjektiv+UNA
nangippaanuna	nangip<Indikativ<DeHam+UNA
nangiinnarlara	nangip-INNAR<Optativ<JegHam
nangilluarpiuk	nangip+LUAR<Interrogativ<DuHam
nangillaralu	nangip<Optativ<JegHam+LU
nangeqquarali	nangip-QQU<Indikativ<JegHam+LI
nangereerakku	nangip-RIIR<Causativ<JegHam
nangittarmanga	nangip+TAR<Causativ<HanMig
Nanortalik	Nanortalik<Absolut
Nanortalilli	Nanortalik<Absolut+LI
Nanortalillu	Nanortalik<Absolut+LU
Nanortalinguna	Nanortalik<Absolut+UNA
Nanortalimmik	Nanortalik<Instrumentalis
Nanortalimmilli	Nanortalik<Instrumentalis+LI
Nanortalimmi	Nanortalik<Lokalis
Nanortalimmiinngimmatalu	Nanortalik<Lokalis+IP-NNGIT<Causativ<de+LU
Nanortalimmiuna	Nanortalik<Lokalis+UNA
Nanortalimmiuli	Nanortalik+MIU<ental<Absolut+LI
Nanortalimmiulereqqaarnini	Nanortalik+MIU-LIRI-QQAAR+NIQ<ental<sin<Absolut
Nanortalimmiunngulaarnini	Nanortalik+MIU-NNGUR-LAAR+NIQ<ental<sin<Absolut
Nanortalimmioqarpoq	Nanortalik+MIU-QAR<Indikativ<han
Nanortalimmioqartoq	Nanortalik+MIU-QAR<Participium<han
Nanortalimmiuujunnaarpunga	Nanortalik+MIU-U+GUNNAAR<Indikativ<jeg
Nanortalimmut	Nanortalik<Terminalis
Nanortalimmukassagaluartoq	Nanortalik<Terminalis-KAR-SSA=GALUAR<Participium<han
Nanortalimmulli	Nanortalik<Terminalis+LI
Nanortalikkut	Nanortalik<Vialis
Nanortalikkulli	Nanortalik<Vialis+LI
Nanortalikkullu	Nanortalik<Vialis+LU
Nanortalikkununa	Nanortalik<Vialis+UNA
Narsaq	Narsaq<Absolut
Narsarli	Narsaq<Absolut+LI
Narsarlu	Narsaq<Absolut+LU
Narsaruna	Narsaq<Absolut+UNA
Narsamik	Narsaq<Instrumentalis
Narsami	Narsaq<Lokalis
Narsameeqqaarlutinguna	Narsaq<Lokalis+IP-QQAAR<Ledsagemåde<de_selv+UNA
Narsameeqqullugulu	Narsaq<Lokalis+IP-QQU<Ledsagemåde<ham+LU
Narsameereertoq	Narsaq<Lokalis+IP-RIIR+TUQ
Narsarmiumukanngilatit	Narsaq+MIU<ental<Terminalis-KAR-NNGIT<Interrogativ<du
Narsarmiunilli	Narsaq+MIU<flertal<Instrumentalis+LI
Narsarmiuniuna	Narsaq+MIU<flertal<Lokalis+UNA
Narsarmiunngussagaluarput	Narsaq+MIU-NNGUR-SSA=GALUAR<Indikativ<de
Narsarmioqarporli	Narsaq+MIU-QAR<Indikativ<han+LI
Narsarmioqarporuna	Narsaq+MIU-QAR<Indikativ<han+UNA
Narsarmioqarneq	Narsaq+MIU-QAR+NIQ
Narsarmioqarneruna	Narsaq+MIU-QAR+NIQ+UNA
Narsarmioqartoq	Narsaq+MIU-QAR<Participium<han
Narsarmioqartoq	Narsaq+MIU-QAR+TUQ
Narsarmiuujartorpungaana	Narsaq+MIU-U+GIARTUR<Indikativ<jeg+UNA
Narsarmiuuinnarpugununa	Narsaq+MIU-U-INNAR<Indikativ<vi+UNA
Narsarmiuuniartuuinnarpugut	Narsaq+MIU-U+NIAR+TUQ-U-INNAR<Indikativ<vi
Narsarmiooqqularaana	Narsaq+MIU-U-QQU<Optativ<JegHam+UNA
Narsamukaannarlutilli	Narsaq<Terminalis-KAR-INNAR<Ledsagemåde<de_selv+LI
Narsamukaannartoqarpoq	Narsaq<Terminalis-KAR-INNAR+TUQ-QAR<Indikativ<han
Narsamukalaarpugununa	Narsaq<Terminalis-KAR-LAAR<Indikativ<vi+UNA
Narsakkut	Narsaq<Vialis
Narsakkulli	Narsaq<Vialis+LI
Narsakkullu	Narsaq<Vialis+LU
Narsakkununa	Narsaq<Vialis+UNA
Narsarsuarmik	Narsarsuaq<Instrumentalis
Narsarsuarmiilaarlutilli	Narsarsuaq<Lokalis+IP-LAAR<Ledsagemåde<de_selv+LI
Narsarsuarmiulereqqaarpulli	Narsarsuaq+MIU-LIRI-QQAAR<Indikativ<de+LI
Narsarsuarmioqartoq	Narsarsuaq+MIU-QAR+TUQ
Narsarsuarmukalaarpit	Narsarsuaq<Terminalis-KAR-LAAR<Interrogativ<du
Narsarsuarmukalaartarpit	Narsarsuaq<Terminalis-KAR-LAAR=TAR<Interrogativ<du
Narsarsuakkut	Narsarsuaq<Vialis
nassiussaq	nassiussaq<ental<Absolut
nassiussaniissimasaramaana	nassiussaq<flertal<Lokalis+IP+SIMA=TAR<Causativ<jeg+UNA
nassiussareqqaarlugilli	nassiussaq+GӘ-QQAAR<Ledsagemåde<dem+LI
nassiussarmiuneeriarnerli	nassiussaq+MIU<flertal<Lokalis+IP-RIAR+NIQ+LI
nassiussarpassuinuna	nassiussaq+PASSUAQ<flertal<Absolut+UNA
nassiussarpassuakka	nassiussaq+PASSUAQ<flertal<min<Absolut
nassiussarsiuinnarattali	nassiussaq+SIUR-INNAR<Causativ<vi+LI
nassiussarsioqqullugu	nassiussaq+SIUR-QQU<Ledsagemåde<ham
nassiussassaraana	nassiussaq-SSAQ<ental<min<Absolut+UNA
nassiussartaalerniniuna	nassiussaq+TAAR-LIR+NIQ<ental<sin<Absolut+UNA
nassiussartaaqqaartulik	nassiussaq+TAAR-QQAAR+TUQ-LIK<ental<Absolut
nassiussartaassagaluarpullu	nassiussaq+TAAR-SSA=GALUAR<Indikativ<de+LU
nipilersoriartornerinuna	nipilersor+GIARTUR+NIQ<flertal<Relativ+UNA
nipilersorunnaarput	nipilersor+GUNNAAR<Indikativ<de
nipilersuinnarattaana	nipilersor-INNAR<Causativ<vi+UNA
nipilersuinnarpit	nipilersor-INNAR<Interrogativ<du
nipilersuinnarlutik	nipilersor-INNAR<Ledsagemåde<de_selv
nipilersuinnarnini	nipilersor-INNAR+NIQ<ental<sin<Absolut
nipilersuinnartungali	nipilersor-INNAR<Participium<jeg+LI
nipilersuinnartortaassasunga	nipilersor-INNAR+TUQ+TAAR-SSA<Participium<jeg
nipilersulaarnini	nipilersor-LAAR+NIQ<ental<sin<Absolut
nipilersulaartuinnannguinnarporuna	nipilersor-LAAR+TUQ-INNAQ-NNGUR-INNAR<Indikativ<han+UNA
nipilersorlutilli	nipilersor<Ledsagemåde<de_selv+LI
nipilersulerlutik	nipilersor-LIR<Ledsagemåde<de_selv
nipilersulernini	nipilersor-LIR+NIQ<ental<sin<Absolut
nipilersorniartullu	nipilersor+NIAR<Participium<de+LU
nipilersornikuusunga	nipilersor+NIKUU<Participium<jeg
nipilersornerusoq	nipilersor+NIRU+TUQ<ental<Absolut
nipilersunngilatit	nipilersor-NNGIT<Interrogativ<du
nipilersornatik	nipilersor-NNGIT<Ledsagemåde<de_selv
nipilersunnginnerali	nipilersor-NNGIT+NIQ<ental<min<Absolut+LI
nipilersunngitsut	nipilersor-NNGIT<Participium<de
nipilersunngitsorpassuilli	nipilersor-NNGIT+TUQ+PASSUAQ<flertal<Absolut+LI
nipilersoqqaarmallu	nipilersor-QQAAR<Causativ<han+LU
nipilersoqqaarpit	nipilersor-QQAAR<Interrogativ<du
nipilersoqqaarnerallu	nipilersor-QQAAR+NIQ<ental<deres+LU
nipilersoqqaarniniuna	nipilersor-QQAAR+NIQ<ental<sin<Absolut+UNA
nipilersoqqaarnerit	nipilersor-QQAAR+NIQ<flertal<Absolut
nipilersoqqaartulli	nipilersor-QQAAR<Participium<de+LI
nipilersoqqaartunga	nipilersor-QQAAR<Participium<jeg
nipilersoqqugakkuli	nipilersor-QQU<Causativ<JegHam+LI
nipilersoqquiuk	nipilersor-QQU<Interrogativ<DuHam
nipilersoriarpunga	nipilersor-RIAR<Indikativ<jeg
nipilersoriarpugununa	nipilersor-RIAR<Indikativ<vi+UNA
nipilersoriartooqqaarnerillu	nipilersor-RIAR+TUQ-U-QQAAR+NIQ<flertal<Absolut+LU
nipilersoreerama	nipilersor-RIIR<Causativ<jeg
nipilersoreerpit	nipilersor-RIIR<Interrogativ<du
nipilersoreerlutik	nipilersor-RIIR<Ledsagemåde<de_selv
nipilersorsimasunga	nipilersor+SIMA<Participium<jeg
nipilersussammanuna	nipilersor-SSA<Causativ<han+UNA
nipilersussallutik	nipilersor-SSA<Ledsagemåde<de_selv
nipilersortaraluarpungali	nipilersor+TAR=GALUAR<Indikativ<jeg+LI
nipilersortaraluarnerat	nipilersor+TAR=GALUAR+NIQ<ental<deres
nipilersortaraluartoq	nipilersor+TAR=GALUAR+TUQ<ental<Absolut
nipilersortoqassavit	nipilersor+TUQ-QAR-SSA<Interrogativ<du
nipilersorpallaartoqaqqugakku	nipilersor+VALLAAR+TUQ-QAR-QQU<Causativ<JegHam
nipilersuikkattali	nipilersor-VIP<Causativ<vi+LI
nipilersuillutik	nipilersor-VIP<Ledsagemåde<de_selv
nuka	nuka<ental<Absolut
nukaa	nuka<ental<hans<Absolut
nukaniikkunnaartulli	nuka<flertal<Lokalis+IP+GUNNAAR<Participium<de+LI
nukaannaajunnaarpugullu	nuka-INNAQ-U+GUNNAAR<Indikativ<vi+LU
nukallillu	nuka-LIK<flertal<Relativ+LU
nukaleriniartulli	nuka-LIRI+NIAR<Participium<de+LI
nukannguara	nuka-NNGUAQ<ental<min<Absolut
nukanngoriartunngoorusupporlu	nuka-NNGUR-RIAR+TUQ-NNGUAQ-U+GUSUP<Indikativ<han+LU
nukasioreerlutillu	nuka+SIUR-RIIR<Ledsagemåde<de_selv+LU
nukassatulli	nuka-SSAQ<ental<Aequalis+LI
nukataannarlutinguna	nuka+TAAR-INNAR<Ledsagemåde<de_selv+UNA
nuliarli	nuliaq<ental<Absolut+LI
nuliariiviuna	nuliaq+GIIT<flertal<hans<Absolut+UNA
nuliariilerilertoqalertooqqummangalu	nuliaq+GIIT-LIRI-LIR+TUQ-QAR-LIR+TUQ-U-QQU<Causativ<HanMig+LU
nuliaannalereqqaarlutik	nuliaq-INNAQ-LIRI-QQAAR<Ledsagemåde<de_selv
nuliallilli	nuliaq-LIK<flertal<Relativ+LI
nuliassakka	nuliaq-SSAQ<flertal<min<Absolut
nuliaanikuuit	nuliaq-U+NIKUU<Interrogativ<du
nunaa	nuna<flertal<hans<Absolut
nunaannalerereertoq	nuna-INNAQ-LIRI-RIIR+TUQ<ental<Absolut
nunallilli	nuna-LIK<flertal<Absolut+LI
nunasiunnginnatta	nuna+SIUR-NNGIT<Causativ<vi
nunassalerereerpugulli	nuna-SSAQ-LIRI-RIIR<Indikativ<vi+LI
nutserisorartortigilli	nutserisoq+GӘ+GIARTUR<Imperativ<ViDem+LI
nutserisuinnaa	nutserisoq-INNAQ<flertal<hans<Absolut
nutserisuinnalererusummataana	nutserisoq-INNAQ-LIRI+GUSUP<Causativ<de+UNA
nutserisukkunneereerpit	nutserisoq-KKUT<flertal<Lokalis+IP-RIIR<Interrogativ<du
nutserisulikka	nutserisoq-LIK<flertal<min<Absolut
nutserisuleriartoratta	nutserisoq-LIRI+GIARTUR<Causativ<vi
nutserisulerinerullutik	nutserisoq-LIRI+NIRU<Ledsagemåde<de_selv
nutserisoorusuppunga	nutserisoq-U+GUSUP<Indikativ<jeg
nutserisoorusuppungaana	nutserisoq-U+GUSUP<Indikativ<jeg+UNA
nutserisoorusuttununa	nutserisoq-U+GUSUP<Participium<de+UNA
Nuuk	Nuuk<Absolut
Nuulli	Nuuk<Absolut+LI
Nuullu	Nuuk<Absolut+LU
Nuunguna	Nuuk<Absolut+UNA
Nuummik	Nuuk<Instrumentalis
Nuummilli	Nuuk<Instrumentalis+LI
Nuumminguna	Nuuk<Instrumentalis+UNA
Nuummi	Nuuk<Lokalis
Nuummiilertungaana	Nuuk<Lokalis+IP-LIR<Participium<jeg+UNA
Nuummeeqqaarmalli	Nuuk<Lokalis+IP-QQAAR<Causativ<han+LI
Nuummeeqqummangali	Nuuk<Lokalis+IP-QQU<Causativ<HanMig+LI
Nuummeeqquassi	Nuuk<Lokalis+IP-QQU<Indikativ<JegJer
Nuummeeqqullugu	Nuuk<Lokalis+IP-QQU<Ledsagemåde<ham
Nuummeeriarlutilli	Nuuk<Lokalis+IP-RIAR<Ledsagemåde<de_selv+LI
Nuummiittarpunga	Nuuk<Lokalis+IP+TAR<Indikativ<jeg
Nuummiippallaartunga	Nuuk<Lokalis+IP+VALLAAR<Participium<jeg
Nuummiuni	Nuuk+MIU<flertal<Lokalis
Nuummiunngoraluarmata	Nuuk+MIU-NNGUR+GALUAR<Causativ<de
Nuummioqarnerli	Nuuk+MIU-QAR+NIQ+LI
Nuummiuulaartartulinngoqqaarpugulli	Nuuk+MIU-U-LAAR=TAR+TUQ-LIK-NNGUR-QQAAR<Indikativ<vi+LI
Nuummiooriarnini	Nuuk+MIU-U-RIAR+NIQ<ental<sin<Absolut
Nuummiooreertulli	Nuuk+MIU-U-RIIR<Participium<de+LI
Nuummukanngilatit	Nuuk<Terminalis-KAR-NNGIT<Interrogativ<du
Nuummukassammatalu	Nuuk<Terminalis-KAR-SSA<Causativ<de+LU
Nuummulli	Nuuk<Terminalis+LI
Nuummununa	Nuuk<Terminalis+UNA
Nuukkut	Nuuk<Vialis
Nuukkulli	Nuuk<Vialis+LI
Nuukkullu	Nuuk<Vialis+LU
Nuukkununa	Nuuk<Vialis+UNA
nuummata	nuup<Causativ<de
nuummat	nuup<Causativ<han
nuukkamali	nuup<Causativ<jeg+LI
nuukkunnaarmata	nuup+GUNNAAR<Causativ<de
nuuppunga	nuup<Indikativ<jeg
nuulaartulerivallaanngilatit	nuup-LAAR+TUQ-LIRI+VALLAAR=NNGIT<Interrogativ<du
nuuttununa	nuup<Participium<de+UNA
nooqqaarmata	nuup-QQAAR<Causativ<de
nooqqaarattaana	nuup-QQAAR<Causativ<vi+UNA
nooqqaarpunga	nuup-QQAAR<Indikativ<jeg
nooqqaarpungali	nuup-QQAAR<Indikativ<jeg+LI
nooqqaarpit	nuup-QQAAR<Interrogativ<du
nooqqaarlutik	nuup-QQAAR<Ledsagemåde<de_selv
nooqqaarnera	nuup-QQAAR+NIQ<ental<hans<Absolut
nooqqaarnini	nuup-QQAAR+NIQ<ental<sin<Absolut
nooqqaarninili	nuup-QQAAR+NIQ<ental<sin<Absolut+LI
nooqqaarnerilli	nuup-QQAAR+NIQ<flertal<Relativ+LI
nooqqaartulli	nuup-QQAAR<Participium<de+LI
nooqqaartoq	nuup-QQAAR<Participium<han
nooqqaartunga	nuup-QQAAR<Participium<jeg
nooqqaartoq	nuup-QQAAR+TUQ<ental<Absolut
nooqqaartulimmukariarlutillu	nuup-QQAAR+TUQ-LIK<ental<Terminalis-KAR-RIAR<Ledsagemåde<de_selv+LU
nooqqaartorpassuarninguna	nuup-QQAAR+TUQ+PASSUAQ<flertal<Instrumentalis+UNA
nooqqaartooqqularalu	nuup-QQAAR+TUQ-U-QQU<Optativ<JegHam+LU
nooqqugakku	nuup-QQU<Causativ<JegHam
nooqqugakkulu	nuup-QQU<Causativ<JegHam+LU
nooqqutigilli	nuup-QQU<Imperativ<ViDem+LI
nooqqutiginuna	nuup-QQU<Imperativ<ViDem+UNA
nooqquaannga	nuup-QQU<Indikativ<DeMig
nooqquassilu	nuup-QQU<Indikativ<JegJer+LU
nooqquiuk	nuup-QQU<Interrogativ<DuHam
nooqqullugu	nuup-QQU<Ledsagemåde<ham
nooqqulluguli	nuup-QQU<Ledsagemåde<ham+LI
nooqqulara	nuup-QQU<Optativ<JegHam
nooqqularalu	nuup-QQU<Optativ<JegHam+LU
nooriarattali	nuup-RIAR<Causativ<vi+LI
nooriarput	nuup-RIAR<Indikativ<de
nooriarpunga	nuup-RIAR<Indikativ<jeg
nooriarpit	nuup-RIAR<Interrogativ<du
nooriarnerilli	nuup-RIAR+NIQ<flertal<Absolut+LI
nooriartulli	nuup-RIAR<Participium<de+LI
nooriartoq	nuup-RIAR+TUQ<ental<Absolut
nooriartoqareerlutinguna	nuup-RIAR+TUQ-QAR-RIIR<Ledsagemåde<de_selv+UNA
nooreerama	nuup-RIIR<Causativ<jeg
nooreerput	nuup-RIIR<Indikativ<de
nooreerpungali	nuup-RIIR<Indikativ<jeg+LI
nooreerpit	nuup-RIIR<Interrogativ<du
nooreerlutik	nuup-RIIR<Ledsagemåde<de_selv
nooreernertullu	nuup-RIIR+NIQ<ental<Aequalis+LU
nooreertoq	nuup-RIIR<Participium<han
nooreertuneeqqutigit	nuup-RIIR+TUQ<flertal<Lokalis+IP-QQU<Imperativ<ViDem
nooreertullillu	nuup-RIIR+TUQ-LIK<flertal<Absolut+LU
nuussimaniniuna	nuup+SIMA+NIQ<ental<sin<Absolut+UNA
nuuppallaarnini	nuup+VALLAAR+NIQ<ental<sin<Absolut
oqaaseq	oqaaseq<ental<Absolut
oqaatsitut	oqaaseq<ental<Aequalis
oqaatsitulli	oqaaseq<ental<Aequalis+LI
oqaasialli	oqaaseq<ental<deres<Absolut+LI
oqaatsimik	oqaaseq<ental<Instrumentalis
oqaatsimi	oqaaseq<ental<Lokalis
oqaatsimeeqqaarnerlu	oqaaseq<ental<Lokalis+IP-QQAAR+NIQ+LU
oqaatsimeeqqaartungalu	oqaaseq<ental<Lokalis+IP-QQAAR<Participium<jeg+LU
oqaatsimeeriartunga	oqaaseq<ental<Lokalis+IP-RIAR<Participium<jeg
oqaatsimalu	oqaaseq<ental<min>Relativ+LU
oqaatsinilli	oqaaseq<flertal<flertal<Instrumentalis+LI
oqaasii	oqaaseq<flertal<hans<Absolut
oqaasiili	oqaaseq<flertal<hans<Absolut+LI
oqaatsini	oqaaseq<flertal<Lokalis
oqaatsineeriartoq	oqaaseq<flertal<Lokalis+IP-RIAR+TUQ
oqaatsikka	oqaaseq<flertal<min<Absolut
oqaatsima	oqaaseq<flertal<min>Relativ
oqaatsinukaannarpulli	oqaaseq<flertal<Terminalis-KAR-INNAR<Indikativ<de+LI
oqaatsinukariartoq	oqaaseq<flertal<Terminalis-KAR-RIAR+TUQ
oqaaseriittulli	oqaaseq+GIIT<flertal<Aequalis+LI
oqaaseriinngoqqulara	oqaaseq+GIIT-NNGUR-QQU<Optativ<JegHam
oqaasereqquanuna	oqaaseq+GӘ-QQU<Indikativ<DuHam+UNA
oqaasilererusukkamalu	oqaaseq-LIRI+GUSUP<Causativ<jeg+LU
oqaasilerisulli	oqaaseq-LIRI<Participium<de+LI
oqaasinnguali	oqaaseq-NNGUAQ<ental<hans<Absolut+LI
oqaaserpassuilli	oqaaseq+PASSUAQ<flertal<Absolut+LI
oqaaseqaannaramalu	oqaaseq-QAR-INNAR<Causativ<jeg+LU
oqaaseqarniarpunga	oqaaseq-QAR+NIAR<Indikativ<jeg
oqaasersiuinnarnini	oqaaseq+SIUR-INNAR+NIQ<ental<sin<Absolut
oqaasissartaavillutilli	oqaaseq-SSAQ+TAAR-VIP<Ledsagemåde<de_selv+LI
oqaasioqqaartussamullu	oqaaseq-U-QQAAR+TUQ-SSAQ<ental<Terminalis+LU
oqaasiussappununa	oqaaseq-U-SSA<Indikativ<de+UNA
oqaasiusukkut	oqaaseq-U+TUQ-KKUT<flertal<Absolut
oqaasilerinimaana	oqaasilerineq<flertal<min>Relativ+UNA
oqaasilerinilereqquagununa	oqaasilerineq-LIRI-QQU<Indikativ<ViDem+UNA
oqaasilerinermiuussagaluarnermali	oqaasilerineq+MIU-U-SSA=GALUAR+NIQ<ental<min>Relativ+LI
oqaasilerisoriinniivimmat	oqaasilerisoq+GIIT<flertal<Lokalis+IP-VIP<Causativ<han
oqaasilerisoorusullutillu	oqaasilerisoq-U+GUSUP<Ledsagemåde<de_selv+LU
oqaasilerisooqqaarninilu	oqaasilerisoq-U-QQAAR+NIQ<ental<sin<Absolut+LU
oqaluttuarunnaaratta	oqaluttuar+GUNNAAR<Causativ<vi
oqaluttuarusullutillu	oqaluttuar+GUSUP<Ledsagemåde<de_selv+LU
oqaluttuarpungali	oqaluttuar<Indikativ<jeg+LI
oqaluttuaannarpit	oqaluttuar-INNAR<Interrogativ<du
oqaluttuaannartoqaqqulara	oqaluttuar-INNAR+TUQ-QAR-QQU<Optativ<JegHam
oqaluttuarisaanikkulli	oqaluttuarisaaneq-KKUT<flertal<Absolut+LI
oqaluttualaarmata	oqaluttuar-LAAR<Causativ<de
oqaluttualaarpit	oqaluttuar-LAAR<Interrogativ<du
oqaluttualaartarpoq	oqaluttuar-LAAR=TAR<Indikativ<han
oqaluttualaartartullu	oqaluttuar-LAAR=TAR<Participium<de+LU
oqaluttuarluarpit	oqaluttuar+LUAR<Interrogativ<du
oqaluttuarniartulli	oqaluttuar+NIAR<Participium<de+LI
oqaluttuarnikuusullu	oqaluttuar+NIKUU<Participium<de+LU
oqaluttuarninilu	oqaluttuar+NIQ<ental<sin<Absolut+LU
oqaluttuarneruit	oqaluttuar+NIRU<Interrogativ<du
oqaluttuarnatinguna	oqaluttuar-NNGIT<Ledsagemåde<de_selv+UNA
oqaluttuaqqaarlutilli	oqaluttuar-QQAAR<Ledsagemåde<de_selv+LI
oqaluttuaqquai	oqaluttuar-QQU<Indikativ<HanDem
oqaluttuaqqullugu	oqaluttuar-QQU<Ledsagemåde<ham
oqaluttuaqqullugulu	oqaluttuar-QQU<Ledsagemåde<ham+LU
oqaluttuariarmatali	oqaluttuar-RIAR<Causativ<de+LI
oqaluttuariarama	oqaluttuar-RIAR<Causativ<jeg
oqaluttuariartoorusukkamaana	oqaluttuar-RIAR+TUQ-U+GUSUP<Causativ<jeg+UNA
oqaluttuareermanuna	oqaluttuar-RIIR<Causativ<han+UNA
oqaluttuareerneranuna	oqaluttuar-RIIR+NIQ<ental<deres+UNA
oqaluttuarsinnaavugulli	oqaluttuar+SINNAA<Indikativ<vi+LI
oqaluttuarsinnaavit	oqaluttuar+SINNAA<Interrogativ<du
oqaluttuassammat	oqaluttuar-SSA<Causativ<han
oqaluttuassagaluaramali	oqaluttuar-SSA=GALUAR<Causativ<jeg+LI
oqaluttuassagaluarlutilli	oqaluttuar-SSA=GALUAR<Ledsagemåde<de_selv+LI
oqaluttuassagaluartorli	oqaluttuar-SSA=GALUAR<Participium<han+LI
oqaluttuartuunnginnini	oqaluttuar+TUQ-U-NNGIT+NIQ<ental<sin<Absolut
oqaluttuarpallaartunnguulaartarpit	oqaluttuar+VALLAAR+TUQ-NNGUAQ-U-LAAR=TAR<Interrogativ<du
oqaluttuavimmatalu	oqaluttuar-VIP<Causativ<de+LU
oqaluttuavinninilu	oqaluttuar-VIP+NIQ<ental<sin<Absolut+LU
oqaluttuavittulli	oqaluttuar-VIP<Participium<de+LI
oqaluttuavittutulli	oqaluttuar-VIP+TUQ<ental<Aequalis+LI
oqaluttuavittoqalermanuna	oqaluttuar-VIP+TUQ-QAR-LIR<Causativ<han+UNA
oqaluttuaritigilli	oqaluttuarә<Imperativ<ViDem+LI
oqaluttuarisimasarpiuk	oqaluttuarә+SIMA=TAR<Interrogativ<DuHam
oqaramalu	oqar<Causativ<jeg+LU
oqarfigeriarlugulu	oqarfigә-RIAR<Ledsagemåde<ham+LU
oqaraluarneraana	oqar+GALUAR+NIQ<ental<hans<Absolut+UNA
oqaraluarnerinuna	oqar+GALUAR+NIQ<flertal<Absolut+UNA
oqaraluartunga	oqar+GALUAR<Participium<jeg
oqariartorniniuna	oqar+GIARTUR+NIQ<ental<sin<Absolut+UNA
oqariartortununa	oqar+GIARTUR<Participium<de+UNA
oqarunnaarpunga	oqar+GUNNAAR<Indikativ<jeg
oqarunnaarpugulli	oqar+GUNNAAR<Indikativ<vi+LI
oqarunnaarlutik	oqar+GUNNAAR<Ledsagemåde<de_selv
oqarunnaarnerillu	oqar+GUNNAAR+NIQ<flertal<Relativ+LU
oqarunnaartoq	oqar+GUNNAAR<Participium<han
oqarunnaartooriarpunga	oqar+GUNNAAR+TUQ-U-RIAR<Indikativ<jeg
oqarpunga	oqar<Indikativ<jeg
oqaannarpugut	oqar-INNAR<Indikativ<vi
oqaannarpugulli	oqar-INNAR<Indikativ<vi+LI
oqaannarlutilli	oqar-INNAR<Ledsagemåde<de_selv+LI
oqalaarporli	oqar-LAAR<Indikativ<han+LI
oqalaarpungali	oqar-LAAR<Indikativ<jeg+LI
oqalaartarattaana	oqar-LAAR=TAR<Causativ<vi+UNA
oqalaartarpulli	oqar-LAAR=TAR<Indikativ<de+LI
oqalaartarpit	oqar-LAAR=TAR<Interrogativ<du
oqalaartarlutik	oqar-LAAR=TAR<Ledsagemåde<de_selv
oqalaartarnini	oqar-LAAR=TAR+NIQ<ental<sin<Absolut
oqalaartartoqassallutik	oqar-LAAR=TAR+TUQ-QAR-SSA<Ledsagemåde<de_selv
oqarlutilli	oqar<Ledsagemåde<de_selv+LI
oqarlutillu	oqar<Ledsagemåde<de_selv+LU
oqalerlutilli	oqar-LIR<Ledsagemåde<de_selv+LI
oqalerlutinguna	oqar-LIR<Ledsagemåde<de_selv+UNA
oqalernini	oqar-LIR+NIQ<ental<sin<Absolut
oqalertukkununa	oqar-LIR+TUQ<ental<Vialis+UNA
oqarniarlutinguna	oqar+NIAR<Ledsagemåde<de_selv+UNA
oqarniarnatilli	oqar+NIAR=NNGIT<Ledsagemåde<de_selv+LI
oqarniannginnera	oqar+NIAR=NNGIT+NIQ<ental<hans<Absolut
oqarniartulli	oqar+NIAR<Participium<de+LI
oqarniartoruna	oqar+NIAR<Participium<han+UNA
oqarnini	oqar+NIQ<ental<sin<Absolut
oqarninili	oqar+NIQ<ental<sin<Absolut+LI
oqarnerlutillu	oqar+NIR<Ledsagemåde<de_selv+LU
oqarnertunga	oqar+NIR<Participium<jeg
oqarnertuusoorusuttukkut	oqar+NIR+TUQ-U+TUQ-U+GUSUP+TUQ-KKUT<flertal<Absolut
oqarnerugamali	oqar+NIRU<Causativ<jeg+LI
oqarneruvugununa	oqar+NIRU<Indikativ<vi+UNA
oqarnerullutik	oqar+NIRU<Ledsagemåde<de_selv
oqanngilatit	oqar-NNGIT<Interrogativ<du
oqannginniniuna	oqar-NNGIT+NIQ<ental<sin<Absolut+UNA
oqannginnerilli	oqar-NNGIT+NIQ<flertal<Relativ+LI
oqanngitsooqqaartulerillutillu	oqar-NNGIT+TUQ-U-QQAAR+TUQ-LIRI<Ledsagemåde<de_selv+LU
oqartunga	oqar<Participium<jeg
oqaqqaaratta	oqar-QQAAR<Causativ<vi
oqaqqaarpugulli	oqar-QQAAR<Indikativ<vi+LI
oqaqqaarpugununa	oqar-QQAAR<Indikativ<vi+UNA
oqaqqaarpit	oqar-QQAAR<Interrogativ<du
oqaqqugakkuuna	oqar-QQU<Causativ<JegHam+UNA
oqaqqutigillu	oqar-QQU<Imperativ<ViDem+LU
oqaqquakka	oqar-QQU<Indikativ<JegDem
oqaqqulara	oqar-QQU<Optativ<JegHam
oqariarpit	oqar-RIAR<Interrogativ<du
oqariarnerneeqqaartorlu	oqar-RIAR+NIQ<flertal<Lokalis+IP-QQAAR+TUQ+LU
oqariartumi	oqar-RIAR+TUQ<ental<Lokalis
oqareerama	oqar-RIIR<Causativ<jeg
oqareerpit	oqar-RIIR<Interrogativ<du
oqarsimavit	oqar+SIMA<Interrogativ<du
oqarsimasarneralu	oqar+SIMA=TAR+NIQ<ental<min<Absolut+LU
oqarsimasulererusukkattaana	oqar+SIMA+TUQ-LIRI+GUSUP<Causativ<vi+UNA
oqarsinnaavit	oqar+SINNAA<Interrogativ<du
oqassagaluarmalli	oqar-SSA=GALUAR<Causativ<han+LI
oqassagaluarmallu	oqar-SSA=GALUAR<Causativ<han+LU
oqassagaluaramaana	oqar-SSA=GALUAR<Causativ<jeg+UNA
oqassagaluarporlu	oqar-SSA=GALUAR<Indikativ<han+LU
oqassagaluarpugut	oqar-SSA=GALUAR<Indikativ<vi
oqassagaluarpit	oqar-SSA=GALUAR<Interrogativ<du
oqassagaluarnertut	oqar-SSA=GALUAR+NIQ<ental<Aequalis
oqassagaluartununa	oqar-SSA=GALUAR<Participium<de+UNA
oqassaaq	oqar-SSA<Indikativ<han
oqassaanga	oqar-SSA<Indikativ<jeg
oqartaraluarnini	oqar+TAR=GALUAR+NIQ<ental<sin<Absolut
oqartartukkuili	oqar+TAR+TUQ-KKUT<flertal<hans<Absolut+LI
oqartulererusuppoq	oqar+TUQ-LIRI+GUSUP<Indikativ<han
oqartooreerpungaana	oqar+TUQ-U-RIIR<Indikativ<jeg+UNA
oqarpallaarpunga	oqar+VALLAAR<Indikativ<jeg
oqarpallaanngimmata	oqar+VALLAAR=NNGIT<Causativ<de
oqarpallaanngilanga	oqar+VALLAAR=NNGIT<Indikativ<jeg
oqarpallaartulli	oqar+VALLAAR<Participium<de+LI
oqavittooreermata	oqar-VIP+TUQ-U-RIIR<Causativ<de
Paamiut	Paamiut<Absolut
Paamiulli	Paamiut<Absolut+LI
Paamiullu	Paamiut<Absolut+LU
Paamiununa	Paamiut<Absolut+UNA
Paamiunik	Paamiut<Instrumentalis
Paamiunilli	Paamiut<Instrumentalis+LI
Paamiunillu	Paamiut<Instrumentalis+LU
Paamiuninguna	Paamiut<Instrumentalis+UNA
Paamiuni	Paamiut<Lokalis
Paamiuniilaartarpit	Paamiut<Lokalis+IP-LAAR=TAR<Interrogativ<du
Paamiuneeqqaarpugut	Paamiut<Lokalis+IP-QQAAR<Indikativ<vi
Paamiuneeqqaarlutik	Paamiut<Lokalis+IP-QQAAR<Ledsagemåde<de_selv
Paamiuneeqqutiginuna	Paamiut<Lokalis+IP-QQU<Imperativ<ViDem+UNA
Paamiuneeriarpugununa	Paamiut<Lokalis+IP-RIAR<Indikativ<vi+UNA
Paamiuneereerlutinguna	Paamiut<Lokalis+IP-RIIR<Ledsagemåde<de_selv+UNA
Paamiuneereertunga	Paamiut<Lokalis+IP-RIIR<Participium<jeg
Paamiuniissagaluartorli	Paamiut<Lokalis+IP-SSA=GALUAR+TUQ+LI
Paamiuniuna	Paamiut<Lokalis+UNA
Paamiormiuli	Paamiut+MIU<ental<Absolut+LI
Paamiormiuuna	Paamiut+MIU<ental<Absolut+UNA
Paamiormiumi	Paamiut+MIU<ental<Lokalis
Paamiormiumeeqqaarneruna	Paamiut+MIU<ental<Lokalis+IP-QQAAR+NIQ+UNA
Paamiormiunik	Paamiut+MIU<flertal<Instrumentalis
Paamiormiuni	Paamiut+MIU<flertal<Lokalis
Paamiormiuniillutik	Paamiut+MIU<flertal<Lokalis+IP<Ledsagemåde<de_selv
Paamiormiulererusullutillu	Paamiut+MIU-LIRI+GUSUP<Ledsagemåde<de_selv+LU
Paamiormiulererusunnerilli	Paamiut+MIU-LIRI+GUSUP+NIQ<flertal<Absolut+LI
Paamiormiulerisimaninili	Paamiut+MIU-LIRI+SIMA+NIQ<ental<sin<Absolut+LI
Paamiormiunngulaartartulli	Paamiut+MIU-NNGUR-LAAR=TAR<Participium<de+LI
Paamiormiunngulerpulli	Paamiut+MIU-NNGUR-LIR<Indikativ<de+LI
Paamiormiunngoqqaartooqqaartungaana	Paamiut+MIU-NNGUR-QQAAR+TUQ-U-QQAAR<Participium<jeg+UNA
Paamiormiunngoriarlutilli	Paamiut+MIU-NNGUR-RIAR<Ledsagemåde<de_selv+LI
Paamiormiunngussagaluartoqariartoqalerporuna	Paamiut+MIU-NNGUR-SSA=GALUAR+TUQ-QAR-RIAR+TUQ-QAR-LIR<Indikativ<han+UNA
Paamiormioqarpoq	Paamiut+MIU-QAR<Indikativ<han
Paamiormioqarneq	Paamiut+MIU-QAR+NIQ
Paamiormioqarnerlu	Paamiut+MIU-QAR+NIQ+LU
Paamiormioqarneruna	Paamiut+MIU-QAR+NIQ+UNA
Paamiormioqartoq	Paamiut+MIU-QAR<Participium<han
Paamiormioqartorli	Paamiut+MIU-QAR<Participium<han+LI
Paamiormioqartorlu	Paamiut+MIU-QAR<Participium<han+LU
Paamiormioqartoq	Paamiut+MIU-QAR+TUQ
Paamiormioqartorli	Paamiut+MIU-QAR+TUQ+LI
Paamiormiuujunnaartussanngoqqutigilli	Paamiut+MIU-U+GUNNAAR+TUQ-SSAQ-NNGUR-QQU<Imperativ<ViDem+LI
Paamiormioorusunnerniilluartoqarpoq	Paamiut+MIU-U+GUSUP+NIQ<flertal<Lokalis+IP+LUAR+TUQ-QAR<Indikativ<han
Paamiormiuulaartarattali	Paamiut+MIU-U-LAAR=TAR<Causativ<vi+LI
Paamiormiuulluarama	Paamiut+MIU-U+LUAR<Causativ<jeg
Paamiormiuunikuuit	Paamiut+MIU-U+NIKUU<Interrogativ<du
Paamiormiuunerusunnguillutilli	Paamiut+MIU-U+NIRU+TUQ-NNGUR-VIP<Ledsagemåde<de_selv+LI
Paamiormiooqqaartuma	Paamiut+MIU-U-QQAAR+TUQ<ental<min>Relativ
Paamiormiooriarmatalu	Paamiut+MIU-U-RIAR<Causativ<de+LU
Paamiormiooriarporuna	Paamiut+MIU-U-RIAR<Indikativ<han+UNA
Paamiormiooreermanuna	Paamiut+MIU-U-RIIR<Causativ<han+UNA
Paamiormiooreeramali	Paamiut+MIU-U-RIIR<Causativ<jeg+LI
Paamiormiuusimasoq	Paamiut+MIU-U+SIMA<Participium<han
Paamiormiuusaraluarama	Paamiut+MIU-U+TAR=GALUAR<Causativ<jeg
Paamiormiuusaraluarpit	Paamiut+MIU-U+TAR=GALUAR<Interrogativ<du
Paamiunut	Paamiut<Terminalis
Paamiunukalaarnerlu	Paamiut<Terminalis-KAR-LAAR+NIQ+LU
Paamiunukalaartarmatali	Paamiut<Terminalis-KAR-LAAR=TAR<Causativ<de+LI
Paamiunukarluarpit	Paamiut<Terminalis-KAR+LUAR<Interrogativ<du
Paamiunukarnikuullutilli	Paamiut<Terminalis-KAR+NIKUU<Ledsagemåde<de_selv+LI
Paamiunukanngilagulli	Paamiut<Terminalis-KAR-NNGIT<Indikativ<vi+LI
Paamiunukaqqularali	Paamiut<Terminalis-KAR-QQU<Optativ<JegHam+LI
Paamiunukariarlutik	Paamiut<Terminalis-KAR-RIAR<Ledsagemåde<de_selv
Paamiunukassasullu	Paamiut<Terminalis-KAR-SSA<Participium<de+LU
Paamiunununa	Paamiut<Terminalis+UNA
paasigakkuli	paasi<Causativ<JegHam+LI
paasiartortigilli	paasi+GIARTUR<Imperativ<ViDem+LI
paasiartorlugu	paasi+GIARTUR<Ledsagemåde<ham
paasiartorlaraana	paasi+GIARTUR<Optativ<JegHam+UNA
paaserusukkakku	paasi+GUSUP<Causativ<JegHam
paaserusukkakkulu	paasi+GUSUP<Causativ<JegHam+LU
paasitigillu	paasi<Imperativ<ViDem+LU
paasilaartiginuna	paasi-LAAR<Imperativ<ViDem+UNA
paasiniarnaginuna	paasi+NIAR=NNGIT<Ledsagemåde<dem+UNA
paasinerulara	paasi+NIRU<Optativ<JegHam
paaseqqaarpaali	paasi-QQAAR<Indikativ<HanHam+LI
paaseqqaarpagut	paasi-QQAAR<Indikativ<ViDem
paaseqqaarlara	paasi-QQAAR<Optativ<JegHam
paaseqqugakkuli	paasi-QQU<Causativ<JegHam+LI
paaseqquiuk	paasi-QQU<Interrogativ<DuHam
paaseqqullugulu	paasi-QQU<Ledsagemåde<ham+LU
paaseqqulara	paasi-QQU<Optativ<JegHam
paaseriarpaangali	paasi-RIAR<Indikativ<HanMig+LI
paaseriarlugillu	paasi-RIAR<Ledsagemåde<dem+LU
paaseriarlugu	paasi-RIAR<Ledsagemåde<ham
paasereerakku	paasi-RIIR<Causativ<JegHam
paasereerlara	paasi-RIIR<Optativ<JegHam
paasereerlarali	paasi-RIIR<Optativ<JegHam+LI
paasisimasartigillu	paasi+SIMA=TAR<Imperativ<ViDem+LU
paasisimasarpat	paasi+SIMA=TAR<Indikativ<DuHam
paasisimasarlaralu	paasi+SIMA=TAR<Optativ<JegHam+LU
paasisinnaammanga	paasi+SINNAA<Causativ<HanMig
paasissammangaana	paasi-SSA<Causativ<HanMig+UNA
paasisarlugu	paasi+TAR<Ledsagemåde<ham
paasivallaanngilaajuna	paasi+VALLAAR=NNGIT<Indikativ<HanHam+UNA
panigalu	panik<ental<min<Absolut+LU
paninnili	panik<ental<sin<Absolut+LI
paninnik	panik<flertal<Instrumentalis
paninnullu	panik<flertal<Terminalis+LU
panigiilli	panik+GIIT<flertal<Relativ+LI
panimmiulereqqaartuulluartoqalaarneralli	panik+MIU-LIRI-QQAAR+TUQ-U+LUAR+TUQ-QAR-LAAR+NIQ<ental<deres+LI
paninngooqqaarninili	panik-NNGUAQ-U-QQAAR+NIQ<ental<sin<Absolut+LI
panippassuit	panik+PASSUAQ<flertal<Absolut
paneqariartorpunga	panik-QAR+GIARTUR<Indikativ<jeg
paneqaannartuussavit	panik-QAR-INNAR+TUQ-U-SSA<Interrogativ<du
paneqalaarmalli	panik-QAR-LAAR<Causativ<han+LI
paneqalaarpugut	panik-QAR-LAAR<Indikativ<vi
paneqalaarpugulli	panik-QAR-LAAR<Indikativ<vi+LI
paneqalaarnini	panik-QAR-LAAR+NIQ<ental<sin<Absolut
paneqalaartarneq	panik-QAR-LAAR=TAR+NIQ<ental<Absolut
paneqalaartulerilaarmata	panik-QAR-LAAR+TUQ-LIRI-LAAR<Causativ<de
paneqarnerlutik	panik-QAR+NIR<Ledsagemåde<de_selv
paneqaqqaartununa	panik-QAR-QQAAR<Participium<de+UNA
paneqareertunga	panik-QAR-RIIR<Participium<jeg
paneqassagaluarpugununa	panik-QAR-SSA=GALUAR<Indikativ<vi+UNA
paneqassagaluartunga	panik-QAR-SSA=GALUAR<Participium<jeg
paneqassaanga	panik-QAR-SSA<Indikativ<jeg
paneqassallutilli	panik-QAR-SSA<Ledsagemåde<de_selv+LI
paneqavikkama	panik-QAR-VIP<Causativ<jeg
panissioqqaartulli	panik+SIUR-QQAAR<Participium<de+LI
piareeriarneralu	piareer-RIAR+NIQ<ental<hans<Absolut+LU
piariissaangali	piareer-SSA<Indikativ<jeg+LI
pimmanga	pi<Causativ<HanMig
pimmangali	pi<Causativ<HanMig+LI
pigakku	pi<Causativ<JegHam
pigaluarakkulu	pi+GALUAR<Causativ<JegHam+LU
pigaluarlarali	pi+GALUAR<Optativ<JegHam+LI
piartorakkulu	pi+GIARTUR<Causativ<JegHam+LU
piunnaartigit	pi+GUNNAAR<Imperativ<ViDem
piunnaarpagununa	pi+GUNNAAR<Indikativ<ViDem+UNA
piunnaarlarali	pi+GUNNAAR<Optativ<JegHam+LI
perusummanga	pi+GUSUP<Causativ<HanMig
perusukkakku	pi+GUSUP<Causativ<JegHam
perusukkakkulu	pi+GUSUP<Causativ<JegHam+LU
perusukkakkuuna	pi+GUSUP<Causativ<JegHam+UNA
perusutsigilli	pi+GUSUP<Imperativ<ViDem+LI
perusuppakkaana	pi+GUSUP<Indikativ<JegDem+UNA
perusuppiuk	pi+GUSUP<Interrogativ<DuHam
perusullugu	pi+GUSUP<Ledsagemåde<ham
perusullara	pi+GUSUP<Optativ<JegHam
pitigillu	pi<Imperativ<ViDem+LU
pivagullu	pi<Indikativ<ViDem+LU
piinnarakku	pi-INNAR<Causativ<JegHam
piinnarpaali	pi-INNAR<Indikativ<HanDem+LI
piinnarpaa	pi-INNAR<Indikativ<HanHam
piviuk	pi<Interrogativ<DuHam
pilaarpiuk	pi-LAAR<Interrogativ<DuHam
pilaarlara	pi-LAAR<Optativ<JegHam
pilaartartigillu	pi-LAAR=TAR<Imperativ<ViDem+LU
pilaartarpaanga	pi-LAAR=TAR<Indikativ<HanMig
pilerpiuk	pi-LIR<Interrogativ<DuHam
pilerlaralu	pi-LIR<Optativ<JegHam+LU
pilluartigillu	pi+LUAR<Imperativ<ViDem+LU
pilluarlara	pi+LUAR<Optativ<JegHam
pingasuniippallaanngillalli	pingasut<Talord<Lokalis+IP+VALLAAR=NNGIT<Indikativ<de+LI
piniarakkuuna	pi+NIAR<Causativ<JegHam+UNA
piniartigilli	pi+NIAR<Imperativ<ViDem+LI
piniarpassi	pi+NIAR<Indikativ<JegJer
piniarnagilli	pi+NIAR=NNGIT<Ledsagemåde<dem+LI
pinikuugakku	pi+NIKUU<Causativ<JegHam
pinikuutigilli	pi+NIKUU<Imperativ<ViDem+LI
pineqarpoq	pi+NIQAR<Indikativ<han
pineqarpit	pi+NIQAR<Interrogativ<du
pineqarninilu	pi+NIQAR+NIQ<ental<sin<Absolut+LU
pinerlara	pi+NIR<Optativ<JegHam
pinerullugit	pi+NIRU<Ledsagemåde<dem
pinngiliuk	pi-NNGIT<Interrogativ<DuHam
pinaginuna	pi-NNGIT<Ledsagemåde<dem+UNA
pinaguuna	pi-NNGIT<Ledsagemåde<ham+UNA
peqqaarmanga	pi-QQAAR<Causativ<HanMig
peqqaarakku	pi-QQAAR<Causativ<JegHam
peqqaartigillu	pi-QQAAR<Imperativ<ViDem+LU
peqqaartiginuna	pi-QQAAR<Imperativ<ViDem+UNA
peqqaarpagut	pi-QQAAR<Indikativ<ViDem
peqqaarpiuk	pi-QQAAR<Interrogativ<DuHam
peqqaarlugu	pi-QQAAR<Ledsagemåde<ham
peqqaarlara	pi-QQAAR<Optativ<JegHam
peqqaarlaraana	pi-QQAAR<Optativ<JegHam+UNA
peqqugakku	pi-QQU<Causativ<JegHam
peqqutigillu	pi-QQU<Imperativ<ViDem+LU
peqqutiginuna	pi-QQU<Imperativ<ViDem+UNA
peqquaalli	pi-QQU<Indikativ<DeHam+LI
peqquaannga	pi-QQU<Indikativ<DeMig
peqquaajuna	pi-QQU<Indikativ<HanHam+UNA
peqquakka	pi-QQU<Indikativ<JegDem
peqquassili	pi-QQU<Indikativ<JegJer+LI
periarmanga	pi-RIAR<Causativ<HanMig
periartigit	pi-RIAR<Imperativ<ViDem
periartigillu	pi-RIAR<Imperativ<ViDem+LU
periarpai	pi-RIAR<Indikativ<HanDem
periarpiuk	pi-RIAR<Interrogativ<DuHam
periarlugilli	pi-RIAR<Ledsagemåde<dem+LI
periarlugu	pi-RIAR<Ledsagemåde<ham
periarlara	pi-RIAR<Optativ<JegHam
periarlarali	pi-RIAR<Optativ<JegHam+LI
periarlaralu	pi-RIAR<Optativ<JegHam+LU
pereermangali	pi-RIIR<Causativ<HanMig+LI
pereerakku	pi-RIIR<Causativ<JegHam
pereertigit	pi-RIIR<Imperativ<ViDem
pereertigilli	pi-RIIR<Imperativ<ViDem+LI
pereertiginuna	pi-RIIR<Imperativ<ViDem+UNA
pereerpaa	pi-RIIR<Indikativ<HanHam
pereerpaanga	pi-RIIR<Indikativ<HanMig
pereerpaangalu	pi-RIIR<Indikativ<HanMig+LU
pereerpakkali	pi-RIIR<Indikativ<JegDem+LI
pereerpassi	pi-RIIR<Indikativ<JegJer
pereerpiuk	pi-RIIR<Interrogativ<DuHam
pereerlugu	pi-RIIR<Ledsagemåde<ham
pereerlara	pi-RIIR<Optativ<JegHam
pereerlarali	pi-RIIR<Optativ<JegHam+LI
pisimatiginuna	pi+SIMA<Imperativ<ViDem+UNA
pisimasartigit	pi+SIMA=TAR<Imperativ<ViDem
pisimasartigilli	pi+SIMA=TAR<Imperativ<ViDem+LI
pisimasarpiuk	pi+SIMA=TAR<Interrogativ<DuHam
pisinnaaviuk	pi+SINNAA<Interrogativ<DuHam
pisinnaalara	pi+SINNAA<Optativ<JegHam
pissagaluartigilli	pi-SSA=GALUAR<Imperativ<ViDem+LI
pissagaluarpat	pi-SSA=GALUAR<Indikativ<DuHam
pissagaluarlara	pi-SSA=GALUAR<Optativ<JegHam
pissallugu	pi-SSA<Ledsagemåde<ham
pissummi	pissut<ental<Lokalis
pissummeeqqaartorli	pissut<ental<Lokalis+IP-QQAAR+TUQ+LI
pissutitaassagatta	pissut+TAAR-SSA<Causativ<vi
pisaraluartigilli	pi+TAR=GALUAR<Imperativ<ViDem+LI
pisaraluarpassi	pi+TAR=GALUAR<Indikativ<JegJer
pisaraluarpassilu	pi+TAR=GALUAR<Indikativ<JegJer+LU
Pituffik	Pituffik<Absolut
Pituffilli	Pituffik<Absolut+LI
Pituffillu	Pituffik<Absolut+LU
Pituffinguna	Pituffik<Absolut+UNA
Pituffimmik	Pituffik<Instrumentalis
Pituffimmillu	Pituffik<Instrumentalis+LU
Pituffimminguna	Pituffik<Instrumentalis+UNA
Pituffimmi	Pituffik<Lokalis
Pituffimmeeqqaarneq	Pituffik<Lokalis+IP-QQAAR+NIQ
Pituffimmeeqqaartorli	Pituffik<Lokalis+IP-QQAAR+TUQ+LI
Pituffimmeeqquaannga	Pituffik<Lokalis+IP-QQU<Indikativ<DeMig
Pituffimmeereerlutik	Pituffik<Lokalis+IP-RIIR<Ledsagemåde<de_selv
Pituffimmeereerlutilli	Pituffik<Lokalis+IP-RIIR<Ledsagemåde<de_selv+LI
Pituffimmeereertununa	Pituffik<Lokalis+IP-RIIR<Participium<de+UNA
Pituffimmeereertoq	Pituffik<Lokalis+IP-RIIR+TUQ
Pituffimmiunngoreertunga	Pituffik+MIU-NNGUR-RIIR<Participium<jeg
Pituffimmioqarpoq	Pituffik+MIU-QAR<Indikativ<han
Pituffimmioqarnerli	Pituffik+MIU-QAR+NIQ+LI
Pituffimmioqartorli	Pituffik+MIU-QAR<Participium<han+LI
Pituffimmioqartoq	Pituffik+MIU-QAR+TUQ
Pituffimmioorusuttoriittut	Pituffik+MIU-U+GUSUP+TUQ+GIIT<flertal<Aequalis
Pituffimmiooriarniniuna	Pituffik+MIU-U-RIAR+NIQ<ental<sin<Absolut+UNA
Pituffimmiooreertooqquiuk	Pituffik+MIU-U-RIIR+TUQ-U-QQU<Interrogativ<DuHam
Pituffimmut	Pituffik<Terminalis
Pituffimmukaleratta	Pituffik<Terminalis-KAR-LIR<Causativ<vi
Pituffimmukalerpunga	Pituffik<Terminalis-KAR-LIR<Indikativ<jeg
Pituffimmukalertunga	Pituffik<Terminalis-KAR-LIR<Participium<jeg
Pituffimmukaqqulara	Pituffik<Terminalis-KAR-QQU<Optativ<JegHam
Pituffimmukassallutik	Pituffik<Terminalis-KAR-SSA<Ledsagemåde<de_selv
Pituffimmulli	Pituffik<Terminalis+LI
Pituffimmullu	Pituffik<Terminalis+LU
Pituffimmununa	Pituffik<Terminalis+UNA
Pituffikkut	Pituffik<Vialis
Pituffikkulli	Pituffik<Vialis+LI
Pituffikkullu	Pituffik<Vialis+LU
Pituffikkununa	Pituffik<Vialis+UNA
pivallaarpiuk	pi+VALLAAR<Interrogativ<DuHam
pivallaarlugit	pi+VALLAAR<Ledsagemåde<dem
pivallaanngilakkalu	pi+VALLAAR=NNGIT<Indikativ<JegDem+LU
pivallaannginaguuna	pi+VALLAAR=NNGIT<Ledsagemåde<ham+UNA
pivimmangali	pi-VIP<Causativ<HanMig+LI
pivitsigillu	pi-VIP<Imperativ<ViDem+LU
qaammallu	qaammat<ental<Absolut+LU
qaammanuna	qaammat<ental<Absolut+UNA
qaammammik	qaammat<ental<Instrumentalis
qaammamminguna	qaammat<ental<Instrumentalis+UNA
qaammammi	qaammat<ental<Lokalis
qaammammeeqqutigilli	qaammat<ental<Lokalis+IP-QQU<Imperativ<ViDem+LI
qaammammukaleramali	qaammat<ental<Terminalis-KAR-LIR<Causativ<jeg+LI
qaammammukassaagulli	qaammat<ental<Terminalis-KAR-SSA<Indikativ<vi+LI
qaammatitaanngilagullu	qaammat+TAAR-NNGIT<Indikativ<vi+LU
qaangiummallu	qaangiup<Causativ<han+LU
qaangiutilaartarpugulli	qaangiup-LAAR=TAR<Indikativ<vi+LI
qaangiullutinguna	qaangiup<Ledsagemåde<de_selv+UNA
qaangiulluartunga	qaangiup+LUAR<Participium<jeg
qaangiunnianngilagulli	qaangiup+NIAR=NNGIT<Indikativ<vi+LI
qaangiuttaraluarniniuna	qaangiup+TAR=GALUAR+NIQ<ental<sin<Absolut+UNA
qaangiuppallaanngitsoqalaartartussalereqqaarpulli	qaangiup+VALLAAR=NNGIT+TUQ-QAR-LAAR=TAR+TUQ-SSAQ-LIRI-QQAAR<Indikativ<de+LI
qaangiuppallaanngitsoorusukkattalu	qaangiup+VALLAAR=NNGIT+TUQ-U+GUSUP<Causativ<vi+LU
qallunaaq	qallunaaq<ental<Absolut
qallunaaneereernerlu	qallunaaq<flertal<Lokalis+IP-RIIR+NIQ+LU
qallunaariittulli	qallunaaq+GIIT<flertal<Aequalis+LI
qallunaariinngunngitsorivippiuk	qallunaaq+GIIT-NNGUR-NNGIT+TUQ+GӘ-VIP<Interrogativ<DuHam
qallunaaralugilli	qallunaaq+GӘ<Ledsagemåde<dem+LI
qallunaariniarlugulu	qallunaaq+GӘ+NIAR<Ledsagemåde<ham+LU
qallunaannakka	qallunaaq-INNAQ<flertal<min<Absolut
qallunaakkut	qallunaaq-KKUT<flertal<Absolut
qallunaallit	qallunaaq-LIK<flertal<Relativ
qallunaanngoorusuttunnguinnarput	qallunaaq-NNGUAQ-U+GUSUP+TUQ-NNGUR-INNAR<Indikativ<de
qallunaanngulerpoq	qallunaaq-NNGUR-LIR<Indikativ<han
qallunaarpassuit	qallunaaq+PASSUAQ<flertal<Absolut
qallunaarpassuili	qallunaaq+PASSUAQ<flertal<hans<Absolut+LI
qallunaarpassuakka	qallunaaq+PASSUAQ<flertal<min<Absolut
qallunaassama	qallunaaq-SSAQ<ental<min>Relativ
qallunaartaaqqutigillu	qallunaaq+TAAR-QQU<Imperativ<ViDem+LU
qallunaajullutillu	qallunaaq-U<Ledsagemåde<de_selv+LU
qangali	qangali<Partikel
qangalili	qangali<Partikel+LI
qangalu	qanga<Partikel+LU
qangaana	qanga<Partikel+UNA
Qaqortoq	Qaqortoq<Absolut
Qaqortorli	Qaqortoq<Absolut+LI
Qaqortorlu	Qaqortoq<Absolut+LU
Qaqortoruna	Qaqortoq<Absolut+UNA
Qaqortumik	Qaqortoq<Instrumentalis
Qaqortumi	Qaqortoq<Lokalis
Qaqortumeeqqaarmalli	Qaqortoq<Lokalis+IP-QQAAR<Causativ<han+LI
Qaqortumeeqqaarpugullu	Qaqortoq<Lokalis+IP-QQAAR<Indikativ<vi+LU
Qaqortumeeqqutigilli	Qaqortoq<Lokalis+IP-QQU<Imperativ<ViDem+LI
Qaqortumeereerpit	Qaqortoq<Lokalis+IP-RIIR<Interrogativ<du
Qaqortumiissagaluartoqanngilarlu	Qaqortoq<Lokalis+IP-SSA=GALUAR+TUQ-QAR-NNGIT<Indikativ<han+LU
Qaqortumili	Qaqortoq<Lokalis+LI
Qaqortormiumi	Qaqortoq+MIU<ental<Lokalis
Qaqortormiuninguna	Qaqortoq+MIU<flertal<Instrumentalis+UNA
Qaqortormiulerivit	Qaqortoq+MIU-LIRI<Interrogativ<du
Qaqortormiunngoqquiuk	Qaqortoq+MIU-NNGUR-QQU<Interrogativ<DuHam
Qaqortormiunngussagaluarnermulli	Qaqortoq+MIU-NNGUR-SSA=GALUAR+NIQ<ental<Terminalis+LI
Qaqortormioorusuppoq	Qaqortoq+MIU-U+GUSUP<Indikativ<han
Qaqortormiooqqaarporli	Qaqortoq+MIU-U-QQAAR<Indikativ<han+LI
Qaqortormiooqqaartulereqqutiginuna	Qaqortoq+MIU-U-QQAAR+TUQ-LIRI-QQU<Imperativ<ViDem+UNA
Qaqortumut	Qaqortoq<Terminalis
Qaqortumukarama	Qaqortoq<Terminalis-KAR<Causativ<jeg
Qaqortumukalaartarneq	Qaqortoq<Terminalis-KAR-LAAR=TAR+NIQ
Qaqortumukanngimmalli	Qaqortoq<Terminalis-KAR-NNGIT<Causativ<han+LI
Qaqortumukaqqaartulli	Qaqortoq<Terminalis-KAR-QQAAR<Participium<de+LI
Qaqortumukaqquaanga	Qaqortoq<Terminalis-KAR-QQU<Indikativ<HanMig
Qaqortumukariartoq	Qaqortoq<Terminalis-KAR-RIAR+TUQ
Qaqortumukarsinnaavunga	Qaqortoq<Terminalis-KAR+SINNAA<Indikativ<jeg
Qaqortumukavinneq	Qaqortoq<Terminalis-KAR-VIP+NIQ
Qaqortumullu	Qaqortoq<Terminalis+LU
Qaqortumununa	Qaqortoq<Terminalis+UNA
Qaqortukkut	Qaqortoq<Vialis
Qaqortukkulli	Qaqortoq<Vialis+LI
Qaqortukkullu	Qaqortoq<Vialis+LU
Qaqortukkununa	Qaqortoq<Vialis+UNA
qarasaasiaq	qarasaasiaq<ental<Absolut
qarasaasiakka	qarasaasiaq<flertal<min<Absolut
qarasaasiama	qarasaasiaq<flertal<min>Relativ
qarasaasiariittullu	qarasaasiaq+GIIT<flertal<Aequalis+LU
qarasaasiarartorpiuk	qarasaasiaq+GӘ+GIARTUR<Interrogativ<DuHam
qarasaasiariunnaartigit	qarasaasiaq+GӘ+GUNNAAR<Imperativ<ViDem
qarasaasiarerusukkakku	qarasaasiaq+GӘ+GUSUP<Causativ<JegHam
qarasaasiareriarmangali	qarasaasiaq+GӘ-RIAR<Causativ<HanMig+LI
qarasaasiaannannguinnartungalu	qarasaasiaq-INNAQ-NNGUR-INNAR<Participium<jeg+LU
qarasaasiaannanngulerlutinguna	qarasaasiaq-INNAQ-NNGUR-LIR<Ledsagemåde<de_selv+UNA
qarasaasiaannarsiuinnarmata	qarasaasiaq-INNAQ+SIUR-INNAR<Causativ<de
qarasaasiakkut	qarasaasiaq-KKUT<flertal<Absolut
qarasaasiakkunni	qarasaasiaq-KKUT<flertal<Lokalis
qarasaasialererusukkatta	qarasaasiaq-LIRI+GUSUP<Causativ<vi
qarasaasiarmiuusimagattaana	qarasaasiaq+MIU-U+SIMA<Causativ<vi+UNA
qarasaasiarpassui	qarasaasiaq+PASSUAQ<flertal<hans<Absolut
qarasaasiaqaraluarnini	qarasaasiaq-QAR+GALUAR+NIQ<ental<sin<Absolut
qarasaasiarsiulaartarninilu	qarasaasiaq+SIUR-LAAR=TAR+NIQ<ental<sin<Absolut+LU
qarasaasiartaaqqaartooriartunngoriarnera	qarasaasiaq+TAAR-QQAAR+TUQ-U-RIAR+TUQ-NNGUR-RIAR+NIQ<ental<hans<Absolut
qarasaasiartaaqqummangaana	qarasaasiaq+TAAR-QQU<Causativ<HanMig+UNA
qarasaasiartaareerlutillu	qarasaasiaq+TAAR-RIIR<Ledsagemåde<de_selv+LU
qarasaasiaanertormiunngulaartungali	qarasaasiaq-U+NIR+TUQ+MIU-NNGUR-LAAR<Participium<jeg+LI
qarasaasiaasunga	qarasaasiaq-U<Participium<jeg
Qasigiannguit	Qasigiannguit<Absolut
Qasigiannguilli	Qasigiannguit<Absolut+LI
Qasigiannguillu	Qasigiannguit<Absolut+LU
Qasigiannguinuna	Qasigiannguit<Absolut+UNA
Qasigiannguanik	Qasigiannguit<Instrumentalis
Qasigiannguanilli	Qasigiannguit<Instrumentalis+LI
Qasigiannguanillu	Qasigiannguit<Instrumentalis+LU
Qasigiannguani	Qasigiannguit<Lokalis
Qasigiannguaniinniartut	Qasigiannguit<Lokalis+IP+NIAR<Participium<de
Qasigiannguaneeqqaarneq	Qasigiannguit<Lokalis+IP-QQAAR+NIQ
Qasigiannguaneeqqullugulu	Qasigiannguit<Lokalis+IP-QQU<Ledsagemåde<ham+LU
Qasigiannguaneeriarmata	Qasigiannguit<Lokalis+IP-RIAR<Causativ<de
Qasigiannguaneereermallu	Qasigiannguit<Lokalis+IP-RIIR<Causativ<han+LU
Qasigiannguaneereerpit	Qasigiannguit<Lokalis+IP-RIIR<Interrogativ<du
Qasigiannguaneereerlutillu	Qasigiannguit<Lokalis+IP-RIIR<Ledsagemåde<de_selv+LU
Qasigiannguaniuna	Qasigiannguit<Lokalis+UNA
Qasigiannguarmiunili	Qasigiannguit+MIU<flertal<Lokalis+LI
Qasigiannguarmiulereriarneq	Qasigiannguit+MIU-LIRI-RIAR+NIQ<ental<Absolut
Qasigiannguarmiunngulerpugununa	Qasigiannguit+MIU-NNGUR-LIR<Indikativ<vi+UNA
Qasigiannguarmiunngunngitsununa	Qasigiannguit+MIU-NNGUR-NNGIT<Participium<de+UNA
Qasigiannguarmiunngoriarama	Qasigiannguit+MIU-NNGUR-RIAR<Causativ<jeg
Qasigiannguarmiunngoriarnerni	Qasigiannguit+MIU-NNGUR-RIAR+NIQ<flertal<Lokalis
Qasigiannguarmioqarpoq	Qasigiannguit+MIU-QAR<Indikativ<han
Qasigiannguarmioqarnerli	Qasigiannguit+MIU-QAR+NIQ+LI
Qasigiannguarmioqartorli	Qasigiannguit+MIU-QAR<Participium<han+LI
Qasigiannguarmioqartorli	Qasigiannguit+MIU-QAR+TUQ+LI
Qasigiannguarmioorusuppulli	Qasigiannguit+MIU-U+GUSUP<Indikativ<de+LI
Qasigiannguarmiooqqaarnerit	Qasigiannguit+MIU-U-QQAAR+NIQ<flertal<Relativ
Qasigiannguarmiooqqutigit	Qasigiannguit+MIU-U-QQU<Imperativ<ViDem
Qasigiannguarmiuusooreertoqariarneq	Qasigiannguit+MIU-U+TUQ-U-RIIR+TUQ-QAR-RIAR+NIQ<ental<Absolut
Qasigiannguanut	Qasigiannguit<Terminalis
Qasigiannguanukaannartungali	Qasigiannguit<Terminalis-KAR-INNAR<Participium<jeg+LI
Qasigiannguanulli	Qasigiannguit<Terminalis+LI
Qasigiannguanununa	Qasigiannguit<Terminalis+UNA
qatanngulli	qatanngut<ental<Absolut+LI
qatanngullu	qatanngut<ental<Absolut+LU
qatanngununa	qatanngut<ental<Absolut+UNA
qatanngummik	qatanngut<ental<Instrumentalis
qatanngumminguna	qatanngut<ental<Instrumentalis+UNA
qatanngummukalaarpoq	qatanngut<ental<Terminalis-KAR-LAAR<Indikativ<han
qatanngutaannarsiorsimavit	qatanngut-INNAQ+SIUR+SIMA<Interrogativ<du
qatanngutilereqqutigillu	qatanngut-LIRI-QQU<Imperativ<ViDem+LU
qatannguteqalertoqassagaluartungali	qatanngut-QAR-LIR+TUQ-QAR-SSA=GALUAR<Participium<jeg+LI
qatanngutissaqaannartunga	qatanngut-SSAQ-QAR-INNAR<Participium<jeg
Qeqertarsuaq	Qeqertarsuaq<Absolut
Qeqertarsuarli	Qeqertarsuaq<Absolut+LI
Qeqertarsuarlu	Qeqertarsuaq<Absolut+LU
Qeqertarsuaruna	Qeqertarsuaq<Absolut+UNA
Qeqertarsuarmik	Qeqertarsuaq<Instrumentalis
Qeqertarsuarmillu	Qeqertarsuaq<Instrumentalis+LU
Qeqertarsuarminguna	Qeqertarsuaq<Instrumentalis+UNA
Qeqertarsuarmi	Qeqertarsuaq<Lokalis
Qeqertarsuarmeeqquiuk	Qeqertarsuaq<Lokalis+IP-QQU<Interrogativ<DuHam
Qeqertarsuarmeeqqulara	Qeqertarsuaq<Lokalis+IP-QQU<Optativ<JegHam
Qeqertarsuarmeereerama	Qeqertarsuaq<Lokalis+IP-RIIR<Causativ<jeg
Qeqertarsuarmeereerpit	Qeqertarsuaq<Lokalis+IP-RIIR<Interrogativ<du
Qeqertarsuarmeereerneq	Qeqertarsuaq<Lokalis+IP-RIIR+NIQ
Qeqertarsuarmeereernerlu	Qeqertarsuaq<Lokalis+IP-RIIR+NIQ+LU
Qeqertarsuarmili	Qeqertarsuaq<Lokalis+LI
Qeqertarsuarmilu	Qeqertarsuaq<Lokalis+LU
Qeqertarsuarmiumukalaartarlutik	Qeqertarsuaq+MIU<ental<Terminalis-KAR-LAAR=TAR<Ledsagemåde<de_selv
Qeqertarsuarmiunili	Qeqertarsuaq+MIU<flertal<Lokalis+LI
Qeqertarsuarmiulerimmat	Qeqertarsuaq+MIU-LIRI<Causativ<han
Qeqertarsuarmiulerereertukkui	Qeqertarsuaq+MIU-LIRI-RIIR+TUQ-KKUT<flertal<hans<Absolut
Qeqertarsuarmioqarpoq	Qeqertarsuaq+MIU-QAR<Indikativ<han
Qeqertarsuarmioqarneq	Qeqertarsuaq+MIU-QAR+NIQ
Qeqertarsuarmioqartoq	Qeqertarsuaq+MIU-QAR<Participium<han
Qeqertarsuarmiooreermatali	Qeqertarsuaq+MIU-U-RIIR<Causativ<de+LI
Qeqertarsuarmiooreertoq	Qeqertarsuaq+MIU-U-RIIR+TUQ<ental<Absolut
Qeqertarsuarmut	Qeqertarsuaq<Terminalis
Qeqertarsuarmukaraluarlutik	Qeqertarsuaq<Terminalis-KAR+GALUAR<Ledsagemåde<de_selv
Qeqertarsuarmukalaartoqanngilaq	Qeqertarsuaq<Terminalis-KAR-LAAR+TUQ-QAR-NNGIT<Indikativ<han
Qeqertarsuarmukalermatali	Qeqertarsuaq<Terminalis-KAR-LIR<Causativ<de+LI
Qeqertarsuarmukalertoruna	Qeqertarsuaq<Terminalis-KAR-LIR+TUQ+UNA
Qeqertarsuarmukaqqugakku	Qeqertarsuaq<Terminalis-KAR-QQU<Causativ<JegHam
Qeqertarsuarmukaqqullugu	Qeqertarsuaq<Terminalis-KAR-QQU<Ledsagemåde<ham
Qeqertarsuarmukariarlutinguna	Qeqertarsuaq<Terminalis-KAR-RIAR<Ledsagemåde<de_selv+UNA
Qeqertarsuarmukariartoqanngilaq	Qeqertarsuaq<Terminalis-KAR-RIAR+TUQ-QAR-NNGIT<Indikativ<han
Qeqertarsuarmukavikkatta	Qeqertarsuaq<Terminalis-KAR-VIP<Causativ<vi
Qeqertarsuarmulli	Qeqertarsuaq<Terminalis+LI
Qeqertarsuarmununa	Qeqertarsuaq<Terminalis+UNA
Qeqertarsuakkut	Qeqertarsuaq<Vialis
Qeqertarsuakkulli	Qeqertarsuaq<Vialis+LI
Qeqertarsuakkullu	Qeqertarsuaq<Vialis+LU
Qeqertarsuakkununa	Qeqertarsuaq<Vialis+UNA
qimammanga	qimap<Causativ<HanMig
qimammangali	qimap<Causativ<HanMig+LI
qimammangaana	qimap<Causativ<HanMig+UNA
qimakkakku	qimap<Causativ<JegHam
qimakkiartorlarali	qimap+GIARTUR<Optativ<JegHam+LI
qimakkunnaarpiuk	qimap+GUNNAAR<Interrogativ<DuHam
qimakkunnaarluguli	qimap+GUNNAAR<Ledsagemåde<ham+LI
qimatsigit	qimap<Imperativ<ViDem
qimatsigilli	qimap<Imperativ<ViDem+LI
qimatsigillu	qimap<Imperativ<ViDem+LU
qimappaat	qimap<Indikativ<DeHam
qimappiuk	qimap<Interrogativ<DuHam
qimalaarlugu	qimap-LAAR<Ledsagemåde<ham
qimalaartarluguli	qimap-LAAR=TAR<Ledsagemåde<ham+LI
qimalluguli	qimap<Ledsagemåde<ham+LI
qimalerpiuk	qimap-LIR<Interrogativ<DuHam
qimannerluginuna	qimap+NIR<Ledsagemåde<dem+UNA
qimanngilaalli	qimap-NNGIT<Indikativ<DeHam+LI
qimanngiliuk	qimap-NNGIT<Interrogativ<DuHam
qimannagu	qimap-NNGIT<Ledsagemåde<ham
qimallara	qimap<Optativ<JegHam
qimaqqullugu	qimap-QQU<Ledsagemåde<ham
qimariarlarali	qimap-RIAR<Optativ<JegHam+LI
qimareerlara	qimap-RIIR<Optativ<JegHam
qimassimammangalu	qimap+SIMA<Causativ<HanMig+LU
qimassimatigit	qimap+SIMA<Imperativ<ViDem
qimassimaviuk	qimap+SIMA<Interrogativ<DuHam
qimassimasarmangaana	qimap+SIMA=TAR<Causativ<HanMig+UNA
qimassimasarakku	qimap+SIMA=TAR<Causativ<JegHam
qimassimasarpara	qimap+SIMA=TAR<Indikativ<JegHam
qimassimasarpagullu	qimap+SIMA=TAR<Indikativ<ViDem+LU
qimassimasarlugillu	qimap+SIMA=TAR<Ledsagemåde<dem+LU
qimassinnaatiginuna	qimap+SINNAA<Imperativ<ViDem+UNA
qimassinnaalarali	qimap+SINNAA<Optativ<JegHam+LI
qimassagaluarpaanga	qimap-SSA=GALUAR<Indikativ<HanMig
qimattaraluarmanga	qimap+TAR=GALUAR<Causativ<HanMig
qimattaraluarpara	qimap+TAR=GALUAR<Indikativ<JegHam
qimattaraluarluginuna	qimap+TAR=GALUAR<Ledsagemåde<dem+UNA
qimattaraluarlugu	qimap+TAR=GALUAR<Ledsagemåde<ham
qimattartigit	qimap+TAR<Imperativ<ViDem
qimattartigillu	qimap+TAR<Imperativ<ViDem+LU
qimattarlugu	qimap+TAR<Ledsagemåde<ham
qimappallaarakku	qimap+VALLAAR<Causativ<JegHam
qimappallaanngilai	qimap+VALLAAR=NNGIT<Indikativ<HanDem
qimappallaanngilagununa	qimap+VALLAAR=NNGIT<Indikativ<ViDem+UNA
qimappallaannginagilli	qimap+VALLAAR=NNGIT<Ledsagemåde<dem+LI
qimappallaarlara	qimap+VALLAAR<Optativ<JegHam
qimavikkakkuuna	qimap-VIP<Causativ<JegHam+UNA
qimavitsigilli	qimap-VIP<Imperativ<ViDem+LI
qinnulli	qinnut<ental<Absolut+LI
qinnullu	qinnut<ental<Absolut+LU
qinnununa	qinnut<ental<Absolut+UNA
qinnummik	qinnut<ental<Instrumentalis
qinnummilli	qinnut<ental<Instrumentalis+LI
qinnummi	qinnut<ental<Lokalis
qinnummeeqqutigit	qinnut<ental<Lokalis+IP-QQU<Imperativ<ViDem
qinnummeeqqullugulu	qinnut<ental<Lokalis+IP-QQU<Ledsagemåde<ham+LU
qinnummeeqqulara	qinnut<ental<Lokalis+IP-QQU<Optativ<JegHam
qinnummeereerpit	qinnut<ental<Lokalis+IP-RIIR<Interrogativ<du
qinnummeereertununa	qinnut<ental<Lokalis+IP-RIIR<Participium<de+UNA
qinnummiuna	qinnut<ental<Lokalis+UNA
qinnummut	qinnut<ental<Terminalis
qinnummukalaarlutik	qinnut<ental<Terminalis-KAR-LAAR<Ledsagemåde<de_selv
qinnummukalaartarneq	qinnut<ental<Terminalis-KAR-LAAR=TAR+NIQ
qinnummulli	qinnut<ental<Terminalis+LI
qinnummullu	qinnut<ental<Terminalis+LU
qinnummununa	qinnut<ental<Terminalis+UNA
qinnutaajuna	qinnut<flertal<hans<Absolut+UNA
qinnutikka	qinnut<flertal<min<Absolut
qinnutigiittullu	qinnut+GIIT<flertal<Aequalis+LU
qinnutigiilererusuttunga	qinnut+GIIT-LIRI+GUSUP<Participium<jeg
qinnutigiilerinikuusorlu	qinnut+GIIT-LIRI+NIKUU<Participium<han+LU
qinnutigiilerisinnaasoorusunninili	qinnut+GIIT-LIRI+SINNAA+TUQ-U+GUSUP+NIQ<ental<sin<Absolut+LI
qinnutigilluartiginuna	qinnut+GӘ+LUAR<Imperativ<ViDem+UNA
qinnutaannaa	qinnut-INNAQ<flertal<hans<Absolut
qinnutilittullu	qinnut-LIK<ental<Aequalis+LU
qinnutililerisinnaallutik	qinnut-LIK-LIRI+SINNAA<Ledsagemåde<de_selv
qinnutilissioreerpulli	qinnut-LIK+SIUR-RIIR<Indikativ<de+LI
qinnutilerigaluartunga	qinnut-LIRI+GALUAR<Participium<jeg
qinnutilerisarnerillu	qinnut-LIRI+TAR+NIQ<flertal<Relativ+LU
qinnutinngoorusummanuna	qinnut-NNGUAQ-U+GUSUP<Causativ<han+UNA
qinnuteqaqqaarnera	qinnut-QAR-QQAAR+NIQ<ental<hans<Absolut
qinnuteqassallutinguna	qinnut-QAR-SSA<Ledsagemåde<de_selv+UNA
qinnutisiunnginninili	qinnut+SIUR-NNGIT+NIQ<ental<sin<Absolut+LI
qinnutitaarlutik	qinnut+TAAR<Ledsagemåde<de_selv
qinnutitaassagaluartungalu	qinnut+TAAR-SSA=GALUAR<Participium<jeg+LU
qinnutaavallaanngitsoriilerilerlutinguna	qinnut-U+VALLAAR=NNGIT+TUQ+GIIT-LIRI-LIR<Ledsagemåde<de_selv+UNA
sammisarigaluarpaanga	sammisarә+GALUAR<Indikativ<HanMig
sammisarartormanga	sammisarә+GIARTUR<Causativ<HanMig
sammisariunnaartigilli	sammisarә+GUNNAAR<Imperativ<ViDem+LI
sammisariunnaarlugu	sammisarә+GUNNAAR<Ledsagemåde<ham
sammisariinnartiginuna	sammisarә-INNAR<Imperativ<ViDem+UNA
sammisarilaartarmanga	sammisarә-LAAR=TAR<Causativ<HanMig
sammisarilaartartigillu	sammisarә-LAAR=TAR<Imperativ<ViDem+LU
sammisaralugit	sammisarә<Ledsagemåde<dem
sammisaralugilli	sammisarә<Ledsagemåde<dem+LI
sammisarilluarlugulu	sammisarә+LUAR<Ledsagemåde<ham+LU
sammisariniarlaralu	sammisarә+NIAR<Optativ<JegHam+LU
sammisarinikuutiginuna	sammisarә+NIKUU<Imperativ<ViDem+UNA
sammisarinikuulara	sammisarә+NIKUU<Optativ<JegHam
sammisarineqarmat	sammisarә+NIQAR<Causativ<han
sammisarineqarpunga	sammisarә+NIQAR<Indikativ<jeg
sammisarineqarpungali	sammisarә+NIQAR<Indikativ<jeg+LI
sammisarinerlara	sammisarә+NIR<Optativ<JegHam
sammisarinerullugu	sammisarә+NIRU<Ledsagemåde<ham
sammisarinerulara	sammisarә+NIRU<Optativ<JegHam
sammisarinngilat	sammisarә-NNGIT<Indikativ<DuHam
sammisarilarali	sammisarә<Optativ<JegHam+LI
sammisarilaraana	sammisarә<Optativ<JegHam+UNA
sammisareqqaarlara	sammisarә-QQAAR<Optativ<JegHam
sammisareqqullugu	sammisarә-QQU<Ledsagemåde<ham
sammisareriarmanga	sammisarә-RIAR<Causativ<HanMig
sammisareriarpaa	sammisarә-RIAR<Indikativ<HanHam
sammisarereertiginuna	sammisarә-RIIR<Imperativ<ViDem+UNA
sammisarereerpaannga	sammisarә-RIIR<Indikativ<DeMig
sammisarereerlaraana	sammisarә-RIIR<Optativ<JegHam+UNA
sammisarisimasartiginuna	sammisarә+SIMA=TAR<Imperativ<ViDem+UNA
sammisarissagaluarakku	sammisarә-SSA=GALUAR<Causativ<JegHam
sammisarissagaluartigit	sammisarә-SSA=GALUAR<Imperativ<ViDem
sammisarissagaluartigilli	sammisarә-SSA=GALUAR<Imperativ<ViDem+LI
sammisarissavaalu	sammisarә-SSA<Indikativ<HanDem+LU
sammisarissavaanga	sammisarә-SSA<Indikativ<HanMig
sammisarissavaangali	sammisarә-SSA<Indikativ<HanMig+LI
sammisarisarlugu	sammisarә+TAR<Ledsagemåde<ham
sammisarivallaarmanga	sammisarә+VALLAAR<Causativ<HanMig
sammisarivallaarlugu	sammisarә+VALLAAR<Ledsagemåde<ham
sammisarivallaanngilara	sammisarә+VALLAAR=NNGIT<Indikativ<JegHam
sammisarivimmanga	sammisarә-VIP<Causativ<HanMig
sammisarivitsigillu	sammisarә-VIP<Imperativ<ViDem+LU
sinneraluarlara	sinner+GALUAR<Optativ<JegHam
sinnerpakkaana	sinner<Indikativ<JegDem+UNA
sinnerlugilli	sinner<Ledsagemåde<dem+LI
sinnilerpiuk	sinner-LIR<Interrogativ<DuHam
sinnerluarakku	sinner+LUAR<Causativ<JegHam
sinninnginnakkuuna	sinner-NNGIT<Causativ<JegHam+UNA
sinnereertigit	sinner-RIIR<Imperativ<ViDem
sinnereerlarali	sinner-RIIR<Optativ<JegHam+LI
sisamaannakkaana	sisamat-INNAQ<flertal<min<Absolut+UNA
sisamaannanngoqquiuk	sisamat-INNAQ-NNGUR-QQU<Interrogativ<DuHam
sisamaannartaassallutilli	sisamat-INNAQ+TAAR-SSA<Ledsagemåde<de_selv+LI
sisamassanik	sisamat-SSAQ<flertal<Instrumentalis
sisamassaqaqqaarmatalu	sisamat-SSAQ-QAR-QQAAR<Causativ<de+LU
sisamassartaanngitsoq	sisamat-SSAQ+TAAR-NNGIT<Participium<han
sisamassaainnarninilu	sisamat-SSAQ-U-INNAR+NIQ<ental<sin<Absolut+LU
sisamassaanertunngooqqummanga	sisamat-SSAQ-U+NIR+TUQ-NNGUAQ-U-QQU<Causativ<HanMig
sisamatut	sisamat<Talord<Aequalis
sisamatullu	sisamat<Talord<Aequalis+LU
sisamatununa	sisamat<Talord<Aequalis+UNA
sisamaanuna	sisamat<Talord<ental<deres+UNA
sisamanununa	sisamat<Talord<flertal<Terminalis+UNA
Sisimiut	Sisimiut<Absolut
Sisimiulli	Sisimiut<Absolut+LI
Sisimiullu	Sisimiut<Absolut+LU
Sisimiununa	Sisimiut<Absolut+UNA
Sisimiunik	Sisimiut<Instrumentalis
Sisimiunilli	Sisimiut<Instrumentalis+LI
Sisimiunillu	Sisimiut<Instrumentalis+LU
Sisimiuninguna	Sisimiut<Instrumentalis+UNA
Sisimiuni	Sisimiut<Lokalis
Sisimiuniimmatali	Sisimiut<Lokalis+IP<Causativ<de+LI
Sisimiuniilaarpununa	Sisimiut<Lokalis+IP-LAAR<Indikativ<de+UNA
Sisimiuneeqqaarpit	Sisimiut<Lokalis+IP-QQAAR<Interrogativ<du
Sisimiuneeqquakkalu	Sisimiut<Lokalis+IP-QQU<Indikativ<JegDem+LU
Sisimiuneereerlutinguna	Sisimiut<Lokalis+IP-RIIR<Ledsagemåde<de_selv+UNA
Sisimiormiuuna	Sisimiut+MIU<ental<Absolut+UNA
Sisimiormiumilli	Sisimiut+MIU<ental<Instrumentalis+LI
Sisimiormiumi	Sisimiut+MIU<ental<Lokalis
Sisimiormiumulli	Sisimiut+MIU<ental<Terminalis+LI
Sisimiormiuneeqquaa	Sisimiut+MIU<flertal<Lokalis+IP-QQU<Indikativ<HanHam
Sisimiormiuneeqquiuk	Sisimiut+MIU<flertal<Lokalis+IP-QQU<Interrogativ<DuHam
Sisimiormiuneeqqulara	Sisimiut+MIU<flertal<Lokalis+IP-QQU<Optativ<JegHam
Sisimiormiuneereerneq	Sisimiut+MIU<flertal<Lokalis+IP-RIIR+NIQ
Sisimiormiulerivikkama	Sisimiut+MIU-LIRI-VIP<Causativ<jeg
Sisimiormiunnguinnaramaana	Sisimiut+MIU-NNGUR-INNAR<Causativ<jeg+UNA
Sisimiormiunngorlutik	Sisimiut+MIU-NNGUR<Ledsagemåde<de_selv
Sisimiormiunngulertulilli	Sisimiut+MIU-NNGUR-LIR+TUQ-LIK<ental<Absolut+LI
Sisimiormiunngoriarmata	Sisimiut+MIU-NNGUR-RIAR<Causativ<de
Sisimiormiunngoriartunga	Sisimiut+MIU-NNGUR-RIAR<Participium<jeg
Sisimiormiunngoreertoqalaartartulerinini	Sisimiut+MIU-NNGUR-RIIR+TUQ-QAR-LAAR=TAR+TUQ-LIRI+NIQ<ental<sin<Absolut
Sisimiormiunngoreertoqassammalli	Sisimiut+MIU-NNGUR-RIIR+TUQ-QAR-SSA<Causativ<han+LI
Sisimiormioqarpoq	Sisimiut+MIU-QAR<Indikativ<han
Sisimiormioqarneq	Sisimiut+MIU-QAR+NIQ
Sisimiormioqarnerli	Sisimiut+MIU-QAR+NIQ+LI
Sisimiormioqarnerlu	Sisimiut+MIU-QAR+NIQ+LU
Sisimiormioqarneruna	Sisimiut+MIU-QAR+NIQ+UNA
Sisimiormioqartoq	Sisimiut+MIU-QAR<Participium<han
Sisimiormioqartoruna	Sisimiut+MIU-QAR<Participium<han+UNA
Sisimiormioqartorli	Sisimiut+MIU-QAR+TUQ+LI
Sisimiormioqartorlu	Sisimiut+MIU-QAR+TUQ+LU
Sisimiormiuummat	Sisimiut+MIU-U<Causativ<han
Sisimiormiuugaluarlutillu	Sisimiut+MIU-U+GALUAR<Ledsagemåde<de_selv+LU
Sisimiormiuuppununa	Sisimiut+MIU-U<Indikativ<de+UNA
Sisimiormiuuit	Sisimiut+MIU-U<Interrogativ<du
Sisimiormiuulaartooqqulluginuna	Sisimiut+MIU-U-LAAR+TUQ-U-QQU<Ledsagemåde<dem+UNA
Sisimiormiuuneratta	Sisimiut+MIU-U+NIR<Causativ<vi
Sisimiormiuuneruvugut	Sisimiut+MIU-U+NIRU<Indikativ<vi
Sisimiormiooqqaarlutik	Sisimiut+MIU-U-QQAAR<Ledsagemåde<de_selv
Sisimiormiooqqutigillu	Sisimiut+MIU-U-QQU<Imperativ<ViDem+LU
Sisimiormiooqquakka	Sisimiut+MIU-U-QQU<Indikativ<JegDem
Sisimiormiooqqularali	Sisimiut+MIU-U-QQU<Optativ<JegHam+LI
Sisimiormiooriarlutillu	Sisimiut+MIU-U-RIAR<Ledsagemåde<de_selv+LU
Sisimiormiooreerpit	Sisimiut+MIU-U-RIIR<Interrogativ<du
Sisimiormiooreerlutik	Sisimiut+MIU-U-RIIR<Ledsagemåde<de_selv
Sisimiormiuusimavoruna	Sisimiut+MIU-U+SIMA<Indikativ<han+UNA
Sisimiormiuusimavungali	Sisimiut+MIU-U+SIMA<Indikativ<jeg+LI
Sisimiormiuussavit	Sisimiut+MIU-U-SSA<Interrogativ<du
Sisimiunukalaartartorlu	Sisimiut<Terminalis-KAR-LAAR=TAR<Participium<han+LU
Sisimiunukanngilatit	Sisimiut<Terminalis-KAR-NNGIT<Interrogativ<du
Sisimiunukaqqaartoqanngilarlu	Sisimiut<Terminalis-KAR-QQAAR+TUQ-QAR-NNGIT<Indikativ<han+LU
Sisimiunukariarpunga	Sisimiut<Terminalis-KAR-RIAR<Indikativ<jeg
Sisimiunukassagaluarpit	Sisimiut<Terminalis-KAR-SSA=GALUAR<Interrogativ<du
Sisimiunukavittoq	Sisimiut<Terminalis-KAR-VIP<Participium<han
Sisimiunukavittunga	Sisimiut<Terminalis-KAR-VIP<Participium<jeg
Sisimiunulli	Sisimiut<Terminalis+LI
Sisimiunununa	Sisimiut<Terminalis+UNA
siullikka	siulleq<flertal<min<Absolut
siullerartorlarali	siulleq+GӘ+GIARTUR<Optativ<JegHam+LI
siulliinnaq	siulleq-INNAQ<ental<Absolut
siulliinnartaassagaluarniniuna	siulleq-INNAQ+TAAR-SSA=GALUAR+NIQ<ental<sin<Absolut+UNA
sivikimmanuna	sivikip<Causativ<han+UNA
sivikinnermanuna	sivikip+NIR<Causativ<han+UNA
sivikeqqaarpit	sivikip-QQAAR<Interrogativ<du
sivikeqqaartungaana	sivikip-QQAAR<Participium<jeg+UNA
sivikeqquiuk	sivikip-QQU<Interrogativ<DuHam
sivikeqqullugit	sivikip-QQU<Ledsagemåde<dem
sivikeqqulara	sivikip-QQU<Optativ<JegHam
sivikeriarpit	sivikip-RIAR<Interrogativ<du
sivikeriartunga	sivikip-RIAR<Participium<jeg
sooq	sooq<Partikel
soorli	sooq<Partikel+LI
soorlu	sooq<Partikel+LU
sooruna	sooq<Partikel+UNA
soorunami	soorunami<Partikel
soorunamili	soorunami<Partikel+LI
soqutiginalaartarpugullu	soqutiginar-LAAR=TAR<Indikativ<vi+LU
soqutiginarnikuunermukalaartartoqarpoq	soqutiginar+NIKUU+NIQ<ental<Terminalis-KAR-LAAR=TAR+TUQ-QAR<Indikativ<han
soqutiginaqqaarpit	soqutiginar-QQAAR<Interrogativ<du
soqutiginaqqaartoq	soqutiginar-QQAAR+TUQ<ental<Absolut
soqutiginarsimasarattali	soqutiginar+SIMA=TAR<Causativ<vi+LI
soqutiginarpallaannginatilli	soqutiginar+VALLAAR=NNGIT<Ledsagemåde<de_selv+LI
soqutiginarpallaannginnini	soqutiginar+VALLAAR=NNGIT+NIQ<ental<sin<Absolut
soqutigiunnaarakku	soqutigә+GUNNAAR<Causativ<JegHam
soqutigivassi	soqutigә<Indikativ<JegJer
soqutigiviuk	soqutigә<Interrogativ<DuHam
soqutiginikuuara	soqutigә+NIKUU<Indikativ<JegHam
soqutiginngimmanga	soqutigә-NNGIT<Causativ<HanMig
soqutiginnginnakku	soqutigә-NNGIT<Causativ<JegHam
soqutigilara	soqutigә<Optativ<JegHam
soqutigeqqaartigit	soqutigә-QQAAR<Imperativ<ViDem
soqutigereertigit	soqutigә-RIIR<Imperativ<ViDem
summatalu	su<Causativ<de+LU
sujartorpit	su+GIARTUR<Interrogativ<du
sujartortunga	su+GIARTUR<Participium<jeg
sujartortulerivimmatalu	su+GIARTUR+TUQ-LIRI-VIP<Causativ<de+LU
sujunnaartunga	su+GUNNAAR<Participium<jeg
sorusummatalu	su+GUSUP<Causativ<de+LU
sorusummat	su+GUSUP<Causativ<han
sorusummalli	su+GUSUP<Causativ<han+LI
sorusummallu	su+GUSUP<Causativ<han+LU
sorusukkattali	su+GUSUP<Causativ<vi+LI
sorusuppugununa	su+GUSUP<Indikativ<vi+UNA
sorusullutik	su+GUSUP<Ledsagemåde<de_selv
sorusullutillu	su+GUSUP<Ledsagemåde<de_selv+LU
sorusunnernillu	su+GUSUP+NIQ<flertal<Instrumentalis+LU
suvugut	su<Indikativ<vi
suinnarmalli	su-INNAR<Causativ<han+LI
suinnarpugununa	su-INNAR<Indikativ<vi+UNA
suinnarlutinguna	su-INNAR<Ledsagemåde<de_selv+UNA
sulaartarlutik	su-LAAR=TAR<Ledsagemåde<de_selv
sullutik	su<Ledsagemåde<de_selv
sullutilli	su<Ledsagemåde<de_selv+LI
SULI	SULI<Partikel
SULIli	SULI<Partikel+LI
SULIlu	SULI<Partikel+LU
SULIuna	SULI<Partikel+UNA
sulerpulli	su-LIR<Indikativ<de+LI
sulerporuna	su-LIR<Indikativ<han+UNA
sulluarpit	su+LUAR<Interrogativ<du
sulluartunga	su+LUAR<Participium<jeg
suna	suna<Pronomen<Absolut<ental
sungiukkakku	sungiup<Causativ<JegHam
suniarneq	su+NIAR+NIQ<ental<Absolut
sunermallu	su+NIR<Causativ<han+LU
sunngillalli	su-NNGIT<Indikativ<de+LI
soqqaarmata	su-QQAAR<Causativ<de
soqqaarmat	su-QQAAR<Causativ<han
soqqaarpunga	su-QQAAR<Indikativ<jeg
soqqaartunga	su-QQAAR<Participium<jeg
soqqugakku	su-QQU<Causativ<JegHam
soqqugakkuli	su-QQU<Causativ<JegHam+LI
soqqutiginuna	su-QQU<Imperativ<ViDem+UNA
soqquiuk	su-QQU<Interrogativ<DuHam
soqqullugilli	su-QQU<Ledsagemåde<dem+LI
soqqullugu	su-QQU<Ledsagemåde<ham
soqqulluguli	su-QQU<Ledsagemåde<ham+LI
soqqularalu	su-QQU<Optativ<JegHam+LU
soriarput	su-RIAR<Indikativ<de
soriarpoq	su-RIAR<Indikativ<han
soriarpit	su-RIAR<Interrogativ<du
soriarlutik	su-RIAR<Ledsagemåde<de_selv
soriarlutilli	su-RIAR<Ledsagemåde<de_selv+LI
soriartungali	su-RIAR<Participium<jeg+LI
soreerlutilli	su-RIIR<Ledsagemåde<de_selv+LI
soreerneranuna	su-RIIR+NIQ<ental<deres+UNA
soreernini	su-RIIR+NIQ<ental<sin<Absolut
soreernerilli	su-RIIR+NIQ<flertal<Relativ+LI
soreertorisarakku	su-RIIR+TUQ+GӘ+TAR<Causativ<JegHam
susimasorlu	su+SIMA<Participium<han+LU
susimasartungaana	su+SIMA=TAR<Participium<jeg+UNA
sussagaluartoqalermallu	su-SSA=GALUAR+TUQ-QAR-LIR<Causativ<han+LU
susaraluarpit	su+TAR=GALUAR<Interrogativ<du
susaraluartooriarnini	su+TAR=GALUAR+TUQ-U-RIAR+NIQ<ental<sin<Absolut
susaraluartooreerlutillu	su+TAR=GALUAR+TUQ-U-RIIR<Ledsagemåde<de_selv+LU
susartungaana	su+TAR<Participium<jeg+UNA
suallaannginnini	su+VALLAAR=NNGIT+NIQ<ental<sin<Absolut
suallaannginnerinuna	su+VALLAAR=NNGIT+NIQ<flertal<Absolut+UNA
suittuulaartaratta	su-VIP+TUQ-U-LAAR=TAR<Causativ<vi
taajunnaarakkuli	taa+GUNNAAR<Causativ<JegHam+LI
taaguummili	taaguut<ental<Lokalis+LI
taallugit	taa<Ledsagemåde<dem
taallugu	taa<Ledsagemåde<ham
taalermanga	taa-LIR<Causativ<HanMig
taalluarpaangali	taa+LUAR<Indikativ<HanMig+LI
taaniarnaginuna	taa+NIAR=NNGIT<Ledsagemåde<dem+UNA
taaniarnaguli	taa+NIAR=NNGIT<Ledsagemåde<ham+LI
taaneqartukkununa	taa+NIQAR+TUQ<ental<Vialis+UNA
taanerutiginuna	taa+NIRU<Imperativ<ViDem+UNA
taannali	taanna<Pronomen<Absolut<ental+LI
taassavara	taa-SSA<Indikativ<JegHam
taassalaraana	taa-SSA<Optativ<JegHam+UNA
taasarlara	taa+TAR<Optativ<JegHam
taava	taava<Partikel
takorusukkakku	taku+GUSUP<Causativ<JegHam
takorusutsigilli	taku+GUSUP<Imperativ<ViDem+LI
takorusutsiginuna	taku+GUSUP<Imperativ<ViDem+UNA
takulaarpiuk	taku-LAAR<Interrogativ<DuHam
takulluarpiuk	taku+LUAR<Interrogativ<DuHam
takunerpaanuna	taku+NIR<Indikativ<DeHam+UNA
takunngiliuk	taku-NNGIT<Interrogativ<DuHam
takoqqaarlara	taku-QQAAR<Optativ<JegHam
takoriarluginuna	taku-RIAR<Ledsagemåde<dem+UNA
takoriarlara	taku-RIAR<Optativ<JegHam
takoreertigit	taku-RIIR<Imperativ<ViDem
takoreertiginuna	taku-RIIR<Imperativ<ViDem+UNA
takussammanga	taku-SSA<Causativ<HanMig
takusaraluartigillu	taku+TAR=GALUAR<Imperativ<ViDem+LU
takuillugilli	taku-VIP<Ledsagemåde<dem+LI
tallimaannaanuna	tallimat-INNAQ<flertal<Absolut+UNA
tallimaannalerivallaarmanuna	tallimat-INNAQ-LIRI+VALLAAR<Causativ<han+UNA
tallimaannartaaqqaarpit	tallimat-INNAQ+TAAR-QQAAR<Interrogativ<du
tallimassani	tallimat-SSAQ<flertal<Lokalis
tallimassalereqqulara	tallimat-SSAQ-LIRI-QQU<Optativ<JegHam
tallimassalerivikkamali	tallimat-SSAQ-LIRI-VIP<Causativ<jeg+LI
tallimassanngoraluarlutik	tallimat-SSAQ-NNGUR+GALUAR<Ledsagemåde<de_selv
tallimassaqaqqaartungali	tallimat-SSAQ-QAR-QQAAR<Participium<jeg+LI
tallimassarsiulernera	tallimat-SSAQ+SIUR-LIR+NIQ<ental<min<Absolut
tallimassartaaqqutigit	tallimat-SSAQ+TAAR-QQU<Imperativ<ViDem
tallimassaassagaluartoqalaartunga	tallimat-SSAQ-U-SSA=GALUAR+TUQ-QAR-LAAR<Participium<jeg
tallimatununa	tallimat<Talord<Aequalis+UNA
tallimallu	tallimat<Talord<flertal<Absolut+LU
tallimanukareeratta	tallimat<Talord<flertal<Terminalis-KAR-RIIR<Causativ<vi
tallimanik	tallimat<Talord<Instrumentalis
tallimanilli	tallimat<Talord<Instrumentalis+LI
tallimani	tallimat<Talord<Lokalis
tamanna	tamanna<Pronomen<Absolut<ental
tamannali	tamanna<Pronomen<Absolut<ental+LI
tamannalu	tamanna<Pronomen<Absolut<ental+LU
tamarmilli	tamarmik<Adjektiv+LI
tamarmillu	tamarmik<Adjektiv+LU
tamarminguna	tamarmik<Adjektiv+UNA
tamatta	tamatta<Adjektiv
tamattali	tamatta<Adjektiv+LI
tamattaana	tamatta<Adjektiv+UNA
Tasiilaq	Tasiilaq<Absolut
Tasiilarli	Tasiilaq<Absolut+LI
Tasiilarlu	Tasiilaq<Absolut+LU
Tasiilaruna	Tasiilaq<Absolut+UNA
Tasiilamik	Tasiilaq<Instrumentalis
Tasiilamilli	Tasiilaq<Instrumentalis+LI
Tasiilamillu	Tasiilaq<Instrumentalis+LU
Tasiilaminguna	Tasiilaq<Instrumentalis+UNA
Tasiilami	Tasiilaq<Lokalis
Tasiilamiikkaluarlutillu	Tasiilaq<Lokalis+IP+GALUAR<Ledsagemåde<de_selv+LU
Tasiilameeqqaarlutinguna	Tasiilaq<Lokalis+IP-QQAAR<Ledsagemåde<de_selv+UNA
Tasiilameeqqaartoqarporli	Tasiilaq<Lokalis+IP-QQAAR+TUQ-QAR<Indikativ<han+LI
Tasiilameeqquara	Tasiilaq<Lokalis+IP-QQU<Indikativ<JegHam
Tasiilameeqqulara	Tasiilaq<Lokalis+IP-QQU<Optativ<JegHam
Tasiilameeriarpit	Tasiilaq<Lokalis+IP-RIAR<Interrogativ<du
Tasiilameeriartoqarpoq	Tasiilaq<Lokalis+IP-RIAR+TUQ-QAR<Indikativ<han
Tasiilameereerpullu	Tasiilaq<Lokalis+IP-RIIR<Indikativ<de+LU
Tasiilameereertoqanngilaq	Tasiilaq<Lokalis+IP-RIIR+TUQ-QAR-NNGIT<Indikativ<han
Tasiilamili	Tasiilaq<Lokalis+LI
Tasiilarmiumiillutilli	Tasiilaq+MIU<ental<Lokalis+IP<Ledsagemåde<de_selv+LI
Tasiilarmiumeeqqaartunga	Tasiilaq+MIU<ental<Lokalis+IP-QQAAR<Participium<jeg
Tasiilarmiulereqqulara	Tasiilaq+MIU-LIRI-QQU<Optativ<JegHam
Tasiilarmiulerisooriarlutillu	Tasiilaq+MIU-LIRI+TUQ-U-RIAR<Ledsagemåde<de_selv+LU
Tasiilarmiunngulaaramalu	Tasiilaq+MIU-NNGUR-LAAR<Causativ<jeg+LU
Tasiilarmiunngulermat	Tasiilaq+MIU-NNGUR-LIR<Causativ<han
Tasiilarmiunngussagaluarmallu	Tasiilaq+MIU-NNGUR-SSA=GALUAR<Causativ<han+LU
Tasiilarmioqarporlu	Tasiilaq+MIU-QAR<Indikativ<han+LU
Tasiilarmioqarneq	Tasiilaq+MIU-QAR+NIQ
Tasiilarmioqartoq	Tasiilaq+MIU-QAR<Participium<han
Tasiilarmioqartorli	Tasiilaq+MIU-QAR<Participium<han+LI
Tasiilarmioqartorlu	Tasiilaq+MIU-QAR<Participium<han+LU
Tasiilarmioqartorlu	Tasiilaq+MIU-QAR+TUQ+LU
Tasiilarmiuulerpugununa	Tasiilaq+MIU-U-LIR<Indikativ<vi+UNA
Tasiilarmiuunikuullutik	Tasiilaq+MIU-U+NIKUU<Ledsagemåde<de_selv
Tasiilarmiuunerit	Tasiilaq+MIU-U+NIQ<flertal<Absolut
Tasiilarmiuunngilaq	Tasiilaq+MIU-U-NNGIT<Indikativ<han
Tasiilarmiooqqaartunga	Tasiilaq+MIU-U-QQAAR<Participium<jeg
Tasiilarmiooriarpit	Tasiilaq+MIU-U-RIAR<Interrogativ<du
Tasiilarmiuusimasaramali	Tasiilaq+MIU-U+SIMA=TAR<Causativ<jeg+LI
Tasiilamut	Tasiilaq<Terminalis
Tasiilamukalaarneq	Tasiilaq<Terminalis-KAR-LAAR+NIQ
Tasiilamukalerama	Tasiilaq<Terminalis-KAR-LIR<Causativ<jeg
Tasiilamukaqqaarmat	Tasiilaq<Terminalis-KAR-QQAAR<Causativ<han
Tasiilamukaqquakkaana	Tasiilaq<Terminalis-KAR-QQU<Indikativ<JegDem+UNA
Tasiilamukaqquiuk	Tasiilaq<Terminalis-KAR-QQU<Interrogativ<DuHam
Tasiilamukariartunga	Tasiilaq<Terminalis-KAR-RIAR<Participium<jeg
Tasiilamukariartoqarporuna	Tasiilaq<Terminalis-KAR-RIAR+TUQ-QAR<Indikativ<han+UNA
Tasiilamullu	Tasiilaq<Terminalis+LU
Tasiilamununa	Tasiilaq<Terminalis+UNA
Tasiilakkut	Tasiilaq<Vialis
Tasiilakkulli	Tasiilaq<Vialis+LI
Tasiilakkununa	Tasiilaq<Vialis+UNA
tassa	tassa<Partikel
tassali	tassa<Partikel+LI
tassalu	tassa<Partikel+LU
tikimmanga	tikip<Causativ<HanMig
tikikkakku	tikip<Causativ<JegHam
tikikkaluarlaraana	tikip+GALUAR<Optativ<JegHam+UNA
tikikkiartortigillu	tikip+GIARTUR<Imperativ<ViDem+LU
tikitsigit	tikip<Imperativ<ViDem
tikitsigilli	tikip<Imperativ<ViDem+LI
tikitsiginuna	tikip<Imperativ<ViDem+UNA
tikilaarparaana	tikip-LAAR<Indikativ<JegHam+UNA
tikillugit	tikip<Ledsagemåde<dem
tikillugu	tikip<Ledsagemåde<ham
tikilluguli	tikip<Ledsagemåde<ham+LI
tikinniarnagilli	tikip+NIAR=NNGIT<Ledsagemåde<dem+LI
tikinnikuulluguuna	tikip+NIKUU<Ledsagemåde<ham+UNA
tikinnikuularaana	tikip+NIKUU<Optativ<JegHam+UNA
tikinnerummanga	tikip+NIRU<Causativ<HanMig
tikinneruagulli	tikip+NIRU<Indikativ<ViDem+LI
tikinnaginuna	tikip-NNGIT<Ledsagemåde<dem+UNA
tikillara	tikip<Optativ<JegHam
tikeqqaarmanga	tikip-QQAAR<Causativ<HanMig
tikeqqaarakku	tikip-QQAAR<Causativ<JegHam
tikeqqaarakkuuna	tikip-QQAAR<Causativ<JegHam+UNA
tikeqqaartigit	tikip-QQAAR<Imperativ<ViDem
tikeqqaartigilli	tikip-QQAAR<Imperativ<ViDem+LI
tikeqqaartiginuna	tikip-QQAAR<Imperativ<ViDem+UNA
tikeqqaarpiuk	tikip-QQAAR<Interrogativ<DuHam
tikeqqaarlugilli	tikip-QQAAR<Ledsagemåde<dem+LI
tikeqqaarlara	tikip-QQAAR<Optativ<JegHam
tikeqqummanga	tikip-QQU<Causativ<HanMig
tikeqquaanngali	tikip-QQU<Indikativ<DeMig+LI
tikeqquiuk	tikip-QQU<Interrogativ<DuHam
tikeqqullugilli	tikip-QQU<Ledsagemåde<dem+LI
tikeqqullugu	tikip-QQU<Ledsagemåde<ham
tikeriartigilli	tikip-RIAR<Imperativ<ViDem+LI
tikeriartigillu	tikip-RIAR<Imperativ<ViDem+LU
tikeriarlugit	tikip-RIAR<Ledsagemåde<dem
tikeriarlara	tikip-RIAR<Optativ<JegHam
tikeriarlarali	tikip-RIAR<Optativ<JegHam+LI
tikereermanga	tikip-RIIR<Causativ<HanMig
tikereerlugit	tikip-RIIR<Ledsagemåde<dem
tikereerlara	tikip-RIIR<Optativ<JegHam
tikereerlaraana	tikip-RIIR<Optativ<JegHam+UNA
tikissimavassi	tikip+SIMA<Indikativ<JegJer
tikissimaviuk	tikip+SIMA<Interrogativ<DuHam
tikissinnaalluginuna	tikip+SINNAA<Ledsagemåde<dem+UNA
tikissagaluarlarali	tikip-SSA=GALUAR<Optativ<JegHam+LI
tikittaraluarpagulli	tikip+TAR=GALUAR<Indikativ<ViDem+LI
tikittaraluarluguuna	tikip+TAR=GALUAR<Ledsagemåde<ham+UNA
tikittarlaralu	tikip+TAR<Optativ<JegHam+LU
tikippallaartigit	tikip+VALLAAR<Imperativ<ViDem
tikippallaarpagununa	tikip+VALLAAR<Indikativ<ViDem+UNA
tulluariartornermalu	tulluar+GIARTUR+NIQ<ental<min>Relativ+LU
tulluarunnaarnerlu	tulluar+GUNNAAR+NIQ<ental<Absolut+LU
tulluaannartooreerpit	tulluar-INNAR+TUQ-U-RIIR<Interrogativ<du
tullualaarporlu	tulluar-LAAR<Indikativ<han+LU
tullualaarnerinuna	tulluar-LAAR+NIQ<flertal<Relativ+UNA
tullualaartarpugut	tulluar-LAAR=TAR<Indikativ<vi
tullualaartartoriniarluguli	tulluar-LAAR=TAR+TUQ+GӘ+NIAR<Ledsagemåde<ham+LI
tulluarlutilli	tulluar<Ledsagemåde<de_selv+LI
tullualertulli	tulluar-LIR<Participium<de+LI
tullualertutulli	tulluar-LIR+TUQ<ental<Aequalis+LI
tulluarluarmanuna	tulluar+LUAR<Causativ<han+UNA
tulluarnianngitsorli	tulluar+NIAR=NNGIT<Participium<han+LI
tulluarnikuusunga	tulluar+NIKUU<Participium<jeg
tulluarnikuusuunini	tulluar+NIKUU+TUQ-U+NIQ<ental<sin<Absolut
tulluarnini	tulluar+NIQ<ental<sin<Absolut
tulluanngimmanuna	tulluar-NNGIT<Causativ<han+UNA
tulluanngilarli	tulluar-NNGIT<Indikativ<han+LI
tulluannginnini	tulluar-NNGIT+NIQ<ental<sin<Absolut
tulluaqqulara	tulluar-QQU<Optativ<JegHam
tulluarsinnaasuuallaartunga	tulluar+SINNAA+TUQ-U+VALLAAR<Participium<jeg
tulluassagaluarpunga	tulluar-SSA=GALUAR<Indikativ<jeg
tulluassasununa	tulluar-SSA<Participium<de+UNA
tulluartarnini	tulluar+TAR+NIQ<ental<sin<Absolut
tulluartartunga	tulluar+TAR<Participium<jeg
tulluarpallaarneq	tulluar+VALLAAR+NIQ<ental<Absolut
tulluarpallaanngillalli	tulluar+VALLAAR=NNGIT<Indikativ<de+LI
tusagassiortunngooqqullugulu	tusagassiortoq-NNGUAQ-U-QQU<Ledsagemåde<ham+LU
tusagassiortoorusuttunga	tusagassiortoq-U+GUSUP<Participium<jeg
tusagassiortooreerlutilli	tusagassiortoq-U-RIIR<Ledsagemåde<de_selv+LI
tusagassiortooreertungaana	tusagassiortoq-U-RIIR<Participium<jeg+UNA
tusaannarpakkalu	tusar-INNAR<Indikativ<JegDem+LU
tusalaarlaraana	tusar-LAAR<Optativ<JegHam+UNA
tusarnikuuiuk	tusar+NIKUU<Interrogativ<DuHam
tusarnerlugulu	tusar+NIR<Ledsagemåde<ham+LU
tusaqquiuk	tusar-QQU<Interrogativ<DuHam
tusassagaluarlara	tusar-SSA=GALUAR<Optativ<JegHam
tusarpallaannginagit	tusar+VALLAAR=NNGIT<Ledsagemåde<dem
tusavikkakkulu	tusar-VIP<Causativ<JegHam+LU
tusilarunnaarpit	tusilar+GUNNAAR<Interrogativ<du
tusilarusukkamalu	tusilar+GUSUP<Causativ<jeg+LU
tusilarusuttungalu	tusilar+GUSUP<Participium<jeg+LU
tusilarusuttoriilereriartoorusuttuma	tusilar+GUSUP+TUQ+GIIT-LIRI-RIAR+TUQ-U+GUSUP+TUQ<ental<min>Relativ
tusilalaarnini	tusilar-LAAR+NIQ<ental<sin<Absolut
tusilalaartarmataana	tusilar-LAAR=TAR<Causativ<de+UNA
tusilalaartarpit	tusilar-LAAR=TAR<Interrogativ<du
tusilarluarnernullu	tusilar+LUAR+NIQ<flertal<Terminalis+LU
tusilarniarnini	tusilar+NIAR+NIQ<ental<sin<Absolut
tusilarnini	tusilar+NIQ<ental<sin<Absolut
tusilartungali	tusilar<Participium<jeg+LI
tusilaqqaarlutinguna	tusilar-QQAAR<Ledsagemåde<de_selv+UNA
tusilariartulereqquakka	tusilar-RIAR+TUQ-LIRI-QQU<Indikativ<JegDem
tusilarpallaarpugullu	tusilar+VALLAAR<Indikativ<vi+LU
tusilavinnera	tusilar-VIP+NIQ<ental<hans<Absolut
tutsiuteqqimmat	tutsiuteqqip<Causativ<han
tutsiuteqqimmallu	tutsiuteqqip<Causativ<han+LU
tutsiuteqqikkattalu	tutsiuteqqip<Causativ<vi+LU
tutsiuteqqikkaluarnerinuna	tutsiuteqqip+GALUAR+NIQ<flertal<Relativ+UNA
tutsiuteqqilluarpunga	tutsiuteqqip+LUAR<Indikativ<jeg
tutsiuteqqilluarnini	tutsiuteqqip+LUAR+NIQ<ental<sin<Absolut
tutsiuteqqilluartungaana	tutsiuteqqip+LUAR<Participium<jeg+UNA
tutsiuteqqinnianngitsorlu	tutsiuteqqip+NIAR=NNGIT<Participium<han+LU
tutsiuteqqinnginnatta	tutsiuteqqip-NNGIT<Causativ<vi
tutsiuteqqittullu	tutsiuteqqip<Participium<de+LU
tutsiuteqqeqqaarpungali	tutsiuteqqip-QQAAR<Indikativ<jeg+LI
tutsiuteqqeqqutigilli	tutsiuteqqip-QQU<Imperativ<ViDem+LI
tutsiuteqqeqqulluginuna	tutsiuteqqip-QQU<Ledsagemåde<dem+UNA
tutsiuteqqeqqulara	tutsiuteqqip-QQU<Optativ<JegHam
tutsiuteqqeriarlutik	tutsiuteqqip-RIAR<Ledsagemåde<de_selv
tutsiuteqqeriartulli	tutsiuteqqip-RIAR<Participium<de+LI
tutsiuteqqeriartunga	tutsiuteqqip-RIAR<Participium<jeg
tutsiuteqqeriartutullu	tutsiuteqqip-RIAR+TUQ<ental<Aequalis+LU
tutsiuteqqereerporlu	tutsiuteqqip-RIIR<Indikativ<han+LU
tutsiuteqqereerlutik	tutsiuteqqip-RIIR<Ledsagemåde<de_selv
tutsiuteqqereertullu	tutsiuteqqip-RIIR<Participium<de+LU
tutsiuteqqissimallutinguna	tutsiuteqqip+SIMA<Ledsagemåde<de_selv+UNA
tutsiuteqqissimasarlutinguna	tutsiuteqqip+SIMA=TAR<Ledsagemåde<de_selv+UNA
tutsiuteqqissimasartunga	tutsiuteqqip+SIMA=TAR<Participium<jeg
tutsiuteqqittaraluartooqqaarlutilli	tutsiuteqqip+TAR=GALUAR+TUQ-U-QQAAR<Ledsagemåde<de_selv+LI
uagut	uagut<Pronomen<Absolut<ental
uagulli	uagut<Pronomen<Absolut<ental+LI
uagullu	uagut<Pronomen<Absolut<ental+LU
uagununa	uagut<Pronomen<Absolut<ental+UNA
uannit	uanga<Pronomen<Ablativ<jeg
uannillu	uanga<Pronomen<Ablativ<jeg+LU
uanga	uanga<Pronomen<jeg
uangalu	uanga<Pronomen<jeg+LU
uannulli	uanga<Pronomen<Terminalis<jeg+LI
uani	uani<Partikel
uanili	uani<Partikel+LI
uanilu	uani<Partikel+LU
uaniuna	uani<Partikel+UNA
ukiigamali	ukii<Causativ<jeg+LI
ukiigaluarattali	ukii+GALUAR<Causativ<vi+LI
ukeerusummalli	ukii+GUSUP<Causativ<han+LI
ukeerusuppit	ukii+GUSUP<Interrogativ<du
ukeerusunnerali	ukii+GUSUP+NIQ<ental<hans<Absolut+LI
ukeerusuttussanili	ukii+GUSUP+TUQ-SSAQ<flertal<Lokalis+LI
ukiinikuusoq	ukii+NIKUU<Participium<han
ukiisullu	ukii<Participium<de+LU
ukiisunga	ukii<Participium<jeg
ukeeqqaartorlu	ukii-QQAAR<Participium<han+LU
ukeeqqaartussalererusunninilu	ukii-QQAAR+TUQ-SSAQ-LIRI+GUSUP+NIQ<ental<sin<Absolut+LU
ukeeqqugakkuuna	ukii-QQU<Causativ<JegHam+UNA
ukeeqquiuk	ukii-QQU<Interrogativ<DuHam
ukeeqqulluginuna	ukii-QQU<Ledsagemåde<dem+UNA
ukeeriarpit	ukii-RIAR<Interrogativ<du
ukiisaraluarpit	ukii+TAR=GALUAR<Interrogativ<du
ukiisooqqaartut	ukii+TUQ-U-QQAAR<Participium<de
ukiivallaarmalli	ukii+VALLAAR<Causativ<han+LI
ukioq	ukioq<ental<Absolut
ukioruna	ukioq<ental<Absolut+UNA
ukiui	ukioq<flertal<hans<Absolut
ukiuinnakkut	ukioq-INNAQ<ental<Vialis
ukiuinnanngorpunga	ukioq-INNAQ-NNGUR<Indikativ<jeg
ukiukkullu	ukioq-KKUT<flertal<Absolut+LU
ukiunngoorusuppit	ukioq-NNGUAQ-U+GUSUP<Interrogativ<du
ukiortaaqqaartorlu	ukioq+TAAR-QQAAR+TUQ+LU
ukioorusullutillu	ukioq-U+GUSUP<Ledsagemåde<de_selv+LU
ukiooriarpit	ukioq-U-RIAR<Interrogativ<du
ukiooreerpit	ukioq-U-RIIR<Interrogativ<du
ulloq	ulloq<ental<Absolut
ullukkulli	ulloq<ental<Vialis+LI
ullukkununa	ulloq<ental<Vialis+UNA
ulloriivi	ulloq+GIIT<flertal<hans<Absolut
ulloriniarnagu	ulloq+GӘ+NIAR=NNGIT<Ledsagemåde<ham
ulluinnanngulerporuna	ulloq-INNAQ-NNGUR-LIR<Indikativ<han+UNA
ulluinnaasartoq	ulloq-INNAQ-U+TAR+TUQ<ental<Absolut
ullukkunninguna	ulloq-KKUT<flertal<Instrumentalis+UNA
ullulererusullutillu	ulloq-LIRI+GUSUP<Ledsagemåde<de_selv+LU
ullunngoorusukkama	ulloq-NNGUAQ-U+GUSUP<Causativ<jeg
ullunngoriarpit	ulloq-NNGUR-RIAR<Interrogativ<du
ulloqanngillalli	ulloq-QAR-NNGIT<Indikativ<de+LI
ulloqariarlutik	ulloq-QAR-RIAR<Ledsagemåde<de_selv
ulloqariartoqaqqaartuulaartartut	ulloq-QAR-RIAR+TUQ-QAR-QQAAR+TUQ-U-LAAR=TAR<Participium<de
ulloqassagaluartunnguuvunga	ulloq-QAR-SSA=GALUAR+TUQ-NNGUAQ-U<Indikativ<jeg
ullussanngornianngitsut	ulloq-SSAQ-NNGUR+NIAR=NNGIT<Participium<de
ullussartaaraluarmata	ulloq-SSAQ+TAAR+GALUAR<Causativ<de
ullortaalaartarpulli	ulloq+TAAR-LAAR=TAR<Indikativ<de+LI
ullortaavinninili	ulloq+TAAR-VIP+NIQ<ental<sin<Absolut+LI
ulluujunnaarnermali	ulloq-U+GUNNAAR+NIQ<ental<min>Relativ+LI
ulloorusunnerninguna	ulloq-U+GUSUP+NIQ<flertal<Instrumentalis+UNA
ulluunikuuneq	ulloq-U+NIKUU+NIQ<ental<Absolut
ullooqqaarpit	ulloq-U-QQAAR<Interrogativ<du
ullooriartullinuna	ulloq-U-RIAR+TUQ-LIK<flertal<Relativ+UNA
ullumi	ullumi<Partikel
ullumili	ullumi<Partikel+LI
ullumilu	ullumi<Partikel+LU
ullumiuna	ullumi<Partikel+UNA
ungasillutillu	ungasip<Ledsagemåde<de_selv+LU
ungasilluarnermukariarpugulli	ungasip+LUAR+NIQ<ental<Terminalis-KAR-RIAR<Indikativ<vi+LI
ungasilluartullu	ungasip+LUAR<Participium<de+LU
ungasinnianngitsullilli	ungasip+NIAR=NNGIT+TUQ-LIK<flertal<Relativ+LI
ungasittorlu	ungasip<Participium<han+LU
ungaseqqaarama	ungasip-QQAAR<Causativ<jeg
ungaseqqaarput	ungasip-QQAAR<Indikativ<de
ungaseqqaarnini	ungasip-QQAAR+NIQ<ental<sin<Absolut
ungaseriarlutilli	ungasip-RIAR<Ledsagemåde<de_selv+LI
ungaseriarlutinguna	ungasip-RIAR<Ledsagemåde<de_selv+UNA
ungasissavit	ungasip-SSA<Interrogativ<du
ungasittaraluartunngooqqaartoqaqqaarpit	ungasip+TAR=GALUAR+TUQ-NNGUAQ-U-QQAAR+TUQ-QAR-QQAAR<Interrogativ<du
ungasippallaartullu	ungasip+VALLAAR<Participium<de+LU
unimmata	unip<Causativ<de
unimmalli	unip<Causativ<han+LI
unimmallu	unip<Causativ<han+LU
unikkiartortorli	unip+GIARTUR<Participium<han+LI
uniinnarlutik	unip-INNAR<Ledsagemåde<de_selv
unillutik	unip<Ledsagemåde<de_selv
uninniartoqaqqaarpunga	unip+NIAR+TUQ-QAR-QQAAR<Indikativ<jeg
uneqqaarmanuna	unip-QQAAR<Causativ<han+UNA
uneqqaarpugut	unip-QQAAR<Indikativ<vi
uneqqaarpit	unip-QQAAR<Interrogativ<du
uneqqaartungalu	unip-QQAAR<Participium<jeg+LU
uneqqaartuuniaratta	unip-QQAAR+TUQ-U+NIAR<Causativ<vi
uneqquaallu	unip-QQU<Indikativ<DeHam+LU
uneqquassi	unip-QQU<Indikativ<JegJer
uneqquiuk	unip-QQU<Interrogativ<DuHam
uneqqulara	unip-QQU<Optativ<JegHam
uneqqularali	unip-QQU<Optativ<JegHam+LI
uneqqularalu	unip-QQU<Optativ<JegHam+LU
uneriarpulli	unip-RIAR<Indikativ<de+LI
uneriarpugullu	unip-RIAR<Indikativ<vi+LU
uneriarpit	unip-RIAR<Interrogativ<du
uneriarlutilli	unip-RIAR<Ledsagemåde<de_selv+LI
uneriarnini	unip-RIAR+NIQ<ental<sin<Absolut
unereertunngoqqummanga	unip-RIIR+TUQ-NNGUR-QQU<Causativ<HanMig
unereertooriarporlu	unip-RIIR+TUQ-U-RIAR<Indikativ<han+LU
unissimasarmatalu	unip+SIMA=TAR<Causativ<de+LU
unippallaarmata	unip+VALLAAR<Causativ<de
univimmat	unip-VIP<Causativ<han
upernaaq	upernaaq<ental<Absolut
upernaarli	upernaaq<ental<Absolut+LI
upernaami	upernaaq<ental<Lokalis
upernaarali	upernaaq<ental<min<Absolut+LI
upernaama	upernaaq<ental<min>Relativ
upernaariilli	upernaaq+GIIT<flertal<Relativ+LI
upernaariilererusukkatta	upernaaq+GIIT-LIRI+GUSUP<Causativ<vi
upernaariinngunngitsuusuinnarmik	upernaaq+GIIT-NNGUR-NNGIT+TUQ-U+TUQ-INNAQ<ental<Instrumentalis
upernaariinngoqqaarattalu	upernaaq+GIIT-NNGUR-QQAAR<Causativ<vi+LU
upernaarilaarpiuk	upernaaq+GӘ-LAAR<Interrogativ<DuHam
upernaarivillugu	upernaaq+GӘ-VIP<Ledsagemåde<ham
upernaannanngunngitsut	upernaaq-INNAQ-NNGUR-NNGIT<Participium<de
upernaakkunni	upernaaq-KKUT<flertal<Lokalis
upernaakkunneeriartoqanngilarli	upernaaq-KKUT<flertal<Lokalis+IP-RIAR+TUQ-QAR-NNGIT<Indikativ<han+LI
upernaalia	upernaaq-LIK<ental<hans<Absolut
upernaallit	upernaaq-LIK<flertal<Absolut
upernaannguuinnarnini	upernaaq-NNGUAQ-U-INNAR+NIQ<ental<sin<Absolut
upernaanngooriartunga	upernaaq-NNGUAQ-U-RIAR<Participium<jeg
upernaanngunngitsuusinnaanerma	upernaaq-NNGUR-NNGIT+TUQ-U+SINNAA+NIQ<ental<min>Relativ
upernaanngoqqulara	upernaaq-NNGUR-QQU<Optativ<JegHam
upernaarpassui	upernaaq+PASSUAQ<flertal<hans<Absolut
upernaarpassuili	upernaaq+PASSUAQ<flertal<hans<Absolut+LI
upernaarpassuarneeqqulara	upernaaq+PASSUAQ<flertal<Lokalis+IP-QQU<Optativ<JegHam
upernaaqarattali	upernaaq-QAR<Causativ<vi+LI
upernaaqariartunga	upernaaq-QAR-RIAR<Participium<jeg
upernaarsiulaartarnini	upernaaq+SIUR-LAAR=TAR+NIQ<ental<sin<Absolut
upernaartaalaartarput	upernaaq+TAAR-LAAR=TAR<Indikativ<de
upernaartaariarpit	upernaaq+TAAR-RIAR<Interrogativ<du
upernaajujartorlutilli	upernaaq-U+GIARTUR<Ledsagemåde<de_selv+LI
upernaaqqaarlutillu	upernaaq-U-QQAAR<Ledsagemåde<de_selv+LU
upernaajusaraluarama	upernaaq-U+TAR=GALUAR<Causativ<jeg
Upernavik	Upernavik<Absolut
Upernavilli	Upernavik<Absolut+LI
Upernavillu	Upernavik<Absolut+LU
Upernavinguna	Upernavik<Absolut+UNA
Upernavimmik	Upernavik<Instrumentalis
Upernavimmilli	Upernavik<Instrumentalis+LI
Upernavimminguna	Upernavik<Instrumentalis+UNA
Upernavimmi	Upernavik<Lokalis
Upernavimmiilaartaratta	Upernavik<Lokalis+IP-LAAR=TAR<Causativ<vi
Upernavimmeeriarpugullu	Upernavik<Lokalis+IP-RIAR<Indikativ<vi+LU
Upernavimmeeriartoruna	Upernavik<Lokalis+IP-RIAR+TUQ+UNA
Upernavimmeereerpit	Upernavik<Lokalis+IP-RIIR<Interrogativ<du
Upernavimmiittartoq	Upernavik<Lokalis+IP+TAR+TUQ
Upernavimmiivimmalli	Upernavik<Lokalis+IP-VIP<Causativ<han+LI
Upernavimmiunik	Upernavik+MIU<flertal<Instrumentalis
Upernavimmiunilli	Upernavik+MIU<flertal<Instrumentalis+LI
Upernavimmiunngulerattalu	Upernavik+MIU-NNGUR-LIR<Causativ<vi+LU
Upernavimmioqarporlu	Upernavik+MIU-QAR<Indikativ<han+LU
Upernavimmiuugaluarnerallu	Upernavik+MIU-U+GALUAR+NIQ<ental<deres+LU
Upernavimmioorusullutillu	Upernavik+MIU-U+GUSUP<Ledsagemåde<de_selv+LU
Upernavimmioorusuttunga	Upernavik+MIU-U+GUSUP<Participium<jeg
Upernavimmiuuit	Upernavik+MIU-U<Interrogativ<du
Upernavimmiooreermat	Upernavik+MIU-U-RIIR<Causativ<han
Upernavimmukarpoq	Upernavik<Terminalis-KAR<Indikativ<han
Upernavimmukalaartarlutik	Upernavik<Terminalis-KAR-LAAR=TAR<Ledsagemåde<de_selv
Upernavimmukaqqugakkuuna	Upernavik<Terminalis-KAR-QQU<Causativ<JegHam+UNA
Upernavimmukariarpit	Upernavik<Terminalis-KAR-RIAR<Interrogativ<du
Upernavimmukartarlutilli	Upernavik<Terminalis-KAR+TAR<Ledsagemåde<de_selv+LI
Upernavimmukavittunga	Upernavik<Terminalis-KAR-VIP<Participium<jeg
Upernavimmulli	Upernavik<Terminalis+LI
Upernavimmullu	Upernavik<Terminalis+LU
Upernavimmununa	Upernavik<Terminalis+UNA
Upernavikkut	Upernavik<Vialis
Upernavikkulli	Upernavik<Vialis+LI
Upernavikkullu	Upernavik<Vialis+LU
Upernavikkununa	Upernavik<Vialis+UNA
Uummannaq	Uummannaq<Absolut
Uummannarli	Uummannaq<Absolut+LI
Uummannarlu	Uummannaq<Absolut+LU
Uummannaruna	Uummannaq<Absolut+UNA
Uummannamik	Uummannaq<Instrumentalis
Uummannamilli	Uummannaq<Instrumentalis+LI
Uummannamillu	Uummannaq<Instrumentalis+LU
Uummannaminguna	Uummannaq<Instrumentalis+UNA
Uummannami	Uummannaq<Lokalis
Uummannameeqqaarmata	Uummannaq<Lokalis+IP-QQAAR<Causativ<de
Uummannameeqqaarama	Uummannaq<Lokalis+IP-QQAAR<Causativ<jeg
Uummannameeqqaarattalu	Uummannaq<Lokalis+IP-QQAAR<Causativ<vi+LU
Uummannameeqqaartorli	Uummannaq<Lokalis+IP-QQAAR<Participium<han+LI
Uummannameeqqummangaana	Uummannaq<Lokalis+IP-QQU<Causativ<HanMig+UNA
Uummannameeqqullugilli	Uummannaq<Lokalis+IP-QQU<Ledsagemåde<dem+LI
Uummannameeriartoqarpoq	Uummannaq<Lokalis+IP-RIAR+TUQ-QAR<Indikativ<han
Uummannamiissimagama	Uummannaq<Lokalis+IP+SIMA<Causativ<jeg
Uummannamili	Uummannaq<Lokalis+LI
Uummannamilu	Uummannaq<Lokalis+LU
Uummannamiuna	Uummannaq<Lokalis+UNA
Uummannarmiumukaqqaarattalu	Uummannaq+MIU<ental<Terminalis-KAR-QQAAR<Causativ<vi+LU
Uummannarmiunilli	Uummannaq+MIU<flertal<Instrumentalis+LI
Uummannarmiunillu	Uummannaq+MIU<flertal<Instrumentalis+LU
Uummannarmiulerilerlutilli	Uummannaq+MIU-LIRI-LIR<Ledsagemåde<de_selv+LI
Uummannarmiunnguinnarpit	Uummannaq+MIU-NNGUR-INNAR<Interrogativ<du
Uummannarmiunngulaartoq	Uummannaq+MIU-NNGUR-LAAR<Participium<han
Uummannarmiunngortungalu	Uummannaq+MIU-NNGUR<Participium<jeg+LU
Uummannarmiunngussallutillu	Uummannaq+MIU-NNGUR-SSA<Ledsagemåde<de_selv+LU
Uummannarmioqarporlu	Uummannaq+MIU-QAR<Indikativ<han+LU
Uummannarmioqarneq	Uummannaq+MIU-QAR+NIQ
Uummannarmioqarnerli	Uummannaq+MIU-QAR+NIQ+LI
Uummannarmioqartorlu	Uummannaq+MIU-QAR+TUQ+LU
Uummannarmioorusullutik	Uummannaq+MIU-U+GUSUP<Ledsagemåde<de_selv
Uummannarmiuunertooreermat	Uummannaq+MIU-U+NIR+TUQ-U-RIIR<Causativ<han
Uummannarmiooqqulara	Uummannaq+MIU-U-QQU<Optativ<JegHam
Uummannarmiooriaratta	Uummannaq+MIU-U-RIAR<Causativ<vi
Uummannamut	Uummannaq<Terminalis
Uummannamukaannaratta	Uummannaq<Terminalis-KAR-INNAR<Causativ<vi
Uummannamukaannarpugullu	Uummannaq<Terminalis-KAR-INNAR<Indikativ<vi+LU
Uummannamukalaarneq	Uummannaq<Terminalis-KAR-LAAR+NIQ
Uummannamukariarlutik	Uummannaq<Terminalis-KAR-RIAR<Ledsagemåde<de_selv
Uummannamukariartorlu	Uummannaq<Terminalis-KAR-RIAR<Participium<han+LU
Uummannamukareerporli	Uummannaq<Terminalis-KAR-RIIR<Indikativ<han+LI
Uummannamulli	Uummannaq<Terminalis+LI
Uummannamullu	Uummannaq<Terminalis+LU
Uummannakkut	Uummannaq<Vialis
Uummannakkulli	Uummannaq<Vialis+LI
Uummannakkullu	Uummannaq<Vialis+LU
Uummannakkununa	Uummannaq<Vialis+UNA
