akisussaassuseq	akisussaassuseq<ental<Absolut
akisussaassusiata	akisussaassuseq<ental<deres<Relativ
akisussaassusiata	akisussaassuseq<ental<hans<Relativ
akisussaassutsinni	akisussaassuseq<ental<min<Lokalis
akisussaassusii	akisussaassuseq<flertal<deres<Absolut
akisussaassutsinni	akisussaassuseq<flertal<min<Lokalis
akisussaassusilerpaa	akisussaassuseq-LIR_nv<Indikativ<HanHam
akisussaassusilertippaa	akisussaassuseq-LIR_nv+TIP<Indikativ<HanHam
akisussaassusilertussaavaa	akisussaassuseq-LIR_nv+TUQ=SSAQ=U<Indikativ<HanHam
akisussaassusissaagaluaq	akisussaassuseq-SSAQ=U=GALUAQ<Absolut<ental
akisussaassusissaagaluata	akisussaassuseq-SSAQ=U=GALUAQ<ental<deres<Relativ
akisussaassusissaagaluata	akisussaassuseq-SSAQ=U=GALUAQ<ental<hans<Relativ
akisussaassusissaagaluanni	akisussaassuseq-SSAQ=U=GALUAQ<ental<min<Lokalis
akisussaassusissaagalui	akisussaassuseq-SSAQ=U=GALUAQ<flertal<deres<Absolut
akisussaassusissaagaluanni	akisussaassuseq-SSAQ=U=GALUAQ<flertal<min<Lokalis
allagaq	allagaq<ental<Absolut
allakkanni	allagaq<ental<min<Lokalis
allakkanni	allagaq<flertal<min<Lokalis
allagalerpaa	allagaq-LIR_nv<Indikativ<HanHam
allagalertippaa	allagaq-LIR_nv+TIP<Indikativ<HanHam
allagalertussaavaa	allagaq-LIR_nv+TUQ=SSAQ=U<Indikativ<HanHam
allagassaagaluaq	allagaq-SSAQ=U=GALUAQ<Absolut<ental
allagassaagaluata	allagaq-SSAQ=U=GALUAQ<ental<deres<Relativ
allagassaagaluata	allagaq-SSAQ=U=GALUAQ<ental<hans<Relativ
allagassaagaluanni	allagaq-SSAQ=U=GALUAQ<ental<min<Lokalis
allagassaagalui	allagaq-SSAQ=U=GALUAQ<flertal<deres<Absolut
allagassaagaluanni	allagaq-SSAQ=U=GALUAQ<flertal<min<Lokalis
allakkeriffik	allakkeri+FIK<ental<Absolut
allakkeriffiata	allakkeri+FIK<ental<hans<Relativ
allakkeriffinni	allakkeri+FIK<flertal<min<Lokalis
allakkeriffilerpaa	allakkeri+FIK-LIR_nv<Indikativ<HanHam
allakkeriffilertippaa	allakkeri+FIK-LIR_nv+TIP<Indikativ<HanHam
allakkeriffissaagaluata	allakkeri+FIK-SSAQ=U=GALUAQ<ental<hans<Relativ
allakkeriffissaagaluanni	allakkeri+FIK-SSAQ=U=GALUAQ<ental<min<Lokalis
allakkeriva	allakkeri<Interrogativ<han
allakkerinerpaaq	allakkeri+NIRPAAQ<ental<Absolut
allakkerinerpaata	allakkeri+NIRPAAQ<ental<deres<Relativ
allakkerinerpaata	allakkeri+NIRPAAQ<ental<hans<Relativ
allakkerinerpaat	allakkeri+NIRPAAQ<flertal<deres<Absolut
allakkerinerpaanni	allakkeri+NIRPAAQ<flertal<min<Lokalis
allakkerinerpaalerpaa	allakkeri+NIRPAAQ-LIR_nv<Indikativ<HanHam
allakkerinerpaalertippaa	allakkeri+NIRPAAQ-LIR_nv+TIP<Indikativ<HanHam
allakkerinerpaalertussaavaa	allakkeri+NIRPAAQ-LIR_nv+TUQ=SSAQ=U<Indikativ<HanHam
allakkerinerpaassaagaluaq	allakkeri+NIRPAAQ-SSAQ=U=GALUAQ<Absolut<ental
allakkerinerpaassaagaluata	allakkeri+NIRPAAQ-SSAQ=U=GALUAQ<ental<hans<Relativ
allakkerinerpaassaagaluanni	allakkeri+NIRPAAQ-SSAQ=U=GALUAQ<ental<min<Lokalis
allakkerinerpaassaagalui	allakkeri+NIRPAAQ-SSAQ=U=GALUAQ<flertal<deres<Absolut
allakkerinerpaassaagaluanni	allakkeri+NIRPAAQ-SSAQ=U=GALUAQ<flertal<min<Lokalis
allakkeritippaa	allakkeri+TIP<Indikativ<HanHam
allakkerisussaaffinni	allakkeri+TUQ=SSAQ=U+FIK<ental<min<Lokalis
allakkerisussaaffilertippaa	allakkeri+TUQ=SSAQ=U+FIK-LIR_nv+TIP<Indikativ<HanHam
allakkerisussaaffilertussaavaa	allakkeri+TUQ=SSAQ=U+FIK-LIR_nv+TUQ=SSAQ=U<Indikativ<HanHam
allakkerisussaava	allakkeri+TUQ=SSAQ=U<Interrogativ<han
allakkerisussaanerpaata	allakkeri+TUQ=SSAQ=U+NIRPAAQ<ental<deres<Relativ
allakkerisussaanerpaanni	allakkeri+TUQ=SSAQ=U+NIRPAAQ<ental<min<Lokalis
allakkerisussaanerpaat	allakkeri+TUQ=SSAQ=U+NIRPAAQ<flertal<deres<Absolut
allakkerisussaanerpaassaagaluata	allakkeri+TUQ=SSAQ=U+NIRPAAQ-SSAQ=U=GALUAQ<ental<hans<Relativ
assorsuaq	assorsuaq<Partikel
eqqarsaatigivaa	eqqarsaatigә<Indikativ<HanHam
eqqarsaatigitippaa	eqqarsaatigә+TIP<Indikativ<HanHam
eqqarsaatigisussaavaa	eqqarsaatigә+TUQ=SSAQ=U<Indikativ<HanHam
eqqumiiffik	eqqumiip+FIK<ental<Absolut
eqqumiiffiata	eqqumiip+FIK<ental<deres<Relativ
eqqumiiffiata	eqqumiip+FIK<ental<hans<Relativ
eqqumiiffinni	eqqumiip+FIK<ental<min<Lokalis
eqqumiiffii	eqqumiip+FIK<flertal<deres<Absolut
eqqumiiffinni	eqqumiip+FIK<flertal<min<Lokalis
eqqumiiffilerpaa	eqqumiip+FIK-LIR_nv<Indikativ<HanHam
eqqumiiffilertippaa	eqqumiip+FIK-LIR_nv+TIP<Indikativ<HanHam
eqqumiiffilertussaavaa	eqqumiip+FIK-LIR_nv+TUQ=SSAQ=U<Indikativ<HanHam
eqqumiiffissaagaluaq	eqqumiip+FIK-SSAQ=U=GALUAQ<Absolut<ental
eqqumiiffissaagaluata	eqqumiip+FIK-SSAQ=U=GALUAQ<ental<deres<Relativ
eqqumiiffissaagaluata	eqqumiip+FIK-SSAQ=U=GALUAQ<ental<hans<Relativ
eqqumiiffissaagaluanni	eqqumiip+FIK-SSAQ=U=GALUAQ<ental<min<Lokalis
eqqumiiffissaagalui	eqqumiip+FIK-SSAQ=U=GALUAQ<flertal<deres<Absolut
eqqumiiffissaagaluanni	eqqumiip+FIK-SSAQ=U=GALUAQ<flertal<min<Lokalis
eqqumiippoq	eqqumiip<Indikativ<han
eqqumiippa	eqqumiip<Interrogativ<han
eqqumiinnerpaaq	eqqumiip+NIRPAAQ<ental<Absolut
eqqumiinnerpaata	eqqumiip+NIRPAAQ<ental<deres<Relativ
eqqumiinnerpaata	eqqumiip+NIRPAAQ<ental<hans<Relativ
eqqumiinnerpaanni	eqqumiip+NIRPAAQ<ental<min<Lokalis
eqqumiinnerpaat	eqqumiip+NIRPAAQ<flertal<deres<Absolut
eqqumiinnerpaanni	eqqumiip+NIRPAAQ<flertal<min<Lokalis
eqqumiinnerpaalerpaa	eqqumiip+NIRPAAQ-LIR_nv<Indikativ<HanHam
eqqumiinnerpaalertippaa	eqqumiip+NIRPAAQ-LIR_nv+TIP<Indikativ<HanHam
eqqumiinnerpaalertussaavaa	eqqumiip+NIRPAAQ-LIR_nv+TUQ=SSAQ=U<Indikativ<HanHam
eqqumiinnerpaassaagaluaq	eqqumiip+NIRPAAQ-SSAQ=U=GALUAQ<Absolut<ental
eqqumiinnerpaassaagaluata	eqqumiip+NIRPAAQ-SSAQ=U=GALUAQ<ental<hans<Relativ
eqqumiinnerpaassaagaluanni	eqqumiip+NIRPAAQ-SSAQ=U=GALUAQ<ental<min<Lokalis
eqqumiinnerpaassaagalui	eqqumiip+NIRPAAQ-SSAQ=U=GALUAQ<flertal<deres<Absolut
eqqumiitsippaa	eqqumiip+TIP<Indikativ<HanHam
eqqumiitsussaaffik	eqqumiip+TUQ=SSAQ=U+FIK<ental<Absolut
eqqumiitsussaaffiata	eqqumiip+TUQ=SSAQ=U+FIK<ental<deres<Relativ
eqqumiitsussaaffiata	eqqumiip+TUQ=SSAQ=U+FIK<ental<hans<Relativ
eqqumiitsussaaffinni	eqqumiip+TUQ=SSAQ=U+FIK<ental<min<Lokalis
eqqumiitsussaaffii	eqqumiip+TUQ=SSAQ=U+FIK<flertal<deres<Absolut
eqqumiitsussaaffinni	eqqumiip+TUQ=SSAQ=U+FIK<flertal<min<Lokalis
eqqumiitsussaaffilerpaa	eqqumiip+TUQ=SSAQ=U+FIK-LIR_nv<Indikativ<HanHam
eqqumiitsussaaffilertippaa	eqqumiip+TUQ=SSAQ=U+FIK-LIR_nv+TIP<Indikativ<HanHam
eqqumiitsussaaffilertussaavaa	eqqumiip+TUQ=SSAQ=U+FIK-LIR_nv+TUQ=SSAQ=U<Indikativ<HanHam
eqqumiitsussaaffissaagaluaq	eqqumiip+TUQ=SSAQ=U+FIK-SSAQ=U=GALUAQ<Absolut<ental
eqqumiitsussaaffissaagaluata	eqqumiip+TUQ=SSAQ=U+FIK-SSAQ=U=GALUAQ<ental<deres<Relativ
eqqumiitsussaaffissaagalui	eqqumiip+TUQ=SSAQ=U+FIK-SSAQ=U=GALUAQ<flertal<deres<Absolut
eqqumiitsussaaffissaagaluanni	eqqumiip+TUQ=SSAQ=U+FIK-SSAQ=U=GALUAQ<flertal<min<Lokalis
eqqumiitsussaava	eqqumiip+TUQ=SSAQ=U<Interrogativ<han
eqqumiitsussaanerpaaq	eqqumiip+TUQ=SSAQ=U+NIRPAAQ<ental<Absolut
eqqumiitsussaanerpaata	eqqumiip+TUQ=SSAQ=U+NIRPAAQ<ental<hans<Relativ
eqqumiitsussaanerpaanni	eqqumiip+TUQ=SSAQ=U+NIRPAAQ<ental<min<Lokalis
eqqumiitsussaanerpaat	eqqumiip+TUQ=SSAQ=U+NIRPAAQ<flertal<deres<Absolut
eqqumiitsussaanerpaanni	eqqumiip+TUQ=SSAQ=U+NIRPAAQ<flertal<min<Lokalis
eqqumiitsussaanerpaalerpaa	eqqumiip+TUQ=SSAQ=U+NIRPAAQ-LIR_nv<Indikativ<HanHam
eqqumiitsussaanerpaalertippaa	eqqumiip+TUQ=SSAQ=U+NIRPAAQ-LIR_nv+TIP<Indikativ<HanHam
eqqumiitsussaanerpaalertussaavaa	eqqumiip+TUQ=SSAQ=U+NIRPAAQ-LIR_nv+TUQ=SSAQ=U<Indikativ<HanHam
eqqumiitsussaanerpaassaagaluata	eqqumiip+TUQ=SSAQ=U+NIRPAAQ-SSAQ=U=GALUAQ<ental<deres<Relativ
eqqumiitsussaanerpaassaagaluata	eqqumiip+TUQ=SSAQ=U+NIRPAAQ-SSAQ=U=GALUAQ<ental<hans<Relativ
eqqumiitsussaanerpaassaagaluanni	eqqumiip+TUQ=SSAQ=U+NIRPAAQ-SSAQ=U=GALUAQ<ental<min<Lokalis
eqqumiitsussaanerpaassaagalui	eqqumiip+TUQ=SSAQ=U+NIRPAAQ-SSAQ=U=GALUAQ<flertal<deres<Absolut
eqqumiitsussaanerpaassaagaluanni	eqqumiip+TUQ=SSAQ=U+NIRPAAQ-SSAQ=U=GALUAQ<flertal<min<Lokalis
ilagivaa	ilagә<Indikativ<HanHam
ilagitippaa	ilagә+TIP<Indikativ<HanHam
ilagisussaavaa	ilagә+TUQ=SSAQ=U<Indikativ<HanHam
ilinniartitaaneq	ilinniartitaaneq<ental<Absolut
ilinniartitaanerata	ilinniartitaaneq<ental<deres<Relativ
ilinniartitaanerata	ilinniartitaaneq<ental<hans<Relativ
ilinniartitaaninni	ilinniartitaaneq<ental<min<Lokalis
ilinniartitaaneri	ilinniartitaaneq<flertal<deres<Absolut
ilinniartitaaninni	ilinniartitaaneq<flertal<min<Lokalis
ilinniartitaanilerpaa	ilinniartitaaneq-LIR_nv<Indikativ<HanHam
ilinniartitaanilertippaa	ilinniartitaaneq-LIR_nv+TIP<Indikativ<HanHam
ilinniartitaanilertussaavaa	ilinniartitaaneq-LIR_nv+TUQ=SSAQ=U<Indikativ<HanHam
ilinniartitaanissaagaluaq	ilinniartitaaneq-SSAQ=U=GALUAQ<Absolut<ental
ilinniartitaanissaagaluata	ilinniartitaaneq-SSAQ=U=GALUAQ<ental<deres<Relativ
ilinniartitaanissaagaluata	ilinniartitaaneq-SSAQ=U=GALUAQ<ental<hans<Relativ
ilinniartitaanissaagaluanni	ilinniartitaaneq-SSAQ=U=GALUAQ<ental<min<Lokalis
ilinniartitaanissaagalui	ilinniartitaaneq-SSAQ=U=GALUAQ<flertal<deres<Absolut
ilinniartitaanissaagaluanni	ilinniartitaaneq-SSAQ=U=GALUAQ<flertal<min<Lokalis
inequnarfik	inequnar+FIK<ental<Absolut
inequnarfinni	inequnar+FIK<ental<min<Lokalis
inequnarfilerpaa	inequnar+FIK-LIR_nv<Indikativ<HanHam
inequnarfissaagaluaq	inequnar+FIK-SSAQ=U=GALUAQ<Absolut<ental
inequnarfissaagaluanni	inequnar+FIK-SSAQ=U=GALUAQ<flertal<min<Lokalis
inequnarpa	inequnar<Interrogativ<han
inequnarnerpaaq	inequnar+NIRPAAQ<ental<Absolut
inequnarnerpaata	inequnar+NIRPAAQ<ental<hans<Relativ
inequnarnerpaanni	inequnar+NIRPAAQ<ental<min<Lokalis
inequnarnerpaat	inequnar+NIRPAAQ<flertal<deres<Absolut
inequnarnerpaalerpaa	inequnar+NIRPAAQ-LIR_nv<Indikativ<HanHam
inequnarnerpaalertussaavaa	inequnar+NIRPAAQ-LIR_nv+TUQ=SSAQ=U<Indikativ<HanHam
inequnarnerpaassaagaluanni	inequnar+NIRPAAQ-SSAQ=U=GALUAQ<ental<min<Lokalis
inequnarnerpaassaagalui	inequnar+NIRPAAQ-SSAQ=U=GALUAQ<flertal<deres<Absolut
inequnarnerpaassaagaluanni	inequnar+NIRPAAQ-SSAQ=U=GALUAQ<flertal<min<Lokalis
inequnartippaa	inequnar+TIP<Indikativ<HanHam
inequnartussaaffissaagaluanni	inequnar+TUQ=SSAQ=U+FIK-SSAQ=U=GALUAQ<ental<min<Lokalis
inequnartussaanerpaata	inequnar+TUQ=SSAQ=U+NIRPAAQ<ental<hans<Relativ
inequnartussaanerpaat	inequnar+TUQ=SSAQ=U+NIRPAAQ<flertal<deres<Absolut
ingerlappaa	ingerlap<Indikativ<HanHam
ingerlatitippaa	ingerlap+TIP<Indikativ<HanHam
ingerlattussaavaa	ingerlap+TUQ=SSAQ=U<Indikativ<HanHam
inuuik	inuuik<ental<Absolut
inuuiata	inuuik<ental<deres<Relativ
inuuiata	inuuik<ental<hans<Relativ
inuuinni	inuuik<ental<min<Lokalis
inuuii	inuuik<flertal<deres<Absolut
inuuinni	inuuik<flertal<min<Lokalis
inuuilerpaa	inuuik-LIR_nv<Indikativ<HanHam
inuuilertippaa	inuuik-LIR_nv+TIP<Indikativ<HanHam
inuuissaagaluaq	inuuik-SSAQ=U=GALUAQ<Absolut<ental
inuuissaagaluata	inuuik-SSAQ=U=GALUAQ<ental<deres<Relativ
inuuissaagaluanni	inuuik-SSAQ=U=GALUAQ<ental<min<Lokalis
inuuissaagalui	inuuik-SSAQ=U=GALUAQ<flertal<deres<Absolut
inuuissaagaluanni	inuuik-SSAQ=U=GALUAQ<flertal<min<Lokalis
isumaqatigiissutigivaa	isumaqatigiissutigә<Indikativ<HanHam
isumaqatigiissutigitippaa	isumaqatigiissutigә+TIP<Indikativ<HanHam
isumaqatigiissutigisussaavaa	isumaqatigiissutigә+TUQ=SSAQ=U<Indikativ<HanHam
januaari	januaari<ental<Absolut
maaji	maaji<ental<Absolut
malippaa	malip<Indikativ<HanHam
malitsippaa	malip+TIP<Indikativ<HanHam
malittussaavaa	malip+TUQ=SSAQ=U<Indikativ<HanHam
meeqqerivik	meeqqerivik<ental<Absolut
meeqqeriviata	meeqqerivik<ental<deres<Relativ
meeqqeriviata	meeqqerivik<ental<hans<Relativ
meeqqerivinni	meeqqerivik<ental<min<Lokalis
meeqqerivii	meeqqerivik<flertal<deres<Absolut
meeqqerivinni	meeqqerivik<flertal<min<Lokalis
meeqqerivilerpaa	meeqqerivik-LIR_nv<Indikativ<HanHam
meeqqerivilertippaa	meeqqerivik-LIR_nv+TIP<Indikativ<HanHam
meeqqerivilertussaavaa	meeqqerivik-LIR_nv+TUQ=SSAQ=U<Indikativ<HanHam
meeqqerivissaagaluaq	meeqqerivik-SSAQ=U=GALUAQ<Absolut<ental
meeqqerivissaagaluata	meeqqerivik-SSAQ=U=GALUAQ<ental<deres<Relativ
meeqqerivissaagaluata	meeqqerivik-SSAQ=U=GALUAQ<ental<hans<Relativ
meeqqerivissaagaluanni	meeqqerivik-SSAQ=U=GALUAQ<ental<min<Lokalis
meeqqerivissaagalui	meeqqerivik-SSAQ=U=GALUAQ<flertal<deres<Absolut
meeqqerivissaagaluanni	meeqqerivik-SSAQ=U=GALUAQ<flertal<min<Lokalis
naleqartitaq	naleqartitaq<ental<Absolut
naleqartitaata	naleqartitaq<ental<deres<Relativ
naleqartitaata	naleqartitaq<ental<hans<Relativ
naleqartitanni	naleqartitaq<ental<min<Lokalis
naleqartitaat	naleqartitaq<flertal<deres<Absolut
naleqartitanni	naleqartitaq<flertal<min<Lokalis
naleqartitalerpaa	naleqartitaq-LIR_nv<Indikativ<HanHam
naleqartitalertippaa	naleqartitaq-LIR_nv+TIP<Indikativ<HanHam
naleqartitalertussaavaa	naleqartitaq-LIR_nv+TUQ=SSAQ=U<Indikativ<HanHam
naleqartitassaagaluaq	naleqartitaq-SSAQ=U=GALUAQ<Absolut<ental
naleqartitassaagaluata	naleqartitaq-SSAQ=U=GALUAQ<ental<deres<Relativ
naleqartitassaagaluata	naleqartitaq-SSAQ=U=GALUAQ<ental<hans<Relativ
naleqartitassaagaluanni	naleqartitaq-SSAQ=U=GALUAQ<ental<min<Lokalis
naleqartitassaagalui	naleqartitaq-SSAQ=U=GALUAQ<flertal<deres<Absolut
naleqartitassaagaluanni	naleqartitaq-SSAQ=U=GALUAQ<flertal<min<Lokalis
nassuiarpaa	nassuiar<Indikativ<HanHam
nassuiartippaa	nassuiar+TIP<Indikativ<HanHam
nassuiartussaavaa	nassuiar+TUQ=SSAQ=U<Indikativ<HanHam
nujaq	nujaq<ental<Absolut
nujaata	nujaq<ental<hans<Relativ
nujanni	nujaq<ental<min<Lokalis
nujanni	nujaq<flertal<min<Lokalis
nujalerpaa	nujaq-LIR_nv<Indikativ<HanHam
nujalertippaa	nujaq-LIR_nv+TIP<Indikativ<HanHam
nujalertussaavaa	nujaq-LIR_nv+TUQ=SSAQ=U<Indikativ<HanHam
nujassaagaluaq	nujaq-SSAQ=U=GALUAQ<Absolut<ental
nujassaagaluata	nujaq-SSAQ=U=GALUAQ<ental<deres<Relativ
nujassaagaluata	nujaq-SSAQ=U=GALUAQ<ental<hans<Relativ
nujassaagaluanni	nujaq-SSAQ=U=GALUAQ<ental<min<Lokalis
nujassaagalui	nujaq-SSAQ=U=GALUAQ<flertal<deres<Absolut
nujassaagaluanni	nujaq-SSAQ=U=GALUAQ<flertal<min<Lokalis
nutaaq	nutaaq<ental<Absolut
paarivaa	paarә<Indikativ<HanHam
paaritippaa	paarә+TIP<Indikativ<HanHam
paarisussaavaa	paarә+TUQ=SSAQ=U<Indikativ<HanHam
pilersaarut	pilersaarut<ental<Absolut
pilersaarutaata	pilersaarut<ental<deres<Relativ
pilersaarutaata	pilersaarut<ental<hans<Relativ
pilersaarutaat	pilersaarut<flertal<deres<Absolut
pilersaarutinni	pilersaarut<flertal<min<Lokalis
pilersaarutilerpaa	pilersaarut-LIR_nv<Indikativ<HanHam
pilersaarutilertippaa	pilersaarut-LIR_nv+TIP<Indikativ<HanHam
pilersaarutissaagaluaq	pilersaarut-SSAQ=U=GALUAQ<Absolut<ental
pilersaarutissaagaluata	pilersaarut-SSAQ=U=GALUAQ<ental<deres<Relativ
pilersaarutissaagaluata	pilersaarut-SSAQ=U=GALUAQ<ental<hans<Relativ
pilersaarutissaagaluanni	pilersaarut-SSAQ=U=GALUAQ<ental<min<Lokalis
pilersaarutissaagalui	pilersaarut-SSAQ=U=GALUAQ<flertal<deres<Absolut
pilersaarutissaagaluanni	pilersaarut-SSAQ=U=GALUAQ<flertal<min<Lokalis
pingaarfik	pingaar+FIK<ental<Absolut
pingaarfiata	pingaar+FIK<ental<deres<Relativ
pingaarfiata	pingaar+FIK<ental<hans<Relativ
pingaarfinni	pingaar+FIK<ental<min<Lokalis
pingaarfinni	pingaar+FIK<flertal<min<Lokalis
pingaarfilerpaa	pingaar+FIK-LIR_nv<Indikativ<HanHam
pingaarfilertippaa	pingaar+FIK-LIR_nv+TIP<Indikativ<HanHam
pingaarfissaagaluata	pingaar+FIK-SSAQ=U=GALUAQ<ental<deres<Relativ
pingaarfissaagaluata	pingaar+FIK-SSAQ=U=GALUAQ<ental<hans<Relativ
pingaarfissaagaluanni	pingaar+FIK-SSAQ=U=GALUAQ<ental<min<Lokalis
pingaarfissaagalui	pingaar+FIK-SSAQ=U=GALUAQ<flertal<deres<Absolut
pingaarpa	pingaar<Interrogativ<han
pingaarnerpaaq	pingaar+NIRPAAQ<ental<Absolut
pingaarnerpaata	pingaar+NIRPAAQ<ental<deres<Relativ
pingaarnerpaata	pingaar+NIRPAAQ<ental<hans<Relativ
pingaarnerpaat	pingaar+NIRPAAQ<flertal<deres<Absolut
pingaarnerpaanni	pingaar+NIRPAAQ<flertal<min<Lokalis
pingaarnerpaalerpaa	pingaar+NIRPAAQ-LIR_nv<Indikativ<HanHam
pingaarnerpaalertippaa	pingaar+NIRPAAQ-LIR_nv+TIP<Indikativ<HanHam
pingaarnerpaalertussaavaa	pingaar+NIRPAAQ-LIR_nv+TUQ=SSAQ=U<Indikativ<HanHam
pingaarnerpaassaagaluata	pingaar+NIRPAAQ-SSAQ=U=GALUAQ<ental<deres<Relativ
pingaarnerpaassaagalui	pingaar+NIRPAAQ-SSAQ=U=GALUAQ<flertal<deres<Absolut
pingaarnerpaassaagaluanni	pingaar+NIRPAAQ-SSAQ=U=GALUAQ<flertal<min<Lokalis
pingaartippaa	pingaar+TIP<Indikativ<HanHam
pingaartussaaffik	pingaar+TUQ=SSAQ=U+FIK<ental<Absolut
pingaartussaaffiata	pingaar+TUQ=SSAQ=U+FIK<ental<hans<Relativ
pingaartussaaffissaagaluanni	pingaar+TUQ=SSAQ=U+FIK-SSAQ=U=GALUAQ<flertal<min<Lokalis
pingaartussaava	pingaar+TUQ=SSAQ=U<Interrogativ<han
pingaartussaanerpaaq	pingaar+TUQ=SSAQ=U+NIRPAAQ<ental<Absolut
pingaartussaanerpaassaagaluata	pingaar+TUQ=SSAQ=U+NIRPAAQ-SSAQ=U=GALUAQ<ental<deres<Relativ
pisimasoq	pisimasoq<ental<Absolut
pisimasuata	pisimasoq<ental<deres<Relativ
pisimasuata	pisimasoq<ental<hans<Relativ
pisimasunni	pisimasoq<ental<min<Lokalis
pisimasui	pisimasoq<flertal<deres<Absolut
pisimasunni	pisimasoq<flertal<min<Lokalis
pisimasulerpaa	pisimasoq-LIR_nv<Indikativ<HanHam
pisimasulertippaa	pisimasoq-LIR_nv+TIP<Indikativ<HanHam
pisimasulertussaavaa	pisimasoq-LIR_nv+TUQ=SSAQ=U<Indikativ<HanHam
pisimasussaagaluaq	pisimasoq-SSAQ=U=GALUAQ<Absolut<ental
pisimasussaagaluata	pisimasoq-SSAQ=U=GALUAQ<ental<hans<Relativ
pisimasussaagaluanni	pisimasoq-SSAQ=U=GALUAQ<ental<min<Lokalis
pisimasussaagalui	pisimasoq-SSAQ=U=GALUAQ<flertal<deres<Absolut
pisimasussaagaluanni	pisimasoq-SSAQ=U=GALUAQ<flertal<min<Lokalis
poortugaq	poortugaq<ental<Absolut
poortukkanni	poortugaq<ental<min<Lokalis
poortukkanni	poortugaq<flertal<min<Lokalis
poortugalerpaa	poortugaq-LIR_nv<Indikativ<HanHam
poortugalertippaa	poortugaq-LIR_nv+TIP<Indikativ<HanHam
poortugalertussaavaa	poortugaq-LIR_nv+TUQ=SSAQ=U<Indikativ<HanHam
poortugassaagaluaq	poortugaq-SSAQ=U=GALUAQ<Absolut<ental
poortugassaagaluata	poortugaq-SSAQ=U=GALUAQ<ental<deres<Relativ
poortugassaagaluata	poortugaq-SSAQ=U=GALUAQ<ental<hans<Relativ
poortugassaagaluanni	poortugaq-SSAQ=U=GALUAQ<ental<min<Lokalis
poortugassaagalui	poortugaq-SSAQ=U=GALUAQ<flertal<deres<Absolut
poortugassaagaluanni	poortugaq-SSAQ=U=GALUAQ<flertal<min<Lokalis
qulaa	qulә<Absolut<ental<hans
qulaata	qulә<ental<deres<Relativ
qulaata	qulә<ental<hans<Relativ
qulinni	qulә<ental<min<Lokalis
sakkutooqarfik	sakkutooqarfik<ental<Absolut
sakkutooqarfiata	sakkutooqarfik<ental<deres<Relativ
sakkutooqarfiata	sakkutooqarfik<ental<hans<Relativ
sakkutooqarfinni	sakkutooqarfik<ental<min<Lokalis
sakkutooqarfii	sakkutooqarfik<flertal<deres<Absolut
sakkutooqarfinni	sakkutooqarfik<flertal<min<Lokalis
sakkutooqarfilerpaa	sakkutooqarfik-LIR_nv<Indikativ<HanHam
sakkutooqarfilertippaa	sakkutooqarfik-LIR_nv+TIP<Indikativ<HanHam
sakkutooqarfilertussaavaa	sakkutooqarfik-LIR_nv+TUQ=SSAQ=U<Indikativ<HanHam
sakkutooqarfissaagaluaq	sakkutooqarfik-SSAQ=U=GALUAQ<Absolut<ental
sakkutooqarfissaagaluata	sakkutooqarfik-SSAQ=U=GALUAQ<ental<deres<Relativ
sakkutooqarfissaagaluata	sakkutooqarfik-SSAQ=U=GALUAQ<ental<hans<Relativ
sakkutooqarfissaagaluanni	sakkutooqarfik-SSAQ=U=GALUAQ<ental<min<Lokalis
sakkutooqarfissaagalui	sakkutooqarfik-SSAQ=U=GALUAQ<flertal<deres<Absolut
sakkutooqarfissaagaluanni	sakkutooqarfik-SSAQ=U=GALUAQ<flertal<min<Lokalis
sakkutooq	sakkutooq<ental<Absolut
sakkutuuata	sakkutooq<ental<deres<Relativ
sakkutuuata	sakkutooq<ental<hans<Relativ
sakkutuunni	sakkutooq<ental<min<Lokalis
sakkutuui	sakkutooq<flertal<deres<Absolut
sakkutuunni	sakkutooq<flertal<min<Lokalis
sakkutuulerpaa	sakkutooq-LIR_nv<Indikativ<HanHam
sakkutuulertippaa	sakkutooq-LIR_nv+TIP<Indikativ<HanHam
sakkutuulertussaavaa	sakkutooq-LIR_nv+TUQ=SSAQ=U<Indikativ<HanHam
sakkutuussaagaluaq	sakkutooq-SSAQ=U=GALUAQ<Absolut<ental
sakkutuussaagaluata	sakkutooq-SSAQ=U=GALUAQ<ental<deres<Relativ
sakkutuussaagaluata	sakkutooq-SSAQ=U=GALUAQ<ental<hans<Relativ
sakkutuussaagaluanni	sakkutooq-SSAQ=U=GALUAQ<ental<min<Lokalis
sakkutuussaagalui	sakkutooq-SSAQ=U=GALUAQ<flertal<deres<Absolut
sakkutuussaagaluanni	sakkutooq-SSAQ=U=GALUAQ<flertal<min<Lokalis
takisooq	takisooq<ental<Absolut
tamakku	tamakku<Pronomen<Absolut<flertal
tamanna	tamanna<Pronomen<Absolut<ental
ulapaarfik	ulapaar+FIK<ental<Absolut
ulapaarfiata	ulapaar+FIK<ental<deres<Relativ
ulapaarfiata	ulapaar+FIK<ental<hans<Relativ
ulapaarfinni	ulapaar+FIK<ental<min<Lokalis
ulapaarfii	ulapaar+FIK<flertal<deres<Absolut
ulapaarfinni	ulapaar+FIK<flertal<min<Lokalis
ulapaarfilerpaa	ulapaar+FIK-LIR_nv<Indikativ<HanHam
ulapaarfilertippaa	ulapaar+FIK-LIR_nv+TIP<Indikativ<HanHam
ulapaarfilertussaavaa	ulapaar+FIK-LIR_nv+TUQ=SSAQ=U<Indikativ<HanHam
ulapaarfissaagaluaq	ulapaar+FIK-SSAQ=U=GALUAQ<Absolut<ental
ulapaarfissaagaluata	ulapaar+FIK-SSAQ=U=GALUAQ<ental<deres<Relativ
ulapaarfissaagaluata	ulapaar+FIK-SSAQ=U=GALUAQ<ental<hans<Relativ
ulapaarfissaagaluanni	ulapaar+FIK-SSAQ=U=GALUAQ<ental<min<Lokalis
ulapaarfissaagalui	ulapaar+FIK-SSAQ=U=GALUAQ<flertal<deres<Absolut
ulapaarfissaagaluanni	ulapaar+FIK-SSAQ=U=GALUAQ<flertal<min<Lokalis
ulapaarpa	ulapaar<Interrogativ<han
ulapaarnerpaaq	ulapaar+NIRPAAQ<ental<Absolut
ulapaarnerpaata	ulapaar+NIRPAAQ<ental<deres<Relativ
ulapaarnerpaata	ulapaar+NIRPAAQ<ental<hans<Relativ
ulapaarnerpaanni	ulapaar+NIRPAAQ<ental<min<Lokalis
ulapaarnerpaat	ulapaar+NIRPAAQ<flertal<deres<Absolut
ulapaarnerpaanni	ulapaar+NIRPAAQ<flertal<min<Lokalis
ulapaarnerpaalerpaa	ulapaar+NIRPAAQ-LIR_nv<Indikativ<HanHam
ulapaarnerpaalertippaa	ulapaar+NIRPAAQ-LIR_nv+TIP<Indikativ<HanHam
ulapaarnerpaalertussaavaa	ulapaar+NIRPAAQ-LIR_nv+TUQ=SSAQ=U<Indikativ<HanHam
ulapaarnerpaassaagaluaq	ulapaar+NIRPAAQ-SSAQ=U=GALUAQ<Absolut<ental
ulapaarnerpaassaagaluata	ulapaar+NIRPAAQ-SSAQ=U=GALUAQ<ental<deres<Relativ
ulapaarnerpaassaagaluata	ulapaar+NIRPAAQ-SSAQ=U=GALUAQ<ental<hans<Relativ
ulapaarnerpaassaagaluanni	ulapaar+NIRPAAQ-SSAQ=U=GALUAQ<ental<min<Lokalis
ulapaarnerpaassaagalui	ulapaar+NIRPAAQ-SSAQ=U=GALUAQ<flertal<deres<Absolut
ulapaarnerpaassaagaluanni	ulapaar+NIRPAAQ-SSAQ=U=GALUAQ<flertal<min<Lokalis
ulapaartippaa	ulapaar+TIP<Indikativ<HanHam
ulapaartussaaffik	ulapaar+TUQ=SSAQ=U+FIK<ental<Absolut
ulapaartussaaffiata	ulapaar+TUQ=SSAQ=U+FIK<ental<deres<Relativ
ulapaartussaaffiata	ulapaar+TUQ=SSAQ=U+FIK<ental<hans<Relativ
ulapaartussaaffinni	ulapaar+TUQ=SSAQ=U+FIK<ental<min<Lokalis
ulapaartussaaffii	ulapaar+TUQ=SSAQ=U+FIK<flertal<deres<Absolut
ulapaartussaaffilerpaa	ulapaar+TUQ=SSAQ=U+FIK-LIR_nv<Indikativ<HanHam
ulapaartussaaffilertippaa	ulapaar+TUQ=SSAQ=U+FIK-LIR_nv+TIP<Indikativ<HanHam
ulapaartussaaffilertussaavaa	ulapaar+TUQ=SSAQ=U+FIK-LIR_nv+TUQ=SSAQ=U<Indikativ<HanHam
ulapaartussaaffissaagaluaq	ulapaar+TUQ=SSAQ=U+FIK-SSAQ=U=GALUAQ<Absolut<ental
ulapaartussaaffissaagaluata	ulapaar+TUQ=SSAQ=U+FIK-SSAQ=U=GALUAQ<ental<deres<Relativ
ulapaartussaaffissaagaluanni	ulapaar+TUQ=SSAQ=U+FIK-SSAQ=U=GALUAQ<ental<min<Lokalis
ulapaartussaaffissaagalui	ulapaar+TUQ=SSAQ=U+FIK-SSAQ=U=GALUAQ<flertal<deres<Absolut
ulapaartussaava	ulapaar+TUQ=SSAQ=U<Interrogativ<han
ulapaartussaanerpaaq	ulapaar+TUQ=SSAQ=U+NIRPAAQ<ental<Absolut
ulapaartussaanerpaata	ulapaar+TUQ=SSAQ=U+NIRPAAQ<ental<deres<Relativ
ulapaartussaanerpaata	ulapaar+TUQ=SSAQ=U+NIRPAAQ<ental<hans<Relativ
ulapaartussaanerpaanni	ulapaar+TUQ=SSAQ=U+NIRPAAQ<ental<min<Lokalis
ulapaartussaanerpaat	ulapaar+TUQ=SSAQ=U+NIRPAAQ<flertal<deres<Absolut
ulapaartussaanerpaanni	ulapaar+TUQ=SSAQ=U+NIRPAAQ<flertal<min<Lokalis
ulapaartussaanerpaalerpaa	ulapaar+TUQ=SSAQ=U+NIRPAAQ-LIR_nv<Indikativ<HanHam
ulapaartussaanerpaalertippaa	ulapaar+TUQ=SSAQ=U+NIRPAAQ-LIR_nv+TIP<Indikativ<HanHam
ulapaartussaanerpaalertussaavaa	ulapaar+TUQ=SSAQ=U+NIRPAAQ-LIR_nv+TUQ=SSAQ=U<Indikativ<HanHam
ulapaartussaanerpaassaagaluaq	ulapaar+TUQ=SSAQ=U+NIRPAAQ-SSAQ=U=GALUAQ<Absolut<ental
ulapaartussaanerpaassaagaluata	ulapaar+TUQ=SSAQ=U+NIRPAAQ-SSAQ=U=GALUAQ<ental<hans<Relativ
ulapaartussaanerpaassaagaluanni	ulapaar+TUQ=SSAQ=U+NIRPAAQ-SSAQ=U=GALUAQ<ental<min<Lokalis
ulapaartussaanerpaassaagalui	ulapaar+TUQ=SSAQ=U+NIRPAAQ-SSAQ=U=GALUAQ<flertal<deres<Absolut
