aappaatigut	aappaatigut<Partikel
atorfissaqartippatit	atorfissaqartip<Indikativ<DuDem
atorfissaqartippaa	atorfissaqartip<Indikativ<HanHam
atorfissaqartipparput	atorfissaqartip<Indikativ<ViHam
atorfissaqartilluinnarpatit	atorfissaqartip+LUINNAR<Indikativ<DuDem
atorfissaqartilluinnarpaa	atorfissaqartip+LUINNAR<Indikativ<HanHam
atorfissaqartilluinnarparput	atorfissaqartip+LUINNAR<Indikativ<ViHam
atorfissaqarteqaatit	atorfissaqartip-QӘ<Indikativ<DuDem
atorfissaqarteqaa	atorfissaqartip-QӘ<Indikativ<HanHam
atorfissaqarteqaarput	atorfissaqartip-QӘ<Indikativ<ViHam
atorfissaqartittariaqarpatit	atorfissaqartip+TARIAQAR<Indikativ<DuDem
atorfissaqartittariaqarpaa	atorfissaqartip+TARIAQAR<Indikativ<HanHam
atorfissaqartittariaqarparput	atorfissaqartip+TARIAQAR<Indikativ<ViHam
atorfissaqartittorujorujussuuatit	atorfissaqartip+TUQ=RUJUK=RUJUK=SUAQ=U<Indikativ<DuDem
atorfissaqartittorujorujussuuaa	atorfissaqartip+TUQ=RUJUK=RUJUK=SUAQ=U<Indikativ<HanHam
atorfissaqartittorujorujussuuarput	atorfissaqartip+TUQ=RUJUK=RUJUK=SUAQ=U<Indikativ<ViHam
atorfissaqartittorujussuuatit	atorfissaqartip+TUQ=RUJUK=SUAQ=U<Indikativ<DuDem
atorfissaqartittorujussuuaa	atorfissaqartip+TUQ=RUJUK=SUAQ=U<Indikativ<HanHam
atorfissaqartittorujussuuarput	atorfissaqartip+TUQ=RUJUK=SUAQ=U<Indikativ<ViHam
eqqarsartariaaseq	eqqarsartariaaseq<ental<Absolut
eqqarsartariaasiattut	eqqarsartariaaseq<ental<deres<Aequalis
eqqarsartariaatsimik	eqqarsartariaaseq<ental<Instrumentalis
eqqarsartariaatsimeerpoq	eqqarsartariaaseq<ental<Instrumentalis-IR<Indikativ<han
eqqarsartariaatsimeerluinnarpoq	eqqarsartariaaseq<ental<Instrumentalis-IR+LUINNAR<Indikativ<han
eqqarsartariaatsimeertariaqarpoq	eqqarsartariaaseq<ental<Instrumentalis-IR+TARIAQAR<Indikativ<han
eqqarsartariaatsiminik	eqqarsartariaaseq<ental<sin<Instrumentalis
eqqarsartariaatsinik	eqqarsartariaaseq<flertal<Instrumentalis
eqqarsartariaatsineerpoq	eqqarsartariaaseq<flertal<Instrumentalis-IR<Indikativ<han
eqqarsartariaatsineerluinnarpoq	eqqarsartariaaseq<flertal<Instrumentalis-IR+LUINNAR<Indikativ<han
eqqarsartariaatsineertariaqarpoq	eqqarsartariaaseq<flertal<Instrumentalis-IR+TARIAQAR<Indikativ<han
eqqarsartariaatsiminik	eqqarsartariaaseq<flertal<sin<Instrumentalis
eqqarsartariaasiku	eqqarsartariaaseq-KU<ental<Absolut
eqqarsartariaasikuattut	eqqarsartariaaseq-KU<ental<deres<Aequalis
eqqarsartariaasikumik	eqqarsartariaaseq-KU<ental<Instrumentalis
eqqarsartariaasikumeerluinnarpoq	eqqarsartariaaseq-KU<ental<Instrumentalis-IR+LUINNAR<Indikativ<han
eqqarsartariaasikumeertariaqarpoq	eqqarsartariaaseq-KU<ental<Instrumentalis-IR+TARIAQAR<Indikativ<han
eqqarsartariaasikuminik	eqqarsartariaaseq-KU<ental<sin<Instrumentalis
eqqarsartariaasikunik	eqqarsartariaaseq-KU<flertal<Instrumentalis
eqqarsartariaasikuneerpoq	eqqarsartariaaseq-KU<flertal<Instrumentalis-IR<Indikativ<han
eqqarsartariaasikuneerluinnarpoq	eqqarsartariaaseq-KU<flertal<Instrumentalis-IR+LUINNAR<Indikativ<han
eqqarsartariaasikuneertariaqarpoq	eqqarsartariaaseq-KU<flertal<Instrumentalis-IR+TARIAQAR<Indikativ<han
eqqarsartariaasikuminik	eqqarsartariaaseq-KU<flertal<sin<Instrumentalis
eqqarsartariaaserujuk	eqqarsartariaaseq-RUJUK<ental<Absolut
eqqarsartariaaserujuattut	eqqarsartariaaseq-RUJUK<ental<deres<Aequalis
eqqarsartariaaserujummik	eqqarsartariaaseq-RUJUK<ental<Instrumentalis
eqqarsartariaaserujummeerpoq	eqqarsartariaaseq-RUJUK<ental<Instrumentalis-IR<Indikativ<han
eqqarsartariaaserujummeerluinnarpoq	eqqarsartariaaseq-RUJUK<ental<Instrumentalis-IR+LUINNAR<Indikativ<han
eqqarsartariaaserujummeertariaqarpoq	eqqarsartariaaseq-RUJUK<ental<Instrumentalis-IR+TARIAQAR<Indikativ<han
eqqarsartariaaserujumminik	eqqarsartariaaseq-RUJUK<ental<sin<Instrumentalis
eqqarsartariaaserujunnik	eqqarsartariaaseq-RUJUK<flertal<Instrumentalis
eqqarsartariaaserujunneerpoq	eqqarsartariaaseq-RUJUK<flertal<Instrumentalis-IR<Indikativ<han
eqqarsartariaaserujunneertariaqarpoq	eqqarsartariaaseq-RUJUK<flertal<Instrumentalis-IR+TARIAQAR<Indikativ<han
eqqarsartariaaserujuminik	eqqarsartariaaseq-RUJUK<flertal<sin<Instrumentalis
eqqarsartariaaserujussuaq	eqqarsartariaaseq-RUJUK=SUAQ<ental<Absolut
eqqarsartariaaserujussuattut	eqqarsartariaaseq-RUJUK=SUAQ<ental<deres<Aequalis
eqqarsartariaaserujussuarmik	eqqarsartariaaseq-RUJUK=SUAQ<ental<Instrumentalis
eqqarsartariaaserujussuarmeerpoq	eqqarsartariaaseq-RUJUK=SUAQ<ental<Instrumentalis-IR<Indikativ<han
eqqarsartariaaserujussuarminik	eqqarsartariaaseq-RUJUK=SUAQ<ental<sin<Instrumentalis
eqqarsartariaaserujussuarneerpoq	eqqarsartariaaseq-RUJUK=SUAQ<flertal<Instrumentalis-IR<Indikativ<han
eqqarsartariaaserujussuarneerluinnarpoq	eqqarsartariaaseq-RUJUK=SUAQ<flertal<Instrumentalis-IR+LUINNAR<Indikativ<han
eqqarsartariaaserujussuarneertariaqarpoq	eqqarsartariaaseq-RUJUK=SUAQ<flertal<Instrumentalis-IR+TARIAQAR<Indikativ<han
eqqarsartariaaserujussuaminik	eqqarsartariaaseq-RUJUK=SUAQ<flertal<sin<Instrumentalis
erneq	erneq<ental<Absolut
ernerattut	erneq<ental<deres<Aequalis
ernerminik	erneq<ental<sin<Instrumentalis
ernernik	erneq<flertal<Instrumentalis
ernerneerpoq	erneq<flertal<Instrumentalis-IR<Indikativ<han
ernerneerluinnarpoq	erneq<flertal<Instrumentalis-IR+LUINNAR<Indikativ<han
ernerneertariaqarpoq	erneq<flertal<Instrumentalis-IR+TARIAQAR<Indikativ<han
erniminik	erneq<flertal<sin<Instrumentalis
erniku	erneq-KU<ental<Absolut
ernikuattut	erneq-KU<ental<deres<Aequalis
ernikumik	erneq-KU<ental<Instrumentalis
ernikumeerluinnarpoq	erneq-KU<ental<Instrumentalis-IR+LUINNAR<Indikativ<han
ernikumeertariaqarpoq	erneq-KU<ental<Instrumentalis-IR+TARIAQAR<Indikativ<han
ernikuminik	erneq-KU<ental<sin<Instrumentalis
ernikunik	erneq-KU<flertal<Instrumentalis
ernikuneerpoq	erneq-KU<flertal<Instrumentalis-IR<Indikativ<han
ernikuneerluinnarpoq	erneq-KU<flertal<Instrumentalis-IR+LUINNAR<Indikativ<han
ernikuneertariaqarpoq	erneq-KU<flertal<Instrumentalis-IR+TARIAQAR<Indikativ<han
ernikuminik	erneq-KU<flertal<sin<Instrumentalis
ernerujuk	erneq-RUJUK<ental<Absolut
ernerujuattut	erneq-RUJUK<ental<deres<Aequalis
ernerujummik	erneq-RUJUK<ental<Instrumentalis
ernerujummeerpoq	erneq-RUJUK<ental<Instrumentalis-IR<Indikativ<han
ernerujummeerluinnarpoq	erneq-RUJUK<ental<Instrumentalis-IR+LUINNAR<Indikativ<han
ernerujunnik	erneq-RUJUK<flertal<Instrumentalis
ernerujunneerpoq	erneq-RUJUK<flertal<Instrumentalis-IR<Indikativ<han
ernerujunneerluinnarpoq	erneq-RUJUK<flertal<Instrumentalis-IR+LUINNAR<Indikativ<han
ernerujuminik	erneq-RUJUK<flertal<sin<Instrumentalis
ernerujussuaq	erneq-RUJUK=SUAQ<ental<Absolut
ernerujussuattut	erneq-RUJUK=SUAQ<ental<deres<Aequalis
ernerujussuarmeerpoq	erneq-RUJUK=SUAQ<ental<Instrumentalis-IR<Indikativ<han
ernerujussuarmeerluinnarpoq	erneq-RUJUK=SUAQ<ental<Instrumentalis-IR+LUINNAR<Indikativ<han
ernerujussuarmeertariaqarpoq	erneq-RUJUK=SUAQ<ental<Instrumentalis-IR+TARIAQAR<Indikativ<han
ernerujussuarnik	erneq-RUJUK=SUAQ<flertal<Instrumentalis
ernerujussuarneerpoq	erneq-RUJUK=SUAQ<flertal<Instrumentalis-IR<Indikativ<han
ernerujussuarneerluinnarpoq	erneq-RUJUK=SUAQ<flertal<Instrumentalis-IR+LUINNAR<Indikativ<han
ernerujussuaminik	erneq-RUJUK=SUAQ<flertal<sin<Instrumentalis
ersivoq	ersi<Indikativ<han
ersilluinnarpoq	ersi+LUINNAR<Indikativ<han
erseqaaq	ersi-QӘ<Indikativ<han
ersisariaqarpoq	ersi+TARIAQAR<Indikativ<han
ersisorujorujussuuvoq	ersi+TUQ=RUJUK=RUJUK=SUAQ=U<Indikativ<han
ersisorujussuuvoq	ersi+TUQ=RUJUK=SUAQ=U<Indikativ<han
ilami	ilami<Partikel
ilimagivatit	ilimagә<Indikativ<DuDem
ilimagivarput	ilimagә<Indikativ<ViHam
ilimagiluinnarpatit	ilimagә+LUINNAR<Indikativ<DuDem
ilimagiluinnarpaa	ilimagә+LUINNAR<Indikativ<HanHam
ilimagiluinnarparput	ilimagә+LUINNAR<Indikativ<ViHam
ilimageqaatit	ilimagә-QӘ<Indikativ<DuDem
ilimageqaa	ilimagә-QӘ<Indikativ<HanHam
ilimageqaarput	ilimagә-QӘ<Indikativ<ViHam
ilimagisariaqarpatit	ilimagә+TARIAQAR<Indikativ<DuDem
ilimagisariaqarpaa	ilimagә+TARIAQAR<Indikativ<HanHam
ilimagisariaqarparput	ilimagә+TARIAQAR<Indikativ<ViHam
ilimagisorujorujussuuatit	ilimagә+TUQ=RUJUK=RUJUK=SUAQ=U<Indikativ<DuDem
ilimagisorujorujussuuaa	ilimagә+TUQ=RUJUK=RUJUK=SUAQ=U<Indikativ<HanHam
ilimagisorujorujussuuarput	ilimagә+TUQ=RUJUK=RUJUK=SUAQ=U<Indikativ<ViHam
ilimagisorujussuuatit	ilimagә+TUQ=RUJUK=SUAQ=U<Indikativ<DuDem
ilimagisorujussuuaa	ilimagә+TUQ=RUJUK=SUAQ=U<Indikativ<HanHam
ilimagisorujussuuarput	ilimagә+TUQ=RUJUK=SUAQ=U<Indikativ<ViHam
innaallagissiorfik	innaallagissiorfik<ental<Absolut
innaallagissiorfiattut	innaallagissiorfik<ental<deres<Aequalis
innaallagissiorfimmik	innaallagissiorfik<ental<Instrumentalis
innaallagissiorfimmeerluinnarpoq	innaallagissiorfik<ental<Instrumentalis-IR+LUINNAR<Indikativ<han
innaallagissiorfimmeertariaqarpoq	innaallagissiorfik<ental<Instrumentalis-IR+TARIAQAR<Indikativ<han
innaallagissiorfimminik	innaallagissiorfik<ental<sin<Instrumentalis
innaallagissiorfinnik	innaallagissiorfik<flertal<Instrumentalis
innaallagissiorfinneerpoq	innaallagissiorfik<flertal<Instrumentalis-IR<Indikativ<han
innaallagissiorfinneerluinnarpoq	innaallagissiorfik<flertal<Instrumentalis-IR+LUINNAR<Indikativ<han
innaallagissiorfinneertariaqarpoq	innaallagissiorfik<flertal<Instrumentalis-IR+TARIAQAR<Indikativ<han
innaallagissiorfiminik	innaallagissiorfik<flertal<sin<Instrumentalis
innaallagissiorfiku	innaallagissiorfik-KU<ental<Absolut
innaallagissiorfikuattut	innaallagissiorfik-KU<ental<deres<Aequalis
innaallagissiorfikumik	innaallagissiorfik-KU<ental<Instrumentalis
innaallagissiorfikumeerluinnarpoq	innaallagissiorfik-KU<ental<Instrumentalis-IR+LUINNAR<Indikativ<han
innaallagissiorfikunik	innaallagissiorfik-KU<flertal<Instrumentalis
innaallagissiorfikuneerpoq	innaallagissiorfik-KU<flertal<Instrumentalis-IR<Indikativ<han
innaallagissiorfikuneerluinnarpoq	innaallagissiorfik-KU<flertal<Instrumentalis-IR+LUINNAR<Indikativ<han
innaallagissiorfikuminik	innaallagissiorfik-KU<flertal<sin<Instrumentalis
innaallagissiorferujuk	innaallagissiorfik-RUJUK<ental<Absolut
innaallagissiorferujuattut	innaallagissiorfik-RUJUK<ental<deres<Aequalis
innaallagissiorferujummik	innaallagissiorfik-RUJUK<ental<Instrumentalis
innaallagissiorferujummeerpoq	innaallagissiorfik-RUJUK<ental<Instrumentalis-IR<Indikativ<han
innaallagissiorferujummeerluinnarpoq	innaallagissiorfik-RUJUK<ental<Instrumentalis-IR+LUINNAR<Indikativ<han
innaallagissiorferujummeertariaqarpoq	innaallagissiorfik-RUJUK<ental<Instrumentalis-IR+TARIAQAR<Indikativ<han
innaallagissiorferujumminik	innaallagissiorfik-RUJUK<ental<sin<Instrumentalis
innaallagissiorferujunnik	innaallagissiorfik-RUJUK<flertal<Instrumentalis
innaallagissiorferujunneerpoq	innaallagissiorfik-RUJUK<flertal<Instrumentalis-IR<Indikativ<han
innaallagissiorferujunneerluinnarpoq	innaallagissiorfik-RUJUK<flertal<Instrumentalis-IR+LUINNAR<Indikativ<han
innaallagissiorferujunneertariaqarpoq	innaallagissiorfik-RUJUK<flertal<Instrumentalis-IR+TARIAQAR<Indikativ<han
innaallagissiorferujuminik	innaallagissiorfik-RUJUK<flertal<sin<Instrumentalis
innaallagissiorferujussuaq	innaallagissiorfik-RUJUK=SUAQ<ental<Absolut
innaallagissiorferujussuattut	innaallagissiorfik-RUJUK=SUAQ<ental<deres<Aequalis
innaallagissiorferujussuarmik	innaallagissiorfik-RUJUK=SUAQ<ental<Instrumentalis
innaallagissiorferujussuarmeerpoq	innaallagissiorfik-RUJUK=SUAQ<ental<Instrumentalis-IR<Indikativ<han
innaallagissiorferujussuarmeertariaqarpoq	innaallagissiorfik-RUJUK=SUAQ<ental<Instrumentalis-IR+TARIAQAR<Indikativ<han
innaallagissiorferujussuarminik	innaallagissiorfik-RUJUK=SUAQ<ental<sin<Instrumentalis
innaallagissiorferujussuarnik	innaallagissiorfik-RUJUK=SUAQ<flertal<Instrumentalis
innaallagissiorferujussuarneerluinnarpoq	innaallagissiorfik-RUJUK=SUAQ<flertal<Instrumentalis-IR+LUINNAR<Indikativ<han
innaallagissiorferujussuaminik	innaallagissiorfik-RUJUK=SUAQ<flertal<sin<Instrumentalis
isi	isә<ental<Absolut
isaattut	isә<ental<deres<Aequalis
isimik	isә<ental<Instrumentalis
isimeerluinnarpoq	isә<ental<Instrumentalis-IR+LUINNAR<Indikativ<han
isimeertariaqarpoq	isә<ental<Instrumentalis-IR+TARIAQAR<Indikativ<han
isiminik	isә<ental<sin<Instrumentalis
isinik	isә<flertal<Instrumentalis
isineerpoq	isә<flertal<Instrumentalis-IR<Indikativ<han
isineerluinnarpoq	isә<flertal<Instrumentalis-IR+LUINNAR<Indikativ<han
isineertariaqarpoq	isә<flertal<Instrumentalis-IR+TARIAQAR<Indikativ<han
isiminik	isә<flertal<sin<Instrumentalis
isiku	isә-KU<ental<Absolut
isikumeertariaqarpoq	isә-KU<ental<Instrumentalis-IR+TARIAQAR<Indikativ<han
isikuminik	isә-KU<ental<sin<Instrumentalis
isikunik	isә-KU<flertal<Instrumentalis
isikuneerpoq	isә-KU<flertal<Instrumentalis-IR<Indikativ<han
isikuneerluinnarpoq	isә-KU<flertal<Instrumentalis-IR+LUINNAR<Indikativ<han
isikuneertariaqarpoq	isә-KU<flertal<Instrumentalis-IR+TARIAQAR<Indikativ<han
isikuminik	isә-KU<flertal<sin<Instrumentalis
iserujuk	isә-RUJUK<ental<Absolut
iserujuattut	isә-RUJUK<ental<deres<Aequalis
iserujummik	isә-RUJUK<ental<Instrumentalis
iserujummeerluinnarpoq	isә-RUJUK<ental<Instrumentalis-IR+LUINNAR<Indikativ<han
iserujummeertariaqarpoq	isә-RUJUK<ental<Instrumentalis-IR+TARIAQAR<Indikativ<han
iserujumminik	isә-RUJUK<ental<sin<Instrumentalis
iserujunnik	isә-RUJUK<flertal<Instrumentalis
iserujunneerluinnarpoq	isә-RUJUK<flertal<Instrumentalis-IR+LUINNAR<Indikativ<han
iserujunneertariaqarpoq	isә-RUJUK<flertal<Instrumentalis-IR+TARIAQAR<Indikativ<han
iserujuminik	isә-RUJUK<flertal<sin<Instrumentalis
iserujussuaq	isә-RUJUK=SUAQ<ental<Absolut
iserujussuattut	isә-RUJUK=SUAQ<ental<deres<Aequalis
iserujussuarmeerpoq	isә-RUJUK=SUAQ<ental<Instrumentalis-IR<Indikativ<han
iserujussuarmeerluinnarpoq	isә-RUJUK=SUAQ<ental<Instrumentalis-IR+LUINNAR<Indikativ<han
iserujussuarmeertariaqarpoq	isә-RUJUK=SUAQ<ental<Instrumentalis-IR+TARIAQAR<Indikativ<han
iserujussuarminik	isә-RUJUK=SUAQ<ental<sin<Instrumentalis
iserujussuarnik	isә-RUJUK=SUAQ<flertal<Instrumentalis
iserujussuarneerluinnarpoq	isә-RUJUK=SUAQ<flertal<Instrumentalis-IR+LUINNAR<Indikativ<han
iserujussuarneertariaqarpoq	isә-RUJUK=SUAQ<flertal<Instrumentalis-IR+TARIAQAR<Indikativ<han
iserujussuaminik	isә-RUJUK=SUAQ<flertal<sin<Instrumentalis
nakkarpoq	nakkar<Indikativ<han
nakkarluinnarpoq	nakkar+LUINNAR<Indikativ<han
nakkaqaaq	nakkar-QӘ<Indikativ<han
nakkartariaqarpoq	nakkar+TARIAQAR<Indikativ<han
nakkartorujorujussuuvoq	nakkar+TUQ=RUJUK=RUJUK=SUAQ=U<Indikativ<han
nakkartorujussuuvoq	nakkar+TUQ=RUJUK=SUAQ=U<Indikativ<han
nillerpoq	niller<Indikativ<han
nillerluinnarpoq	niller+LUINNAR<Indikativ<han
nilleqaaq	niller-QӘ<Indikativ<han
nillertariaqarpoq	niller+TARIAQAR<Indikativ<han
nillertorujorujussuuvoq	niller+TUQ=RUJUK=RUJUK=SUAQ=U<Indikativ<han
nillertorujussuuvoq	niller+TUQ=RUJUK=SUAQ=U<Indikativ<han
nuannarivatit	nuannarә<Indikativ<DuDem
nuannarivaa	nuannarә<Indikativ<HanHam
nuannarivarput	nuannarә<Indikativ<ViHam
nuannariluinnarpatit	nuannarә+LUINNAR<Indikativ<DuDem
nuannariluinnarpaa	nuannarә+LUINNAR<Indikativ<HanHam
nuannariluinnarparput	nuannarә+LUINNAR<Indikativ<ViHam
nuannareqaatit	nuannarә-QӘ<Indikativ<DuDem
nuannareqaa	nuannarә-QӘ<Indikativ<HanHam
nuannareqaarput	nuannarә-QӘ<Indikativ<ViHam
nuannarisariaqarpatit	nuannarә+TARIAQAR<Indikativ<DuDem
nuannarisariaqarpaa	nuannarә+TARIAQAR<Indikativ<HanHam
nuannarisariaqarparput	nuannarә+TARIAQAR<Indikativ<ViHam
nuannarisorujorujussuuatit	nuannarә+TUQ=RUJUK=RUJUK=SUAQ=U<Indikativ<DuDem
nuannarisorujorujussuuaa	nuannarә+TUQ=RUJUK=RUJUK=SUAQ=U<Indikativ<HanHam
nuannarisorujorujussuuarput	nuannarә+TUQ=RUJUK=RUJUK=SUAQ=U<Indikativ<ViHam
nuannarisorujussuuatit	nuannarә+TUQ=RUJUK=SUAQ=U<Indikativ<DuDem
nuannarisorujussuuaa	nuannarә+TUQ=RUJUK=SUAQ=U<Indikativ<HanHam
nuannarisorujussuuarput	nuannarә+TUQ=RUJUK=SUAQ=U<Indikativ<ViHam
nukik	nukik<ental<Absolut
nukiattut	nukik<ental<deres<Aequalis
nukinga	nukik<ental<hans<Absolut
nukingani	nukik<ental<hans<Lokalis
nukingata	nukik<ental<hans<Relativ
nukimmik	nukik<ental<Instrumentalis
nukimmeerluinnarpoq	nukik<ental<Instrumentalis-IR+LUINNAR<Indikativ<han
nukimmeertariaqarpoq	nukik<ental<Instrumentalis-IR+TARIAQAR<Indikativ<han
nukimminik	nukik<ental<sin<Instrumentalis
nukinnik	nukik<flertal<Instrumentalis
nukinneerpoq	nukik<flertal<Instrumentalis-IR<Indikativ<han
nukinneerluinnarpoq	nukik<flertal<Instrumentalis-IR+LUINNAR<Indikativ<han
nukinneertariaqarpoq	nukik<flertal<Instrumentalis-IR+TARIAQAR<Indikativ<han
nukiminik	nukik<flertal<sin<Instrumentalis
nukiku	nukik-KU<ental<Absolut
nukikuattut	nukik-KU<ental<deres<Aequalis
nukikumik	nukik-KU<ental<Instrumentalis
nukikumeerpoq	nukik-KU<ental<Instrumentalis-IR<Indikativ<han
nukikumeerluinnarpoq	nukik-KU<ental<Instrumentalis-IR+LUINNAR<Indikativ<han
nukikumeertariaqarpoq	nukik-KU<ental<Instrumentalis-IR+TARIAQAR<Indikativ<han
nukikuneertariaqarpoq	nukik-KU<flertal<Instrumentalis-IR+TARIAQAR<Indikativ<han
nukikuminik	nukik-KU<flertal<sin<Instrumentalis
nukerujuk	nukik-RUJUK<ental<Absolut
nukerujuattut	nukik-RUJUK<ental<deres<Aequalis
nukerujummik	nukik-RUJUK<ental<Instrumentalis
nukerujummeerpoq	nukik-RUJUK<ental<Instrumentalis-IR<Indikativ<han
nukerujummeerluinnarpoq	nukik-RUJUK<ental<Instrumentalis-IR+LUINNAR<Indikativ<han
nukerujummeertariaqarpoq	nukik-RUJUK<ental<Instrumentalis-IR+TARIAQAR<Indikativ<han
nukerujumminik	nukik-RUJUK<ental<sin<Instrumentalis
nukerujunnik	nukik-RUJUK<flertal<Instrumentalis
nukerujunneerpoq	nukik-RUJUK<flertal<Instrumentalis-IR<Indikativ<han
nukerujunneerluinnarpoq	nukik-RUJUK<flertal<Instrumentalis-IR+LUINNAR<Indikativ<han
nukerujunneertariaqarpoq	nukik-RUJUK<flertal<Instrumentalis-IR+TARIAQAR<Indikativ<han
nukerujuminik	nukik-RUJUK<flertal<sin<Instrumentalis
nukerujussuaq	nukik-RUJUK=SUAQ<ental<Absolut
nukerujussuattut	nukik-RUJUK=SUAQ<ental<deres<Aequalis
nukerujussuarmeerpoq	nukik-RUJUK=SUAQ<ental<Instrumentalis-IR<Indikativ<han
nukerujussuarnik	nukik-RUJUK=SUAQ<flertal<Instrumentalis
nukerujussuarneertariaqarpoq	nukik-RUJUK=SUAQ<flertal<Instrumentalis-IR+TARIAQAR<Indikativ<han
nukerujussuaminik	nukik-RUJUK=SUAQ<flertal<sin<Instrumentalis
oqaluttuaq	oqaluttuaq<ental<Absolut
oqaluttuaattut	oqaluttuaq<ental<deres<Aequalis
oqaluttuamik	oqaluttuaq<ental<Instrumentalis
oqaluttuameerpoq	oqaluttuaq<ental<Instrumentalis-IR<Indikativ<han
oqaluttuameerluinnarpoq	oqaluttuaq<ental<Instrumentalis-IR+LUINNAR<Indikativ<han
oqaluttuameertariaqarpoq	oqaluttuaq<ental<Instrumentalis-IR+TARIAQAR<Indikativ<han
oqaluttuaminik	oqaluttuaq<ental<sin<Instrumentalis
oqaluttuanik	oqaluttuaq<flertal<Instrumentalis
oqaluttuaneerpoq	oqaluttuaq<flertal<Instrumentalis-IR<Indikativ<han
oqaluttuaneerluinnarpoq	oqaluttuaq<flertal<Instrumentalis-IR+LUINNAR<Indikativ<han
oqaluttuaneertariaqarpoq	oqaluttuaq<flertal<Instrumentalis-IR+TARIAQAR<Indikativ<han
oqaluttuaminik	oqaluttuaq<flertal<sin<Instrumentalis
oqaluttuaku	oqaluttuaq-KU<ental<Absolut
oqaluttuakuattut	oqaluttuaq-KU<ental<deres<Aequalis
oqaluttuakumik	oqaluttuaq-KU<ental<Instrumentalis
oqaluttuakumeerpoq	oqaluttuaq-KU<ental<Instrumentalis-IR<Indikativ<han
oqaluttuakumeerluinnarpoq	oqaluttuaq-KU<ental<Instrumentalis-IR+LUINNAR<Indikativ<han
oqaluttuakumeertariaqarpoq	oqaluttuaq-KU<ental<Instrumentalis-IR+TARIAQAR<Indikativ<han
oqaluttuakuminik	oqaluttuaq-KU<ental<sin<Instrumentalis
oqaluttuakunik	oqaluttuaq-KU<flertal<Instrumentalis
oqaluttuakuneerpoq	oqaluttuaq-KU<flertal<Instrumentalis-IR<Indikativ<han
oqaluttuakuneerluinnarpoq	oqaluttuaq-KU<flertal<Instrumentalis-IR+LUINNAR<Indikativ<han
oqaluttuakuneertariaqarpoq	oqaluttuaq-KU<flertal<Instrumentalis-IR+TARIAQAR<Indikativ<han
oqaluttuakuminik	oqaluttuaq-KU<flertal<sin<Instrumentalis
oqaluttuarujuk	oqaluttuaq-RUJUK<ental<Absolut
oqaluttuarujuattut	oqaluttuaq-RUJUK<ental<deres<Aequalis
oqaluttuarujummik	oqaluttuaq-RUJUK<ental<Instrumentalis
oqaluttuarujummeerpoq	oqaluttuaq-RUJUK<ental<Instrumentalis-IR<Indikativ<han
oqaluttuarujummeerluinnarpoq	oqaluttuaq-RUJUK<ental<Instrumentalis-IR+LUINNAR<Indikativ<han
oqaluttuarujummeertariaqarpoq	oqaluttuaq-RUJUK<ental<Instrumentalis-IR+TARIAQAR<Indikativ<han
oqaluttuarujumminik	oqaluttuaq-RUJUK<ental<sin<Instrumentalis
oqaluttuarujunnik	oqaluttuaq-RUJUK<flertal<Instrumentalis
oqaluttuarujunneerpoq	oqaluttuaq-RUJUK<flertal<Instrumentalis-IR<Indikativ<han
oqaluttuarujunneerluinnarpoq	oqaluttuaq-RUJUK<flertal<Instrumentalis-IR+LUINNAR<Indikativ<han
oqaluttuarujunneertariaqarpoq	oqaluttuaq-RUJUK<flertal<Instrumentalis-IR+TARIAQAR<Indikativ<han
oqaluttuarujuminik	oqaluttuaq-RUJUK<flertal<sin<Instrumentalis
oqaluttuarujussuaq	oqaluttuaq-RUJUK=SUAQ<ental<Absolut
oqaluttuarujussuattut	oqaluttuaq-RUJUK=SUAQ<ental<deres<Aequalis
oqaluttuarujussuarmik	oqaluttuaq-RUJUK=SUAQ<ental<Instrumentalis
oqaluttuarujussuarmeerpoq	oqaluttuaq-RUJUK=SUAQ<ental<Instrumentalis-IR<Indikativ<han
oqaluttuarujussuarmeerluinnarpoq	oqaluttuaq-RUJUK=SUAQ<ental<Instrumentalis-IR+LUINNAR<Indikativ<han
oqaluttuarujussuarmeertariaqarpoq	oqaluttuaq-RUJUK=SUAQ<ental<Instrumentalis-IR+TARIAQAR<Indikativ<han
oqaluttuarujussuarminik	oqaluttuaq-RUJUK=SUAQ<ental<sin<Instrumentalis
oqaluttuarujussuarnik	oqaluttuaq-RUJUK=SUAQ<flertal<Instrumentalis
oqaluttuarujussuarneerpoq	oqaluttuaq-RUJUK=SUAQ<flertal<Instrumentalis-IR<Indikativ<han
oqaluttuarujussuarneerluinnarpoq	oqaluttuaq-RUJUK=SUAQ<flertal<Instrumentalis-IR+LUINNAR<Indikativ<han
oqaluttuarujussuarneertariaqarpoq	oqaluttuaq-RUJUK=SUAQ<flertal<Instrumentalis-IR+TARIAQAR<Indikativ<han
oqaluttuarujussuaminik	oqaluttuaq-RUJUK=SUAQ<flertal<sin<Instrumentalis
pavani	pavani<Partikel
qaartartoq	qaartartoq<ental<Absolut
qaartartuattut	qaartartoq<ental<deres<Aequalis
qaartartumik	qaartartoq<ental<Instrumentalis
qaartartumeerpoq	qaartartoq<ental<Instrumentalis-IR<Indikativ<han
qaartartumeerluinnarpoq	qaartartoq<ental<Instrumentalis-IR+LUINNAR<Indikativ<han
qaartartuminik	qaartartoq<ental<sin<Instrumentalis
qaartartunik	qaartartoq<flertal<Instrumentalis
qaartartuneerpoq	qaartartoq<flertal<Instrumentalis-IR<Indikativ<han
qaartartuneerluinnarpoq	qaartartoq<flertal<Instrumentalis-IR+LUINNAR<Indikativ<han
qaartartuneertariaqarpoq	qaartartoq<flertal<Instrumentalis-IR+TARIAQAR<Indikativ<han
qaartartuminik	qaartartoq<flertal<sin<Instrumentalis
qaartartuku	qaartartoq-KU<ental<Absolut
qaartartukuattut	qaartartoq-KU<ental<deres<Aequalis
qaartartukumik	qaartartoq-KU<ental<Instrumentalis
qaartartukumeerpoq	qaartartoq-KU<ental<Instrumentalis-IR<Indikativ<han
qaartartukumeerluinnarpoq	qaartartoq-KU<ental<Instrumentalis-IR+LUINNAR<Indikativ<han
qaartartukuminik	qaartartoq-KU<ental<sin<Instrumentalis
qaartartukunik	qaartartoq-KU<flertal<Instrumentalis
qaartartukuneerpoq	qaartartoq-KU<flertal<Instrumentalis-IR<Indikativ<han
qaartartukuneerluinnarpoq	qaartartoq-KU<flertal<Instrumentalis-IR+LUINNAR<Indikativ<han
qaartartukuneertariaqarpoq	qaartartoq-KU<flertal<Instrumentalis-IR+TARIAQAR<Indikativ<han
qaartartukuminik	qaartartoq-KU<flertal<sin<Instrumentalis
qaartartorujuk	qaartartoq-RUJUK<ental<Absolut
qaartartorujuattut	qaartartoq-RUJUK<ental<deres<Aequalis
qaartartorujummik	qaartartoq-RUJUK<ental<Instrumentalis
qaartartorujummeerpoq	qaartartoq-RUJUK<ental<Instrumentalis-IR<Indikativ<han
qaartartorujummeerluinnarpoq	qaartartoq-RUJUK<ental<Instrumentalis-IR+LUINNAR<Indikativ<han
qaartartorujummeertariaqarpoq	qaartartoq-RUJUK<ental<Instrumentalis-IR+TARIAQAR<Indikativ<han
qaartartorujumminik	qaartartoq-RUJUK<ental<sin<Instrumentalis
qaartartorujunnik	qaartartoq-RUJUK<flertal<Instrumentalis
qaartartorujunneerpoq	qaartartoq-RUJUK<flertal<Instrumentalis-IR<Indikativ<han
qaartartorujunneerluinnarpoq	qaartartoq-RUJUK<flertal<Instrumentalis-IR+LUINNAR<Indikativ<han
qaartartorujunneertariaqarpoq	qaartartoq-RUJUK<flertal<Instrumentalis-IR+TARIAQAR<Indikativ<han
qaartartorujuminik	qaartartoq-RUJUK<flertal<sin<Instrumentalis
qaartartorujussuaq	qaartartoq-RUJUK=SUAQ<ental<Absolut
qaartartorujussuattut	qaartartoq-RUJUK=SUAQ<ental<deres<Aequalis
qaartartorujussuarmeerluinnarpoq	qaartartoq-RUJUK=SUAQ<ental<Instrumentalis-IR+LUINNAR<Indikativ<han
qaartartorujussuarminik	qaartartoq-RUJUK=SUAQ<ental<sin<Instrumentalis
qaartartorujussuarneerpoq	qaartartoq-RUJUK=SUAQ<flertal<Instrumentalis-IR<Indikativ<han
qaartartorujussuarneerluinnarpoq	qaartartoq-RUJUK=SUAQ<flertal<Instrumentalis-IR+LUINNAR<Indikativ<han
qaartartorujussuarneertariaqarpoq	qaartartoq-RUJUK=SUAQ<flertal<Instrumentalis-IR+TARIAQAR<Indikativ<han
qaartartorujussuaminik	qaartartoq-RUJUK=SUAQ<flertal<sin<Instrumentalis
qimarnguik	qimarnguik<ental<Absolut
qimarnguiattut	qimarnguik<ental<deres<Aequalis
qimarnguimmik	qimarnguik<ental<Instrumentalis
qimarnguimmeerpoq	qimarnguik<ental<Instrumentalis-IR<Indikativ<han
qimarnguimmeertariaqarpoq	qimarnguik<ental<Instrumentalis-IR+TARIAQAR<Indikativ<han
qimarnguimminik	qimarnguik<ental<sin<Instrumentalis
qimarnguinnik	qimarnguik<flertal<Instrumentalis
qimarnguinneerpoq	qimarnguik<flertal<Instrumentalis-IR<Indikativ<han
qimarnguinneerluinnarpoq	qimarnguik<flertal<Instrumentalis-IR+LUINNAR<Indikativ<han
qimarnguinneertariaqarpoq	qimarnguik<flertal<Instrumentalis-IR+TARIAQAR<Indikativ<han
qimarnguiminik	qimarnguik<flertal<sin<Instrumentalis
qimarnguiku	qimarnguik-KU<ental<Absolut
qimarnguikuattut	qimarnguik-KU<ental<deres<Aequalis
qimarnguikunik	qimarnguik-KU<flertal<Instrumentalis
qimarnguikuneertariaqarpoq	qimarnguik-KU<flertal<Instrumentalis-IR+TARIAQAR<Indikativ<han
qimarnguikuminik	qimarnguik-KU<flertal<sin<Instrumentalis
qimarnguerujuk	qimarnguik-RUJUK<ental<Absolut
qimarnguerujuattut	qimarnguik-RUJUK<ental<deres<Aequalis
qimarnguerujummeerpoq	qimarnguik-RUJUK<ental<Instrumentalis-IR<Indikativ<han
qimarnguerujummeerluinnarpoq	qimarnguik-RUJUK<ental<Instrumentalis-IR+LUINNAR<Indikativ<han
qimarnguerujummeertariaqarpoq	qimarnguik-RUJUK<ental<Instrumentalis-IR+TARIAQAR<Indikativ<han
qimarnguerujumminik	qimarnguik-RUJUK<ental<sin<Instrumentalis
qimarnguerujunnik	qimarnguik-RUJUK<flertal<Instrumentalis
qimarnguerujunneerluinnarpoq	qimarnguik-RUJUK<flertal<Instrumentalis-IR+LUINNAR<Indikativ<han
qimarnguerujunneertariaqarpoq	qimarnguik-RUJUK<flertal<Instrumentalis-IR+TARIAQAR<Indikativ<han
qimarnguerujuminik	qimarnguik-RUJUK<flertal<sin<Instrumentalis
qimarnguerujussuaq	qimarnguik-RUJUK=SUAQ<ental<Absolut
qimarnguerujussuattut	qimarnguik-RUJUK=SUAQ<ental<deres<Aequalis
qimarnguerujussuarmik	qimarnguik-RUJUK=SUAQ<ental<Instrumentalis
qimarnguerujussuarminik	qimarnguik-RUJUK=SUAQ<ental<sin<Instrumentalis
qimarnguerujussuarnik	qimarnguik-RUJUK=SUAQ<flertal<Instrumentalis
qimarnguerujussuarneerluinnarpoq	qimarnguik-RUJUK=SUAQ<flertal<Instrumentalis-IR+LUINNAR<Indikativ<han
qimarnguerujussuarneertariaqarpoq	qimarnguik-RUJUK=SUAQ<flertal<Instrumentalis-IR+TARIAQAR<Indikativ<han
qimarnguerujussuaminik	qimarnguik-RUJUK=SUAQ<flertal<sin<Instrumentalis
qiteq	qiteq<ental<Absolut
qitiattut	qiteq<ental<deres<Aequalis
qeqqa	qiteq<ental<hans<Absolut
qeqqani	qiteq<ental<hans<Lokalis
qeqqata	qiteq<ental<hans<Relativ
qitermik	qiteq<ental<Instrumentalis
qitermeerpoq	qiteq<ental<Instrumentalis-IR<Indikativ<han
qitermeerluinnarpoq	qiteq<ental<Instrumentalis-IR+LUINNAR<Indikativ<han
qiternik	qiteq<flertal<Instrumentalis
qiterneerpoq	qiteq<flertal<Instrumentalis-IR<Indikativ<han
qiterneerluinnarpoq	qiteq<flertal<Instrumentalis-IR+LUINNAR<Indikativ<han
qiterneertariaqarpoq	qiteq<flertal<Instrumentalis-IR+TARIAQAR<Indikativ<han
qitiminik	qiteq<flertal<sin<Instrumentalis
qitiku	qiteq-KU<ental<Absolut
qitikuattut	qiteq-KU<ental<deres<Aequalis
qitikumik	qiteq-KU<ental<Instrumentalis
qitikumeerluinnarpoq	qiteq-KU<ental<Instrumentalis-IR+LUINNAR<Indikativ<han
qitikunik	qiteq-KU<flertal<Instrumentalis
qitikuneerpoq	qiteq-KU<flertal<Instrumentalis-IR<Indikativ<han
qitikuneerluinnarpoq	qiteq-KU<flertal<Instrumentalis-IR+LUINNAR<Indikativ<han
qitikuneertariaqarpoq	qiteq-KU<flertal<Instrumentalis-IR+TARIAQAR<Indikativ<han
qitikuminik	qiteq-KU<flertal<sin<Instrumentalis
qiterujuattut	qiteq-RUJUK<ental<deres<Aequalis
qiterujummeerluinnarpoq	qiteq-RUJUK<ental<Instrumentalis-IR+LUINNAR<Indikativ<han
qiterujunnik	qiteq-RUJUK<flertal<Instrumentalis
qiterujunneertariaqarpoq	qiteq-RUJUK<flertal<Instrumentalis-IR+TARIAQAR<Indikativ<han
qiterujuminik	qiteq-RUJUK<flertal<sin<Instrumentalis
qiterujussuaq	qiteq-RUJUK=SUAQ<ental<Absolut
qiterujussuattut	qiteq-RUJUK=SUAQ<ental<deres<Aequalis
qiterujussuarmeerpoq	qiteq-RUJUK=SUAQ<ental<Instrumentalis-IR<Indikativ<han
qiterujussuarmeerluinnarpoq	qiteq-RUJUK=SUAQ<ental<Instrumentalis-IR+LUINNAR<Indikativ<han
qiterujussuarneerpoq	qiteq-RUJUK=SUAQ<flertal<Instrumentalis-IR<Indikativ<han
qiterujussuarneerluinnarpoq	qiteq-RUJUK=SUAQ<flertal<Instrumentalis-IR+LUINNAR<Indikativ<han
qiterujussuaminik	qiteq-RUJUK=SUAQ<flertal<sin<Instrumentalis
qularnarpoq	qularnar<Indikativ<han
qularnarluinnarpoq	qularnar+LUINNAR<Indikativ<han
qularnaqaaq	qularnar-QӘ<Indikativ<han
qularnartariaqarpoq	qularnar+TARIAQAR<Indikativ<han
qularnartorujorujussuuvoq	qularnar+TUQ=RUJUK=RUJUK=SUAQ=U<Indikativ<han
qularnartorujussuuvoq	qularnar+TUQ=RUJUK=SUAQ=U<Indikativ<han
sanavatit	sana<Indikativ<DuDem
sanavaa	sana<Indikativ<HanHam
sanavarput	sana<Indikativ<ViHam
sanalluinnarpatit	sana+LUINNAR<Indikativ<DuDem
sanalluinnarpaa	sana+LUINNAR<Indikativ<HanHam
sanalluinnarparput	sana+LUINNAR<Indikativ<ViHam
sanaqaatit	sana-QӘ<Indikativ<DuDem
sanaqaarput	sana-QӘ<Indikativ<ViHam
sanasariaqarpatit	sana+TARIAQAR<Indikativ<DuDem
sanasariaqarpaa	sana+TARIAQAR<Indikativ<HanHam
sanasariaqarparput	sana+TARIAQAR<Indikativ<ViHam
sanasorujorujussuuatit	sana+TUQ=RUJUK=RUJUK=SUAQ=U<Indikativ<DuDem
sanasorujorujussuuaa	sana+TUQ=RUJUK=RUJUK=SUAQ=U<Indikativ<HanHam
sanasorujorujussuuarput	sana+TUQ=RUJUK=RUJUK=SUAQ=U<Indikativ<ViHam
sanasorujussuuatit	sana+TUQ=RUJUK=SUAQ=U<Indikativ<DuDem
sanasorujussuuaa	sana+TUQ=RUJUK=SUAQ=U<Indikativ<HanHam
sanasorujussuuarput	sana+TUQ=RUJUK=SUAQ=U<Indikativ<ViHam
sapinngisamik	sapinngisamik<Partikel
sermersuaq	sermersuaq<ental<Absolut
sermersuattut	sermersuaq<ental<deres<Aequalis
sermersuarmik	sermersuaq<ental<Instrumentalis
sermersuarmeerpoq	sermersuaq<ental<Instrumentalis-IR<Indikativ<han
sermersuarmeerluinnarpoq	sermersuaq<ental<Instrumentalis-IR+LUINNAR<Indikativ<han
sermersuarmeertariaqarpoq	sermersuaq<ental<Instrumentalis-IR+TARIAQAR<Indikativ<han
sermersuarminik	sermersuaq<ental<sin<Instrumentalis
sermersuarnik	sermersuaq<flertal<Instrumentalis
sermersuarneerpoq	sermersuaq<flertal<Instrumentalis-IR<Indikativ<han
sermersuarneerluinnarpoq	sermersuaq<flertal<Instrumentalis-IR+LUINNAR<Indikativ<han
sermersuarneertariaqarpoq	sermersuaq<flertal<Instrumentalis-IR+TARIAQAR<Indikativ<han
sermersuaminik	sermersuaq<flertal<sin<Instrumentalis
sorsunneq	sorsunneq<ental<Absolut
sorsunnerattut	sorsunneq<ental<deres<Aequalis
sorsunnerminik	sorsunneq<ental<sin<Instrumentalis
sorsunnernik	sorsunneq<flertal<Instrumentalis
sorsunnerneerpoq	sorsunneq<flertal<Instrumentalis-IR<Indikativ<han
sorsunnerneerluinnarpoq	sorsunneq<flertal<Instrumentalis-IR+LUINNAR<Indikativ<han
sorsunnerneertariaqarpoq	sorsunneq<flertal<Instrumentalis-IR+TARIAQAR<Indikativ<han
sorsunniminik	sorsunneq<flertal<sin<Instrumentalis
sorsunniku	sorsunneq-KU<ental<Absolut
sorsunnikuattut	sorsunneq-KU<ental<deres<Aequalis
sorsunnikumik	sorsunneq-KU<ental<Instrumentalis
sorsunnikumeerpoq	sorsunneq-KU<ental<Instrumentalis-IR<Indikativ<han
sorsunnikumeerluinnarpoq	sorsunneq-KU<ental<Instrumentalis-IR+LUINNAR<Indikativ<han
sorsunnikumeertariaqarpoq	sorsunneq-KU<ental<Instrumentalis-IR+TARIAQAR<Indikativ<han
sorsunnikuminik	sorsunneq-KU<ental<sin<Instrumentalis
sorsunnikunik	sorsunneq-KU<flertal<Instrumentalis
sorsunnikuneerpoq	sorsunneq-KU<flertal<Instrumentalis-IR<Indikativ<han
sorsunnikuneerluinnarpoq	sorsunneq-KU<flertal<Instrumentalis-IR+LUINNAR<Indikativ<han
sorsunnikuneertariaqarpoq	sorsunneq-KU<flertal<Instrumentalis-IR+TARIAQAR<Indikativ<han
sorsunnikuminik	sorsunneq-KU<flertal<sin<Instrumentalis
sorsunnerujuk	sorsunneq-RUJUK<ental<Absolut
sorsunnerujummik	sorsunneq-RUJUK<ental<Instrumentalis
sorsunnerujummeerpoq	sorsunneq-RUJUK<ental<Instrumentalis-IR<Indikativ<han
sorsunnerujummeerluinnarpoq	sorsunneq-RUJUK<ental<Instrumentalis-IR+LUINNAR<Indikativ<han
sorsunnerujummeertariaqarpoq	sorsunneq-RUJUK<ental<Instrumentalis-IR+TARIAQAR<Indikativ<han
sorsunnerujumminik	sorsunneq-RUJUK<ental<sin<Instrumentalis
sorsunnerujunnik	sorsunneq-RUJUK<flertal<Instrumentalis
sorsunnerujunneerluinnarpoq	sorsunneq-RUJUK<flertal<Instrumentalis-IR+LUINNAR<Indikativ<han
sorsunnerujunneertariaqarpoq	sorsunneq-RUJUK<flertal<Instrumentalis-IR+TARIAQAR<Indikativ<han
sorsunnerujuminik	sorsunneq-RUJUK<flertal<sin<Instrumentalis
sorsunnerujussuaq	sorsunneq-RUJUK=SUAQ<ental<Absolut
sorsunnerujussuattut	sorsunneq-RUJUK=SUAQ<ental<deres<Aequalis
sorsunnerujussuarmik	sorsunneq-RUJUK=SUAQ<ental<Instrumentalis
sorsunnerujussuarmeerluinnarpoq	sorsunneq-RUJUK=SUAQ<ental<Instrumentalis-IR+LUINNAR<Indikativ<han
sorsunnerujussuarminik	sorsunneq-RUJUK=SUAQ<ental<sin<Instrumentalis
sorsunnerujussuarnik	sorsunneq-RUJUK=SUAQ<flertal<Instrumentalis
sorsunnerujussuaminik	sorsunneq-RUJUK=SUAQ<flertal<sin<Instrumentalis
timmisartoq	timmisartoq<ental<Absolut
timmisartuattut	timmisartoq<ental<deres<Aequalis
timmisartumik	timmisartoq<ental<Instrumentalis
timmisartumeerpoq	timmisartoq<ental<Instrumentalis-IR<Indikativ<han
timmisartumeerluinnarpoq	timmisartoq<ental<Instrumentalis-IR+LUINNAR<Indikativ<han
timmisartumeertariaqarpoq	timmisartoq<ental<Instrumentalis-IR+TARIAQAR<Indikativ<han
timmisartuminik	timmisartoq<ental<sin<Instrumentalis
timmisartunik	timmisartoq<flertal<Instrumentalis
timmisartuneerpoq	timmisartoq<flertal<Instrumentalis-IR<Indikativ<han
timmisartuneerluinnarpoq	timmisartoq<flertal<Instrumentalis-IR+LUINNAR<Indikativ<han
timmisartuneertariaqarpoq	timmisartoq<flertal<Instrumentalis-IR+TARIAQAR<Indikativ<han
timmisartuminik	timmisartoq<flertal<sin<Instrumentalis
timmisartuku	timmisartoq-KU<ental<Absolut
timmisartukuattut	timmisartoq-KU<ental<deres<Aequalis
timmisartukumik	timmisartoq-KU<ental<Instrumentalis
timmisartukumeerpoq	timmisartoq-KU<ental<Instrumentalis-IR<Indikativ<han
timmisartukumeerluinnarpoq	timmisartoq-KU<ental<Instrumentalis-IR+LUINNAR<Indikativ<han
timmisartukumeertariaqarpoq	timmisartoq-KU<ental<Instrumentalis-IR+TARIAQAR<Indikativ<han
timmisartukuminik	timmisartoq-KU<ental<sin<Instrumentalis
timmisartukunik	timmisartoq-KU<flertal<Instrumentalis
timmisartukuneerpoq	timmisartoq-KU<flertal<Instrumentalis-IR<Indikativ<han
timmisartukuneerluinnarpoq	timmisartoq-KU<flertal<Instrumentalis-IR+LUINNAR<Indikativ<han
timmisartukuneertariaqarpoq	timmisartoq-KU<flertal<Instrumentalis-IR+TARIAQAR<Indikativ<han
timmisartukuminik	timmisartoq-KU<flertal<sin<Instrumentalis
timmisartorujuk	timmisartoq-RUJUK<ental<Absolut
timmisartorujuattut	timmisartoq-RUJUK<ental<deres<Aequalis
timmisartorujummik	timmisartoq-RUJUK<ental<Instrumentalis
timmisartorujummeerpoq	timmisartoq-RUJUK<ental<Instrumentalis-IR<Indikativ<han
timmisartorujummeerluinnarpoq	timmisartoq-RUJUK<ental<Instrumentalis-IR+LUINNAR<Indikativ<han
timmisartorujummeertariaqarpoq	timmisartoq-RUJUK<ental<Instrumentalis-IR+TARIAQAR<Indikativ<han
timmisartorujumminik	timmisartoq-RUJUK<ental<sin<Instrumentalis
timmisartorujunnik	timmisartoq-RUJUK<flertal<Instrumentalis
timmisartorujunneerpoq	timmisartoq-RUJUK<flertal<Instrumentalis-IR<Indikativ<han
timmisartorujunneerluinnarpoq	timmisartoq-RUJUK<flertal<Instrumentalis-IR+LUINNAR<Indikativ<han
timmisartorujunneertariaqarpoq	timmisartoq-RUJUK<flertal<Instrumentalis-IR+TARIAQAR<Indikativ<han
timmisartorujuminik	timmisartoq-RUJUK<flertal<sin<Instrumentalis
timmisartorujussuaq	timmisartoq-RUJUK=SUAQ<ental<Absolut
timmisartorujussuattut	timmisartoq-RUJUK=SUAQ<ental<deres<Aequalis
timmisartorujussuarmik	timmisartoq-RUJUK=SUAQ<ental<Instrumentalis
timmisartorujussuarmeerpoq	timmisartoq-RUJUK=SUAQ<ental<Instrumentalis-IR<Indikativ<han
timmisartorujussuarmeerluinnarpoq	timmisartoq-RUJUK=SUAQ<ental<Instrumentalis-IR+LUINNAR<Indikativ<han
timmisartorujussuarminik	timmisartoq-RUJUK=SUAQ<ental<sin<Instrumentalis
timmisartorujussuarnik	timmisartoq-RUJUK=SUAQ<flertal<Instrumentalis
timmisartorujussuarneerpoq	timmisartoq-RUJUK=SUAQ<flertal<Instrumentalis-IR<Indikativ<han
timmisartorujussuarneerluinnarpoq	timmisartoq-RUJUK=SUAQ<flertal<Instrumentalis-IR+LUINNAR<Indikativ<han
timmisartorujussuaminik	timmisartoq-RUJUK=SUAQ<flertal<sin<Instrumentalis
tunuliaqut	tunuliaqut<ental<Absolut
tunuliaqutaattut	tunuliaqut<ental<deres<Aequalis
tunuliaqummik	tunuliaqut<ental<Instrumentalis
tunuliaqummeerpoq	tunuliaqut<ental<Instrumentalis-IR<Indikativ<han
tunuliaqummeerluinnarpoq	tunuliaqut<ental<Instrumentalis-IR+LUINNAR<Indikativ<han
tunuliaqummeertariaqarpoq	tunuliaqut<ental<Instrumentalis-IR+TARIAQAR<Indikativ<han
tunuliaqutiminik	tunuliaqut<ental<sin<Instrumentalis
tunuliaqutineerpoq	tunuliaqut<flertal<Instrumentalis-IR<Indikativ<han
tunuliaqutineerluinnarpoq	tunuliaqut<flertal<Instrumentalis-IR+LUINNAR<Indikativ<han
tunuliaqutineertariaqarpoq	tunuliaqut<flertal<Instrumentalis-IR+TARIAQAR<Indikativ<han
tunuliaqutiminik	tunuliaqut<flertal<sin<Instrumentalis
tunuliaqutiku	tunuliaqut-KU<ental<Absolut
tunuliaqutikuattut	tunuliaqut-KU<ental<deres<Aequalis
tunuliaqutikumeerluinnarpoq	tunuliaqut-KU<ental<Instrumentalis-IR+LUINNAR<Indikativ<han
tunuliaqutikunik	tunuliaqut-KU<flertal<Instrumentalis
tunuliaqutikuneerpoq	tunuliaqut-KU<flertal<Instrumentalis-IR<Indikativ<han
tunuliaqutikuneerluinnarpoq	tunuliaqut-KU<flertal<Instrumentalis-IR+LUINNAR<Indikativ<han
tunuliaqutikuneertariaqarpoq	tunuliaqut-KU<flertal<Instrumentalis-IR+TARIAQAR<Indikativ<han
tunuliaqutikuminik	tunuliaqut-KU<flertal<sin<Instrumentalis
tunuliaquterujuk	tunuliaqut-RUJUK<ental<Absolut
tunuliaquterujuattut	tunuliaqut-RUJUK<ental<deres<Aequalis
tunuliaquterujummik	tunuliaqut-RUJUK<ental<Instrumentalis
tunuliaquterujummeerluinnarpoq	tunuliaqut-RUJUK<ental<Instrumentalis-IR+LUINNAR<Indikativ<han
tunuliaquterujummeertariaqarpoq	tunuliaqut-RUJUK<ental<Instrumentalis-IR+TARIAQAR<Indikativ<han
tunuliaquterujumminik	tunuliaqut-RUJUK<ental<sin<Instrumentalis
tunuliaquterujunneerpoq	tunuliaqut-RUJUK<flertal<Instrumentalis-IR<Indikativ<han
tunuliaquterujunneerluinnarpoq	tunuliaqut-RUJUK<flertal<Instrumentalis-IR+LUINNAR<Indikativ<han
tunuliaquterujunneertariaqarpoq	tunuliaqut-RUJUK<flertal<Instrumentalis-IR+TARIAQAR<Indikativ<han
tunuliaquterujuminik	tunuliaqut-RUJUK<flertal<sin<Instrumentalis
tunuliaquterujussuaq	tunuliaqut-RUJUK=SUAQ<ental<Absolut
tunuliaquterujussuattut	tunuliaqut-RUJUK=SUAQ<ental<deres<Aequalis
tunuliaquterujussuarmik	tunuliaqut-RUJUK=SUAQ<ental<Instrumentalis
tunuliaquterujussuarmeerpoq	tunuliaqut-RUJUK=SUAQ<ental<Instrumentalis-IR<Indikativ<han
tunuliaquterujussuarminik	tunuliaqut-RUJUK=SUAQ<ental<sin<Instrumentalis
tunuliaquterujussuarnik	tunuliaqut-RUJUK=SUAQ<flertal<Instrumentalis
tunuliaquterujussuarneerpoq	tunuliaqut-RUJUK=SUAQ<flertal<Instrumentalis-IR<Indikativ<han
tunuliaquterujussuarneerluinnarpoq	tunuliaqut-RUJUK=SUAQ<flertal<Instrumentalis-IR+LUINNAR<Indikativ<han
tunuliaquterujussuarneertariaqarpoq	tunuliaqut-RUJUK=SUAQ<flertal<Instrumentalis-IR+TARIAQAR<Indikativ<han
tunuliaquterujussuaminik	tunuliaqut-RUJUK=SUAQ<flertal<sin<Instrumentalis
usivoq	usi<Indikativ<han
usilluinnarpoq	usi+LUINNAR<Indikativ<han
useqaaq	usi-QӘ<Indikativ<han
usisariaqarpoq	usi+TARIAQAR<Indikativ<han
usisorujorujussuuvoq	usi+TUQ=RUJUK=RUJUK=SUAQ=U<Indikativ<han
usisorujussuuvoq	usi+TUQ=RUJUK=SUAQ=U<Indikativ<han
