aallaratta	aallar<Causativ<vi
aallarpallaarpa	aallar+VALLAAR<Interrogativ<han
aappariivi	aappaq+GIIT<flertal<deres<Absolut
aappariinnguinnarneratali	aappaq+GIIT-NNGUR-INNAR+NIQ<ental<deres<Relativ+LI
aapparpassuaminilli	aappaq+PASSUAQ<flertal<sin<Instrumentalis+LI
aap	aap<Partikel
aalluunniit	aap<Partikel+LUUNNIIT
aapuna	aap<Partikel+UNA
aasariilinngilalli	aasaq+GIIT-LIR_nv-NNGIT<Indikativ<DuHam+LI
Aasiaat	Aasiaat<Absolut
Aasiaalli	Aasiaat<Absolut+LI
Aasiaalluunniit	Aasiaat<Absolut+LUUNNIIT
Aasiaanuna	Aasiaat<Absolut+UNA
Aasiannik	Aasiaat<Instrumentalis
Aasiannilli	Aasiaat<Instrumentalis+LI
Aasiannilluunniit	Aasiaat<Instrumentalis+LUUNNIIT
Aasianninguna	Aasiaat<Instrumentalis+UNA
Aasianni	Aasiaat<Lokalis
Aasianneeqqaarpoq	Aasiaat<Lokalis+IP-QQAAR<Indikativ<han
Aasianneeqqaarlutilli	Aasiaat<Lokalis+IP-QQAAR<Ledsagemåde<de_selv+LI
Aasiammiunilli	Aasiaat+MIU<flertal<Instrumentalis+LI
Aasiammiuninguna	Aasiaat+MIU<flertal<Instrumentalis+UNA
Aasiammiuneeqqaarlutillu	Aasiaat+MIU<flertal<Lokalis+IP-QQAAR<Ledsagemåde<de_selv+LU
Aasiammiulererusuppisi	Aasiaat+MIU-LIRI+GUSUP<Interrogativ<I
Aasiammiunnguinnarpugullu	Aasiaat+MIU-NNGUR-INNAR<Indikativ<vi+LU
Aasiammiunngulernerpaaminik	Aasiaat+MIU-NNGUR-LIR+NIRPAAQ<ental<sin<Instrumentalis
Aasiammiunngunngitsorujoqassavisi	Aasiaat+MIU-NNGUR-NNGIT+TUQ-RUJUK-QAR-SSA<Interrogativ<I
Aasiammiunngussagaluarnini	Aasiaat+MIU-NNGUR-SSA=GALUAR+NIQ<ental<sin<Absolut
Aasiammioqarpoq	Aasiaat+MIU-QAR<Indikativ<han
Aasiammioqarporli	Aasiaat+MIU-QAR<Indikativ<han+LI
Aasiammioqarporluunniit	Aasiaat+MIU-QAR<Indikativ<han+LUUNNIIT
Aasiammioqarnerlu	Aasiaat+MIU-QAR+NIQ<ental<Absolut+LU
Aasiammioqartoq	Aasiaat+MIU-QAR<Participium<han
Aasiammioqartoq	Aasiaat+MIU-QAR+TUQ<ental<Absolut
Aasiammioqartorluunniit	Aasiaat+MIU-QAR+TUQ<ental<Absolut+LUUNNIIT
Aasiammioorusummat	Aasiaat+MIU-U+GUSUP<Causativ<han
Aasiammioorusukkamali	Aasiaat+MIU-U+GUSUP<Causativ<jeg+LI
Aasiammioorusuffinguna	Aasiaat+MIU-U+GUSUP+FIK<ental<Absolut+UNA
Aasiammiuunikuufferujooqqaarporli	Aasiaat+MIU-U+NIKUU+FIK-RUJUK-U-QQAAR<Indikativ<han+LI
Aasiammiuunngillalluunniit	Aasiaat+MIU-U-NNGIT<Indikativ<de+LUUNNIIT
Aasiammiooqqaarpit	Aasiaat+MIU-U-QQAAR<Interrogativ<du
Aasiammiooqqaarneralli	Aasiaat+MIU-U-QQAAR+NIQ<ental<deres+LI
Aasiammiooqqaarninilu	Aasiaat+MIU-U-QQAAR+NIQ<ental<sin<Absolut+LU
Aasiammiooqisut	Aasiaat+MIU-U-QӘ<Participium<de
Aasiammiuuittuneeqqullungali	Aasiaat+MIU-U-VIP+TUQ<flertal<Instrumentalis-IR-QQU<Ledsagemåde<mig+LI
Aasiannut	Aasiaat<Terminalis
Aasiannukalaarpit	Aasiaat<Terminalis-KAR-LAAR<Interrogativ<du
Aasiannukalaartarmatali	Aasiaat<Terminalis-KAR-LAAR=TAR<Causativ<de+LI
Aasiannukariarlutillu	Aasiaat<Terminalis-KAR-RIAR<Ledsagemåde<de_selv+LU
Aasiannullu	Aasiaat<Terminalis+LU
Aasiannulluunniit	Aasiaat<Terminalis+LUUNNIIT
Aasiannununa	Aasiaat<Terminalis+UNA
affaq	affaq<ental<Absolut
affarli	affaq<ental<Absolut+LI
affara	affaq<ental<min<Absolut
affaalli	affaq<flertal<deres<Absolut+LI
affaatuna	affaq<flertal<deres<Absolut+UNA
affaniissagaluarlutik	affaq<flertal<Instrumentalis-IR-SSA=GALUAR<Ledsagemåde<de_selv
affarisussaallugillu	affaq+GӘ+TUQ=SSAQ=U<Ledsagemåde<dem+LU
affakunngunnginnatta	affaq-KU-NNGUR-NNGIT<Causativ<vi
affakoqanngiffissiuinnarnerpaaq	affaq-KU-QAR-NNGIT+FIK+SIUR-INNAR+NIRPAAQ<ental<Absolut
affarujussuartulli	affaq-RUJUK=SUAQ<flertal<Aequalis+LI
affarujussuannilu	affaq-RUJUK=SUAQ<flertal<min<Lokalis+LU
affarsiulaartartunga	affaq+SIUR-LAAR=TAR<Participium<jeg
affassaagaluarmukalaarpoq	affaq-SSAQ=U=GALUAQ<ental<Terminalis-KAR-LAAR<Indikativ<han
affartaaqaa	affaq+TAAR-QӘ<Interrogativ<han
affartaavimmata	affaq+TAAR-VIP<Causativ<de
affaanikuuvunga	affaq-U+NIKUU<Indikativ<jeg
akisuumeeriarmanuna	akisooq<ental<Lokalis+IP-RIAR<Causativ<han+UNA
akisuunukariarnernili	akisooq<flertal<flertal<Terminalis-KAR-RIAR+NIQ<flertal<Lokalis+LI
akisuuniissagaluartunga	akisooq<flertal<Instrumentalis-IR-SSA=GALUAR<Participium<jeg
akisooqalertorluunniit	akisooq-QAR-LIR+TUQ<ental<Absolut+LUUNNIIT
akisussaassutsiminilluunniit	akisussaassuseq<ental<sin<Instrumentalis+LUUNNIIT
akisussaassutsimukaqqutigillu	akisussaassuseq<ental<Terminalis-KAR-QQU<Imperativ<ViDem+LU
akisussaassusiinnannguinnarput	akisussaassuseq-INNAQ-NNGUR-INNAR<Indikativ<de
akuerimmangaana	akuerә<Causativ<HanMig+UNA
akuerigaluartiginuna	akuerә+GALUAR<Imperativ<ViDem+UNA
akueritigillu	akuerә<Imperativ<ViDem+LU
akuerilaarpiuk	akuerә-LAAR<Interrogativ<DuHam
akuerinikuuiuk	akuerә+NIKUU<Interrogativ<DuHam
akuereriarluginuna	akuerә-RIAR<Ledsagemåde<dem+UNA
akuerereerluguli	akuerә-RIIR<Ledsagemåde<ham+LI
akuerereerlaraana	akuerә-RIIR<Optativ<JegHam+UNA
akuerisorujorujussuullunga	akuerә+TUQ=RUJUK=RUJUK=SUAQ=U<Ledsagemåde<mig
aleqamininguna	aleqa<flertal<sin<Instrumentalis+UNA
aleqaannaleqqaarlungaana	aleqa-INNAQ-LIR_nv-QQAAR<Ledsagemåde<mig+UNA
aleqakkunneereertunga	aleqa-KKUT<flertal<Instrumentalis-IR-RIIR<Participium<jeg
aleqalereqqaarninili	aleqa-LIRI-QQAAR+NIQ<ental<sin<Absolut+LI
aleqamiuuallaarpit	aleqa+MIU-U+VALLAAR<Interrogativ<du
aleqassaagalui	aleqa-SSAQ=U=GALUAQ<flertal<deres<Absolut
aleqaasaraluarfianuna	aleqa-U+TAR=GALUAR+FIK<ental<Absolut<deres+UNA
allani	alla<flertal<Lokalis
allakkatulli	allagaq<ental<Aequalis+LI
allagiittut	alla+GIIT<flertal<Aequalis
allagereerakku	alla+GӘ-RIIR<Causativ<JegHam
allalimma	alla-LIK<ental<min<Relativ
allallilli	alla-LIK<flertal<Relativ+LI
allalilermanga	alla-LIR_nv-LIR<Causativ<HanMig
allamiooqimmanuna	alla+MIU-U-QӘ<Causativ<han+UNA
allamiuuallaartununa	alla+MIU-U+VALLAAR<Participium<de+UNA
allanngulaartaratta	alla-NNGUR-LAAR=TAR<Causativ<vi
allarujussua	alla-RUJUK=SUAQ<ental<hans<Absolut
allarujussuarmut	alla-RUJUK=SUAQ<ental<Terminalis
allassaagama	alla-SSAQ-U<Causativ<jeg
allassaagaluataana	alla-SSAQ=U=GALUAQ<ental<hans<Relativ+UNA
allataannginnatta	alla+TAAR-NNGIT<Causativ<vi
allataaqqaarnini	alla+TAAR-QQAAR+NIQ<ental<sin<Absolut
allataavifferujuttaannginnerit	alla+TAAR-VIP+FIK-RUJUK+TAAR-NNGIT+NIQ<flertal<Relativ
anaanami	anaana<ental<Lokalis
anaananngualu	anaana-NNGUAQ<ental<hans<Absolut+LU
anaanarpassuilu	anaana+PASSUAQ<flertal<deres<Absolut+LU
anaanaqareerferujuinuna	anaana-QAR-RIIR+FIK-RUJUK<flertal<Relativ+UNA
anaanataalerlutinguna	anaana+TAAR-LIR<Ledsagemåde<de_selv+UNA
anaanataareerpunga	anaana+TAAR-RIIR<Indikativ<jeg
angajoqqaarsiussammata	angajoqqaaq+SIUR-SSA<Causativ<de
angajuinnanngoriarfissiussagaluarfiinnanngoreerfeqareerfikkunninguna	angaju-INNAQ-NNGUR-RIAR+FIK+SIUR-SSA=GALUAR+FIK-INNAQ-NNGUR-RIIR+FIK-QAR-RIIR+FIK-KKUT<flertal<Instrumentalis+UNA
angajorpassuakkali	angaju+PASSUAQ<flertal<min<Absolut+LI
angajoqaqqulara	angaju-QAR-QQU<Optativ<JegHam
angulli	angut<ental<Absolut+LI
angununa	angut<ental<Absolut+UNA
angummiinngilanga	angut<ental<Instrumentalis-IR-NNGIT<Indikativ<jeg
animinillu	ani<flertal<sin<Instrumentalis+LU
aneqalaartunga	ani-QAR-LAAR<Participium<jeg
anerujunngussagatta	ani-RUJUK-NNGUR-SSA<Causativ<vi
anerujooqquiuk	ani-RUJUK-U-QQU<Interrogativ<DuHam
anisiussasununa	ani+SIUR-SSA<Participium<de+UNA
aqqalunnguatalu	aqqalu-NNGUAQ<ental<deres<Relativ+LU
aqqalunngoriarfileqqaarpaa	aqqalu-NNGUR-RIAR+FIK-LIR_nv-QQAAR<Indikativ<HanHam
aqqalorujooqaat	aqqalu-RUJUK-U-QӘ<Interrogativ<du
aqqanilissanngoqqaarnermut	aqqanillit-SSAQ-NNGUR-QQAAR+NIQ<ental<Terminalis
aqqanillinuna	aqqanillit<Talord<flertal<Absolut+UNA
aqqanilinnukavillutik	aqqanillit<Talord<flertal<Terminalis-KAR-VIP<Ledsagemåde<de_selv
aqqutigivagununa	aqqutigә<Indikativ<ViDem+UNA
aqqutigeriarmanga	aqqutigә-RIAR<Causativ<HanMig
aqqutigereerlunga	aqqutigә-RIIR<Ledsagemåde<mig
aqqutigisimallunga	aqqutigә+SIMA<Ledsagemåde<mig
aqqutigissavaa	aqqutigә-SSA<Indikativ<HanHam
aqqutigisarlungalu	aqqutigә+TAR<Ledsagemåde<mig+LU
arnaq	arnaq<ental<Absolut
arnaralu	arnaq<ental<min<Absolut+LU
arnaminik	arnaq<flertal<sin<Instrumentalis
arnariinuna	arnaq+GIIT<flertal<Absolut+UNA
arnareqqaarlara	arnaq+GӘ-QQAAR<Optativ<JegHam
arnaannaaneruffippassuarniinngitsoruna	arnaq-INNAQ-U+NIRU+FIK+PASSUAQ<flertal<Instrumentalis-IR-NNGIT<Participium<han+UNA
arnakkunneeqqularali	arnaq-KKUT<flertal<Instrumentalis-IR-QQU<Optativ<JegHam+LI
arnalereriarfissanngulaartartoq	arnaq-LIRI-RIAR+FIK-SSAQ-NNGUR-LAAR=TAR<Participium<han
arnarmioqartorli	arnaq+MIU-QAR+TUQ<ental<Absolut+LI
arnarpassuartut	arnaq+PASSUAQ<flertal<Aequalis
arnarpassuakka	arnaq+PASSUAQ<flertal<min<Absolut
arnarujulluunniit	arnaq-RUJUK<ental<Absolut+LUUNNIIT
arnarsioreertulluunniit	arnaq+SIUR-RIIR<Participium<de+LUUNNIIT
arnassalilerlugu	arnaq-SSAQ-LIR_nv-LIR<Ledsagemåde<ham
arnartaaqimmallu	arnaq+TAAR-QӘ<Causativ<han+LU
assersuullu	assersuut<ental<Absolut+LU
assersuununa	assersuut<ental<Absolut+UNA
assersuummukaqqutigilli	assersuut<ental<Terminalis-KAR-QQU<Imperativ<ViDem+LI
assorsuaq	assorsuaq<Partikel
assulli	assut<Partikel+LI
assununa	assut<Partikel+UNA
atassummukassagaluarlutinguna	atassut<ental<Terminalis-KAR-SSA=GALUAR<Ledsagemåde<de_selv+UNA
atassutilittulli	atassut-LIK<ental<Aequalis+LI
ateqartorujussuullutik	ateqar+TUQ=RUJUK=SUAQ=U<Ledsagemåde<de_selv
atilerereernini	ateq-LIRI-RIIR+NIQ<ental<sin<Absolut
atinnguiluunniit	ateq-NNGUAQ<flertal<hans<Absolut+LUUNNIIT
aterpassuili	ateq+PASSUAQ<flertal<hans<Absolut+LI
aterujukkali	ateq-RUJUK<flertal<min<Absolut+LI
atiutippiuk	ateq-U+TIP<Interrogativ<DuHam
atuinnartigilli	ator-INNAR<Imperativ<ViDem+LI
atunngilakka	ator-NNGIT<Indikativ<JegDem
atoqquassi	ator-QQU<Indikativ<JegJer
atoqqularali	ator-QQU<Optativ<JegHam+LI
atoriarlugit	ator-RIAR<Ledsagemåde<dem
atoriartoriinni	ator-RIAR+TUQ+GIIT<flertal<min<Lokalis
atussallunga	ator-SSA<Ledsagemåde<mig
atuakkialerininngooqqulara	atuakkialerineq-NNGUAQ-U-QQU<Optativ<JegHam
atuarsinnaasorlu	atuar+SINNAA<Participium<han+LU
Avanersuaq	Avanersuaq<ental<Absolut
Avanersuarli	Avanersuaq<ental<Absolut+LI
Avanersuarluunniit	Avanersuaq<ental<Absolut+LUUNNIIT
Avanersuaruna	Avanersuaq<ental<Absolut+UNA
Avanersuarmik	Avanersuaq<Instrumentalis
Avanersuarmilli	Avanersuaq<Instrumentalis+LI
Avanersuarmilluunniit	Avanersuaq<Instrumentalis+LUUNNIIT
Avanersuarminguna	Avanersuaq<Instrumentalis+UNA
Avanersuarmi	Avanersuaq<Lokalis
Avanersuarmeeqqaarneq	Avanersuaq<Lokalis+IP-QQAAR+NIQ<ental<Absolut
Avanersuarmeeqqaartoq	Avanersuaq<Lokalis+IP-QQAAR<Participium<han
Avanersuarmeeqquaangaluunniit	Avanersuaq<Lokalis+IP-QQU<Indikativ<HanMig+LUUNNIIT
Avanersuarmeeqqullunga	Avanersuaq<Lokalis+IP-QQU<Ledsagemåde<mig
Avanersuarmeeqqulara	Avanersuaq<Lokalis+IP-QQU<Optativ<JegHam
Avanersuarmeeriarama	Avanersuaq<Lokalis+IP-RIAR<Causativ<jeg
Avanersuarmeereertulluunniit	Avanersuaq<Lokalis+IP-RIIR<Participium<de+LUUNNIIT
Avanersuarmili	Avanersuaq<Lokalis+LI
Avanersuarmiluunniit	Avanersuaq<Lokalis+LUUNNIIT
Avanersuarmiuna	Avanersuaq<Lokalis+UNA
Avanersuarmiumukalertunga	Avanersuaq+MIU<ental<Terminalis-KAR-LIR<Participium<jeg
Avanersuarmiuniilaarlutik	Avanersuaq+MIU<flertal<Lokalis+IP-LAAR<Ledsagemåde<de_selv
Avanersuarmiulereriarnerilli	Avanersuaq+MIU-LIRI-RIAR+NIQ<flertal<Absolut+LI
Avanersuarmiulerereernerpaaq	Avanersuaq+MIU-LIRI-RIIR+NIRPAAQ<ental<Absolut
Avanersuarmioqarpa	Avanersuaq+MIU-QAR<Interrogativ<han
Avanersuarmiooqisungali	Avanersuaq+MIU-U-QӘ<Participium<jeg+LI
Avanersuarmut	Avanersuaq<Terminalis
Avanersuarmukaannaratta	Avanersuaq<Terminalis-KAR-INNAR<Causativ<vi
Avanersuarmukalaartarpoq	Avanersuaq<Terminalis-KAR-LAAR=TAR<Indikativ<han
Avanersuarmukalaartarpunga	Avanersuaq<Terminalis-KAR-LAAR=TAR<Indikativ<jeg
Avanersuarmukalernerli	Avanersuaq<Terminalis-KAR-LIR+NIQ<ental<Absolut+LI
Avanersuarmukalertununa	Avanersuaq<Terminalis-KAR-LIR<Participium<de+UNA
Avanersuarmukalertoq	Avanersuaq<Terminalis-KAR-LIR+TUQ<ental<Absolut
Avanersuarmukanngillalluunniit	Avanersuaq<Terminalis-KAR-NNGIT<Indikativ<de+LUUNNIIT
Avanersuarmukaqqaaramali	Avanersuaq<Terminalis-KAR-QQAAR<Causativ<jeg+LI
Avanersuarmukariarama	Avanersuaq<Terminalis-KAR-RIAR<Causativ<jeg
Avanersuarmukareertoq	Avanersuaq<Terminalis-KAR-RIIR+TUQ<ental<Absolut
Avanersuarmukassagaluarmalli	Avanersuaq<Terminalis-KAR-SSA=GALUAR<Causativ<han+LI
Avanersuarmukassagaluarnerlu	Avanersuaq<Terminalis-KAR-SSA=GALUAR+NIQ<ental<Absolut+LU
Avanersuarmullu	Avanersuaq<Terminalis+LU
Avanersuarmununa	Avanersuaq<Terminalis+UNA
Avanersuakkut	Avanersuaq<Vialis
Avanersuakkulli	Avanersuaq<Vialis+LI
Avanersuakkullu	Avanersuaq<Vialis+LU
Avanersuakkulluunniit	Avanersuaq<Vialis+LUUNNIIT
Avanersuakkununa	Avanersuaq<Vialis+UNA
avimmata	avip<Causativ<de
avimmatali	avip<Causativ<de+LI
avikkunnaarlutilli	avip+GUNNAAR<Ledsagemåde<de_selv+LI
avinnikuuisi	avip+NIKUU<Interrogativ<I
avinnikuunini	avip+NIKUU+NIQ<ental<sin<Absolut
avinnerillu	avip+NIQ<flertal<Absolut+LU
avinnerni	avip+NIQ<flertal<Lokalis
aveqqaarpununa	avip-QQAAR<Indikativ<de+UNA
aveqaalli	avip-QӘ<Indikativ<de+LI
averiarfilererusuffittununa	avip-RIAR+FIK-LIRI+GUSUP+FIK<ental<Aequalis+UNA
averiartoqalerpungali	avip-RIAR+TUQ-QAR-LIR<Indikativ<jeg+LI
averiartortaassagaluarpunga	avip-RIAR+TUQ+TAAR-SSA=GALUAR<Indikativ<jeg
avereertulli	avip-RIIR<Participium<de+LI
avittariaqartulivimmanga	avip+TARIAQAR+TUQ-LIR_nv-VIP<Causativ<HanMig
avittarlutinguna	avip+TAR<Ledsagemåde<de_selv+UNA
avippallaarmata	avip+VALLAAR<Causativ<de
avippallaarneq	avip+VALLAAR+NIQ<ental<Absolut
eqqaamarusummangali	eqqaama+GUSUP<Causativ<HanMig+LI
eqqaamalaralu	eqqaama<Optativ<JegHam+LU
eqqaamasimasarlugit	eqqaama+SIMA=TAR<Ledsagemåde<dem
eqqaamassatigit	eqqaama-SSA<Imperativ<ViDem
eqqaamasorujorujussuutigilli	eqqaama+TUQ=RUJUK=RUJUK=SUAQ=U<Imperativ<ViDem+LI
eqqaamavallaartigilluunniit	eqqaama+VALLAAR<Imperativ<ViDem+LUUNNIIT
eqqaata	eqqaq<ental<deres<Relativ
eqqaa	eqqaq<ental<hans<Absolut
eqqaqani	eqqaq<ental<Lokalis<hans
eqqaqaniiginnarneq	eqqaq<ental<Lokalis<hans+IP-INNAR+NIQ<ental<Absolut
eqqaqaneeqqaarpoq	eqqaq<ental<Lokalis<hans+IP-QQAAR<Indikativ<han
eqqaqaneeriarnini	eqqaq<ental<Lokalis<hans+IP-RIAR+NIQ<ental<sin<Absolut
eqqara	eqqaq<ental<min<Absolut
eqqarali	eqqaq<ental<min<Absolut+LI
eqqaraluunniit	eqqaq<ental<min<Absolut+LUUNNIIT
eqqanneeqqugakku	eqqaq<ental<min<Lokalis+IP-QQU<Causativ<JegHam
eqqama	eqqaq<ental<min<Relativ
eqqamali	eqqaq<ental<min<Relativ+LI
eqqani	eqqaq<ental<sin<Absolut
eqqaanulli	eqqaq<ental<Terminalis<hans+LI
eqqaanununa	eqqaq<ental<Terminalis<hans+UNA
eqqaqaannarluunniit	eqqaq-INNAQ<ental<Absolut+LUUNNIIT
eqqaqaannarsiussagaluarnerilluunniit	eqqaq-INNAQ+SIUR-SSA=GALUAR+NIQ<flertal<Absolut+LUUNNIIT
eqqaqinngooqimmata	eqqaq-NNGUAQ-U-QӘ<Causativ<de
eqqaqinngooqaagut	eqqaq-NNGUAQ-U-QӘ<Indikativ<vi
eqqaqinngooreernini	eqqaq-NNGUAQ-U-RIIR+NIQ<ental<sin<Absolut
eqqarsaatiginiarmanga	eqqarsaatigә+NIAR<Causativ<HanMig
eqqarsartariaatsikkulli	eqqarsartariaaseq<ental<Vialis+LI
eqqarsartariaatsineereerpugununa	eqqarsartariaaseq<flertal<Lokalis+IP-RIIR<Indikativ<vi+UNA
eqqarsartariaatsiniissagaluarnerli	eqqarsartariaaseq<flertal<Lokalis+IP-SSA=GALUAR+NIQ<ental<Absolut+LI
eqqarsartariaasiinnaq	eqqarsartariaaseq-INNAQ<ental<Absolut
eqqumiimmatali	eqqumiip<Causativ<de+LI
eqqumiimmallu	eqqumiip<Causativ<han+LU
eqqumiikkamaluunniit	eqqumiip<Causativ<jeg+LUUNNIIT
eqqumiiffilissagaluarpaat	eqqumiip+FIK-LIR_nv-SSA=GALUAR<Indikativ<DeHam
eqqumiiffeqalaartarfeqartussaaffeqaqqaarnerata	eqqumiip+FIK-QAR-LAAR=TAR+FIK-QAR+TUQ=SSAQ=U+FIK-QAR-QQAAR+NIQ<ental<hans<Relativ
eqqumiilaarnernik	eqqumiip-LAAR+NIQ<flertal<Instrumentalis
eqqumiilaartaratta	eqqumiip-LAAR=TAR<Causativ<vi
eqqumiillutinguna	eqqumiip<Ledsagemåde<de_selv+UNA
eqqumiilluarmataluunniit	eqqumiip+LUAR<Causativ<de+LUUNNIIT
eqqumiinnikuuisi	eqqumiip+NIKUU<Interrogativ<I
eqqumiinnikuullutik	eqqumiip+NIKUU<Ledsagemåde<de_selv
eqqumiinnikuullutilluunniit	eqqumiip+NIKUU<Ledsagemåde<de_selv+LUUNNIIT
eqqumiinnerullutik	eqqumiip+NIRU<Ledsagemåde<de_selv
eqqumeeqqaarmata	eqqumiip-QQAAR<Causativ<de
eqqumeeqqaarnerpaannguinnarlutinguna	eqqumiip-QQAAR+NIRPAAQ-NNGUR-INNAR<Ledsagemåde<de_selv+UNA
eqqumeeqqaartukkunniluunniit	eqqumiip-QQAAR+TUQ-KKUT<flertal<Lokalis+LUUNNIIT
eqqumeeqqaartoqavikkama	eqqumiip-QQAAR+TUQ-QAR-VIP<Causativ<jeg
eqqumeeqqaartorujuunatilli	eqqumiip-QQAAR+TUQ-RUJUK-U-NNGIT<Ledsagemåde<de_selv+LI
eqqumeeqqutigilli	eqqumiip-QQU<Imperativ<ViDem+LI
eqqumeeqquatit	eqqumiip-QQU<Indikativ<DuDem
eqqumeeqqulara	eqqumiip-QQU<Optativ<JegHam
eqqumeeqimmalli	eqqumiip-QӘ<Causativ<han+LI
eqqumeeqaat	eqqumiip-QӘ<Interrogativ<du
eqqumeeqalutinguna	eqqumiip-QӘ<Ledsagemåde<de_selv+UNA
eqqumeeqisoqalaartartuni	eqqumiip-QӘ+TUQ-QAR-LAAR=TAR+TUQ<ental<sin<Absolut
eqqumeeqisooqqugakku	eqqumiip-QӘ+TUQ-U-QQU<Causativ<JegHam
eqqumeeriarattaana	eqqumiip-RIAR<Causativ<vi+UNA
eqqumeeriarfinngooqqaarlutik	eqqumiip-RIAR+FIK-NNGUAQ-U-QQAAR<Ledsagemåde<de_selv
eqqumeeriarlutik	eqqumiip-RIAR<Ledsagemåde<de_selv
eqqumeeriarlutillu	eqqumiip-RIAR<Ledsagemåde<de_selv+LU
eqqumeeriarnermalu	eqqumiip-RIAR+NIQ<ental<min<Relativ+LU
eqqumeeriarnerneeqqaartungalu	eqqumiip-RIAR+NIQ<flertal<Instrumentalis-IR-QQAAR<Participium<jeg+LU
eqqumeeriartooqqaarnerpaanili	eqqumiip-RIAR+TUQ-U-QQAAR+NIRPAAQ<flertal<Lokalis+LI
eqqumeereermat	eqqumiip-RIIR<Causativ<han
eqqumeereernerpaatullu	eqqumiip-RIIR+NIRPAAQv<ental<Aequalis+LU
eqqumiissimavugullu	eqqumiip+SIMA<Indikativ<vi+LU
eqqumiissinnaappulli	eqqumiip+SINNAA<Indikativ<de+LI
eqqumiitsippiuk	eqqumiip+TIP<Interrogativ<DuHam
eqqumiittoqalaarnerpaannguimmata	eqqumiip+TUQ-QAR-LAAR+NIRPAAQ-NNGUR-VIP<Causativ<de
eqqumiittussaasooriarneq	eqqumiip+TUQ=SSAQ=U+TUQ-U-RIAR+NIQ<ental<Absolut
eqqumiitsuliortora	eqqumiitsuliortoq<ental<min<Absolut
erneq	erneq<ental<Absolut
ernerattullu	erneq<ental<deres<Aequalis+LU
ernerataluunniit	erneq<ental<deres<Relativ+LUUNNIIT
ernerata	erneq<ental<hans<Relativ
ernerissagaluarlungaluunniit	erneq+GӘ-SSA=GALUAR<Ledsagemåde<mig+LUUNNIIT
ernerivallaarlaraana	erneq+GӘ+VALLAAR<Optativ<JegHam+UNA
ernerinnanngoriarnerilli	erneq-INNAQ-NNGUR-RIAR+NIQ<flertal<Relativ+LI
ernikkunniilertunga	erneq-KKUT<flertal<Instrumentalis-IR-LIR<Participium<jeg
ernikoqaviffeqartuleqquiuk	erneq-KU-QAR-VIP+FIK-QAR+TUQ-LIR_nv-QQU<Interrogativ<DuHam
ernikusiunngitsulli	erneq-KU+SIUR-NNGIT<Participium<de+LI
ernilivimmanga	erneq-LIR_nv-VIP<Causativ<HanMig
ernermiulerereertussaniissavit	erneq+MIU-LIRI-RIIR+TUQ-SSAQ<flertal<Instrumentalis-IR-SSA<Interrogativ<du
ernermioqarnerlu	erneq+MIU-QAR+NIQ<ental<Absolut+LU
erninnguata	erneq-NNGUAQ<ental<hans<Relativ
erninnguujunnaarlutillu	erneq-NNGUAQ-U+GUNNAAR<Ledsagemåde<de_selv+LU
erninngooqaagut	erneq-NNGUAQ-U-QӘ<Indikativ<vi
erninngulaarpit	erneq-NNGUR-LAAR<Interrogativ<du
ernerpassuiuna	erneq+PASSUAQ<flertal<deres<Absolut+UNA
ernerujulinngiliuk	erneq-RUJUK-LIR_nv-NNGIT<Interrogativ<DuHam
ernerujussuata	erneq-RUJUK=SUAQ<ental<deres<Relativ
ernissami	erneq-SSAQ<ental<Lokalis
ernissaa	erneq-SSAQ<flertal<hans<Absolut
ernissaagaluatalu	erneq-SSAQ=U=GALUAQ<ental<deres<Relativ+LU
erniinnaq	erniinnaq<Partikel
erniinnarli	erniinnaq<Partikel+LI
erniinnarlu	erniinnaq<Partikel+LU
erniinnaruna	erniinnaq<Partikel+UNA
ersigaluartuinnanngoreerpungalu	ersi+GALUAR+TUQ-INNAQ-NNGUR-RIIR<Indikativ<jeg+LU
ersiunnaarlutik	ersi+GUNNAAR<Ledsagemåde<de_selv
erserusufferujussuanneeriarfilererusuppit	ersi+GUSUP+FIK-RUJUK=SUAQ<flertal<min<Lokalis+IP-RIAR+FIK-LIRI+GUSUP<Interrogativ<du
erserusufferujussuannili	ersi+GUSUP+FIK-RUJUK=SUAQ<flertal<min<Lokalis+LI
erserusufferujooqqaarama	ersi+GUSUP+FIK-RUJUK-U-QQAAR<Causativ<jeg
erserusuttormiooqqaarnerpaanngunngilasi	ersi+GUSUP+TUQ+MIU-U-QQAAR+NIRPAAQ-NNGUR-NNGIT<Interrogativ<I
ersilaarpugut	ersi-LAAR<Indikativ<vi
ersilaarnini	ersi-LAAR+NIQ<ental<sin<Absolut
ersillutik	ersi<Ledsagemåde<de_selv
ersiniarlutik	ersi+NIAR<Ledsagemåde<de_selv
ersinikuufferujunngussappullu	ersi+NIKUU+FIK-RUJUK-NNGUR-SSA<Indikativ<de+LU
ersineruffilerisimanerni	ersi+NIRU+FIK-LIRI+SIMA+NIQ<flertal<Lokalis
ersisulluunniit	ersi<Participium<de+LUUNNIIT
erseqqaartoorusukkama	ersi-QQAAR+TUQ-U+GUSUP<Causativ<jeg
erseqaarli	ersi-QӘ<Indikativ<han+LI
erseriarfinni	ersi-RIAR+FIK<flertal<Lokalis
erseriarfeqariarlutilluunniit	ersi-RIAR+FIK-QAR-RIAR<Ledsagemåde<de_selv+LUUNNIIT
ersereerattaluunniit	ersi-RIIR<Causativ<vi+LUUNNIIT
ersereerpit	ersi-RIIR<Interrogativ<du
ersereerneraana	ersi-RIIR+NIQ<ental<hans<Absolut+UNA
ersereernerpaarsiulaarpa	ersi-RIIR+NIRPAAQ+SIUR-LAAR<Interrogativ<han
ersisimasarpisi	ersi+SIMA=TAR<Interrogativ<I
ersissallutik	ersi-SSA<Ledsagemåde<de_selv
ersisaraluarferujooqqutigillu	ersi+TAR=GALUAR+FIK-RUJUK-U-QQU<Imperativ<ViDem+LU
ersisariaqarpunga	ersi+TARIAQAR<Indikativ<jeg
ersisariaqarninili	ersi+TARIAQAR+NIQ<ental<sin<Absolut+LI
ersivifferujugivallaarpakka	ersi-VIP+FIK-RUJUK+GӘ+VALLAAR<Indikativ<JegDem
Esbjerg	Esbjerg<Absolut
Esbjergili	Esbjerg<Absolut+LI
Esbjergilu	Esbjerg<Absolut+LU
Esbjergiuna	Esbjerg<Absolut+UNA
Esbjergimik	Esbjerg<Instrumentalis
Esbjergimilli	Esbjerg<Instrumentalis+LI
Esbjergimillu	Esbjerg<Instrumentalis+LU
Esbjergimilluunniit	Esbjerg<Instrumentalis+LUUNNIIT
Esbjergiminguna	Esbjerg<Instrumentalis+UNA
Esbjergimi	Esbjerg<Lokalis
Esbjergimiikkattalu	Esbjerg<Lokalis+IP<Causativ<vi+LU
Esbjergimiilaarlutinguna	Esbjerg<Lokalis+IP-LAAR<Ledsagemåde<de_selv+UNA
Esbjergimiilaartarneq	Esbjerg<Lokalis+IP-LAAR=TAR+NIQ<ental<Absolut
Esbjergimeeqqaarpa	Esbjerg<Lokalis+IP-QQAAR<Interrogativ<han
Esbjergimeeqqummanga	Esbjerg<Lokalis+IP-QQU<Causativ<HanMig
Esbjergimeeqqutigilli	Esbjerg<Lokalis+IP-QQU<Imperativ<ViDem+LI
Esbjergimeeqquakkali	Esbjerg<Lokalis+IP-QQU<Indikativ<JegDem+LI
Esbjergimeeqquara	Esbjerg<Lokalis+IP-QQU<Indikativ<JegHam
Esbjergimeeqquarpulluunniit	Esbjerg<Lokalis+IP-QQU<Indikativ<ViHam+LUUNNIIT
Esbjergimeeqqulara	Esbjerg<Lokalis+IP-QQU<Optativ<JegHam
Esbjergimeeriarmata	Esbjerg<Lokalis+IP-RIAR<Causativ<de
Esbjergimeeriarmalli	Esbjerg<Lokalis+IP-RIAR<Causativ<han+LI
Esbjergimeeriarfinneeqqugakku	Esbjerg<Lokalis+IP-RIAR+FIK<ental<min<Lokalis+IP-QQU<Causativ<JegHam
Esbjergimeeriarfilerereertullu	Esbjerg<Lokalis+IP-RIAR+FIK-LIRI-RIIR<Participium<de+LU
Esbjergimeeriarfissartaalaartarferujussuaminilli	Esbjerg<Lokalis+IP-RIAR+FIK-SSAQ+TAAR-LAAR=TAR+FIK-RUJUK=SUAQ<flertal<sin<Instrumentalis+LI
Esbjergimeeriarlutilli	Esbjerg<Lokalis+IP-RIAR<Ledsagemåde<de_selv+LI
Esbjergimeeriarnini	Esbjerg<Lokalis+IP-RIAR+NIQ<ental<sin<Absolut
Esbjergimeereerpunga	Esbjerg<Lokalis+IP-RIIR<Indikativ<jeg
Esbjergimeereerpit	Esbjerg<Lokalis+IP-RIIR<Interrogativ<du
Esbjergimeereerlutilli	Esbjerg<Lokalis+IP-RIIR<Ledsagemåde<de_selv+LI
Esbjergimeereertoqarpoq	Esbjerg<Lokalis+IP-RIIR+TUQ-QAR<Indikativ<han
Esbjergimeereertoqanngilaq	Esbjerg<Lokalis+IP-RIIR+TUQ-QAR-NNGIT<Indikativ<han
Esbjergimiittoqanngilaq	Esbjerg<Lokalis+IP+TUQ-QAR-NNGIT<Indikativ<han
Esbjergimili	Esbjerg<Lokalis+LI
Esbjergimilu	Esbjerg<Lokalis+LU
Esbjergimiuminguna	Esbjerg+MIU<ental<Instrumentalis+UNA
Esbjergimiumukariartorpassuinuna	Esbjerg+MIU<ental<Terminalis-KAR-RIAR+TUQ+PASSUAQ<flertal<Absolut+UNA
Esbjergimiuni	Esbjerg+MIU<flertal<Lokalis
Esbjergimiuniilaartaratta	Esbjerg+MIU<flertal<Lokalis+IP-LAAR=TAR<Causativ<vi
Esbjergimiuneeqqaarpoq	Esbjerg+MIU<flertal<Lokalis+IP-QQAAR<Indikativ<han
Esbjergimiulerivit	Esbjerg+MIU-LIRI<Interrogativ<du
Esbjergimiulereqqaartorli	Esbjerg+MIU-LIRI-QQAAR<Participium<han+LI
Esbjergimiulereriarneratali	Esbjerg+MIU-LIRI-RIAR+NIQ<ental<deres<Relativ+LI
Esbjergimiulerisimasarpununa	Esbjerg+MIU-LIRI+SIMA=TAR<Indikativ<de+UNA
Esbjergimiunngulaarfippassui	Esbjerg+MIU-NNGUR-LAAR+FIK+PASSUAQ<flertal<deres<Absolut
Esbjergimiunngoqisoq	Esbjerg+MIU-NNGUR-QӘ<Participium<han
Esbjergimioqarpoq	Esbjerg+MIU-QAR<Indikativ<han
Esbjergimioqarporluunniit	Esbjerg+MIU-QAR<Indikativ<han+LUUNNIIT
Esbjergimioqarpa	Esbjerg+MIU-QAR<Interrogativ<han
Esbjergimioqarneq	Esbjerg+MIU-QAR+NIQ<ental<Absolut
Esbjergimioqarnerli	Esbjerg+MIU-QAR+NIQ<ental<Absolut+LI
Esbjergimioqarneruna	Esbjerg+MIU-QAR+NIQ<ental<Absolut+UNA
Esbjergimioqartoq	Esbjerg+MIU-QAR<Participium<han
Esbjergimioqartorlu	Esbjerg+MIU-QAR<Participium<han+LU
Esbjergimioqartoq	Esbjerg+MIU-QAR+TUQ<ental<Absolut
Esbjergimioqartorli	Esbjerg+MIU-QAR+TUQ<ental<Absolut+LI
Esbjergimioqartorluunniit	Esbjerg+MIU-QAR+TUQ<ental<Absolut+LUUNNIIT
Esbjergimioorusuffii	Esbjerg+MIU-U+GUSUP+FIK<flertal<deres<Absolut
Esbjergimiuuisi	Esbjerg+MIU-U<Interrogativ<I
Esbjergimiuulaartoq	Esbjerg+MIU-U-LAAR<Participium<han
Esbjergimiuulluinnartussaagaluanni	Esbjerg+MIU-U+LUINNAR+TUQ-SSAQ=U=GALUAQ<ental<min<Lokalis
Esbjergimiuunerunerit	Esbjerg+MIU-U+NIRU+NIQ<flertal<Relativ
Esbjergimiooqqaarneratali	Esbjerg+MIU-U-QQAAR+NIQ<ental<hans<Relativ+LI
Esbjergimiooqqutigit	Esbjerg+MIU-U-QQU<Imperativ<ViDem
Esbjergimiooqimmatali	Esbjerg+MIU-U-QӘ<Causativ<de+LI
Esbjergimiooriarmata	Esbjerg+MIU-U-RIAR<Causativ<de
Esbjergimiooreerlutinguna	Esbjerg+MIU-U-RIIR<Ledsagemåde<de_selv+UNA
Esbjergimiuusimanini	Esbjerg+MIU-U+SIMA+NIQ<ental<sin<Absolut
Esbjergimiuutippaannga	Esbjerg+MIU-U+TIP<Indikativ<DeMig
Esbjergimiuusussaaffeqaqqummanga	Esbjerg+MIU-U+TUQ=SSAQ=U+FIK-QAR-QQU<Causativ<HanMig
Esbjergimiuuallaanngitsorujussualu	Esbjerg+MIU-U+VALLAAR=NNGIT+TUQ-RUJUK=SUAQ<ental<hans<Absolut+LU
Esbjergimut	Esbjerg<Terminalis
Esbjergimukalaaratta	Esbjerg<Terminalis-KAR-LAAR<Causativ<vi
Esbjergimukalaartarattali	Esbjerg<Terminalis-KAR-LAAR=TAR<Causativ<vi+LI
Esbjergimukalaartartoq	Esbjerg<Terminalis-KAR-LAAR=TAR+TUQ<ental<Absolut
Esbjergimukalaartartoqanngilarli	Esbjerg<Terminalis-KAR-LAAR=TAR+TUQ-QAR-NNGIT<Indikativ<han+LI
Esbjergimukalerlutilli	Esbjerg<Terminalis-KAR-LIR<Ledsagemåde<de_selv+LI
Esbjergimukanngilagulli	Esbjerg<Terminalis-KAR-NNGIT<Indikativ<vi+LI
Esbjergimukanngilagullu	Esbjerg<Terminalis-KAR-NNGIT<Indikativ<vi+LU
Esbjergimukanngitsut	Esbjerg<Terminalis-KAR-NNGIT<Participium<de
Esbjergimukanngitsunga	Esbjerg<Terminalis-KAR-NNGIT<Participium<jeg
Esbjergimukanngitsoq	Esbjerg<Terminalis-KAR-NNGIT+TUQ<ental<Absolut
Esbjergimukanngitsoruna	Esbjerg<Terminalis-KAR-NNGIT+TUQ<ental<Absolut+UNA
Esbjergimukaqquassilu	Esbjerg<Terminalis-KAR-QQU<Indikativ<JegJer+LU
Esbjergimukariartukkunnili	Esbjerg<Terminalis-KAR-RIAR+TUQ-KKUT<flertal<Lokalis+LI
Esbjergimukareerlutik	Esbjerg<Terminalis-KAR-RIIR<Ledsagemåde<de_selv
Esbjergimukassaaq	Esbjerg<Terminalis-KAR-SSA<Indikativ<han
Esbjergimukavikkama	Esbjerg<Terminalis-KAR-VIP<Causativ<jeg
Esbjergimulli	Esbjerg<Terminalis+LI
Esbjergimullu	Esbjerg<Terminalis+LU
Esbjergimulluunniit	Esbjerg<Terminalis+LUUNNIIT
Esbjergimununa	Esbjerg<Terminalis+UNA
Esbjergikkut	Esbjerg<Vialis
Esbjergikkulli	Esbjerg<Vialis+LI
Esbjergikkullu	Esbjerg<Vialis+LU
Esbjergikkulluunniit	Esbjerg<Vialis+LUUNNIIT
Esbjergikkununa	Esbjerg<Vialis+UNA
fiistermalli	fiister<Causativ<han+LI
fiisterattalu	fiister<Causativ<vi+LU
fiisterattaluunniit	fiister<Causativ<vi+LUUNNIIT
fiisterfiillu	fiister+FIK<flertal<Absolut+LU
fiisterfissalereerlarali	fiister+FIK-SSAQ-LIR_nv-RIIR<Optativ<JegHam+LI
fiisteraluarpa	fiister+GALUAR<Interrogativ<han
fiisteriartorfililerisinnaallutilli	fiister+GIARTUR+FIK-LIK-LIRI+SINNAA<Ledsagemåde<de_selv+LI
fiisteriartorpunga	fiister+GIARTUR<Indikativ<jeg
fiisterunnaarmalli	fiister+GUNNAAR<Causativ<han+LI
fiisterunnaarnerpaanngussasungaana	fiister+GUNNAAR+NIRPAAQ-NNGUR-SSA<Participium<jeg+UNA
fiisterunnaartorluunniit	fiister+GUNNAAR<Participium<han+LUUNNIIT
fiisterusummallu	fiister+GUSUP<Causativ<han+LU
fiisterusullutillu	fiister+GUSUP<Ledsagemåde<de_selv+LU
fiistiinnarmalluunniit	fiister-INNAR<Causativ<han+LUUNNIIT
fiistiinnarfissaa	fiister-INNAR+FIK-SSAQ<flertal<hans<Absolut
fiistiinnarpugulluunniit	fiister-INNAR<Indikativ<vi+LUUNNIIT
fiistiinnarpisi	fiister-INNAR<Interrogativ<I
fiistiinnarlutik	fiister-INNAR<Ledsagemåde<de_selv
fiistiinnarnerpaaqariarfippassuarnukalaarpisi	fiister-INNAR+NIRPAAQ-QAR-RIAR+FIK+PASSUAQ<flertal<Terminalis-KAR-LAAR<Interrogativ<I
fiistiinnartorluunniit	fiister-INNAR<Participium<han+LUUNNIIT
fiistiinnartuma	fiister-INNAR+TUQ<ental<min<Relativ
fiistiinnartorujussuaq	fiister-INNAR+TUQ-RUJUK=SUAQ<ental<Absolut
fiisterpit	fiister<Interrogativ<du
fiistilaarmata	fiister-LAAR<Causativ<de
fiistilaarnini	fiister-LAAR+NIQ<ental<sin<Absolut
fiistilaarnerpaanni	fiister-LAAR+NIRPAAQv<flertal<min<Lokalis
fiistilaartarpit	fiister-LAAR=TAR<Interrogativ<du
fiistilaartarpa	fiister-LAAR=TAR<Interrogativ<han
fiistilaartarnerpaavili	fiister-LAAR=TAR+NIRPAAQ<flertal<hans<Absolut+LI
fiistilaartarnerpaaqalaarpa	fiister-LAAR=TAR+NIRPAAQ-QAR-LAAR<Interrogativ<han
fiistilaartartulerivifferujussuanneeqqaartunga	fiister-LAAR=TAR+TUQ-LIRI-VIP+FIK-RUJUK=SUAQ<ental<min<Lokalis+IP-QQAAR<Participium<jeg
fiistilaartartorujoqareerneraana	fiister-LAAR=TAR+TUQ-RUJUK-QAR-RIIR+NIQ<ental<hans<Absolut+UNA
fiistilaartoriilerinatinguna	fiister-LAAR+TUQ+GIIT-LIRI-NNGIT<Ledsagemåde<de_selv+UNA
fiistilaartorujuattulli	fiister-LAAR+TUQ-RUJUK<ental<deres<Aequalis+LI
fiistilaartuusullu	fiister-LAAR+TUQ-U<Participium<de+LU
fiisterlutik	fiister<Ledsagemåde<de_selv
fiistilermalli	fiister-LIR<Causativ<han+LI
fiistilerpunga	fiister-LIR<Indikativ<jeg
fiistilerpungali	fiister-LIR<Indikativ<jeg+LI
fiistilerpugullu	fiister-LIR<Indikativ<vi+LU
fiistilerpit	fiister-LIR<Interrogativ<du
fiistilerlutik	fiister-LIR<Ledsagemåde<de_selv
fiistilerlutillu	fiister-LIR<Ledsagemåde<de_selv+LU
fiistilernini	fiister-LIR+NIQ<ental<sin<Absolut
fiistilernerilli	fiister-LIR+NIQ<flertal<Relativ+LI
fiistilernerpaaq	fiister-LIR+NIRPAAQ<ental<Absolut
fiistilernerpaaqaqqullugit	fiister-LIR+NIRPAAQ-QAR-QQU<Ledsagemåde<dem
fiistilernerpaannili	fiister-LIR+NIRPAAQv<flertal<min<Lokalis+LI
fiistilertulilereqqaarnerpaani	fiister-LIR+TUQ-LIK-LIRI-QQAAR+NIRPAAQ<flertal<Lokalis
fiistilertorujooqquaanga	fiister-LIR+TUQ-RUJUK-U-QQU<Indikativ<HanMig
fiisterluarpit	fiister+LUAR<Interrogativ<du
fiisterluinnartussartaaqqualluunniit	fiister+LUINNAR+TUQ-SSAQ+TAAR-QQU<Indikativ<DuHam+LUUNNIIT
fiisterniarnatilluunniit	fiister+NIAR=NNGIT<Ledsagemåde<de_selv+LUUNNIIT
fiisternianngitsorli	fiister+NIAR=NNGIT<Participium<han+LI
fiisterneruna	fiister+NIQ<ental<Absolut+UNA
fiisternermaluunniit	fiister+NIQ<ental<min<Relativ+LUUNNIIT
fiisternerferujoqassagaluarmalli	fiister+NIR+FIK-RUJUK-QAR-SSA=GALUAR<Causativ<han+LI
fiisternerpaaneeriarlutillu	fiister+NIRPAAQ<flertal<Lokalis+IP-RIAR<Ledsagemåde<de_selv+LU
fiisternerpaanngoriarfeqaqisorujooqaanga	fiister+NIRPAAQ-NNGUR-RIAR+FIK-QAR-QӘ+TUQ-RUJUK-U-QӘ<Indikativ<jeg
fiisternerpaaqaqaangalu	fiister+NIRPAAQ-QAR-QӘ<Indikativ<jeg+LU
fiisternerpaarsioriarferujussioqqugakkuluunniit	fiister+NIRPAAQ+SIUR-RIAR+FIK-RUJUK+SIUR-QQU<Causativ<JegHam+LUUNNIIT
fiisternerpaata	fiister+NIRPAAQvv<ental<hans<Relativ
fiisternertulereqqutigit	fiister+NIR+TUQ-LIRI-QQU<Imperativ<ViDem
fiisternerummalli	fiister+NIRU<Causativ<han+LI
fiistinngimmata	fiister-NNGIT<Causativ<de
fiistinngimmat	fiister-NNGIT<Causativ<han
fiistinngiffiinnaminilluunniit	fiister-NNGIT+FIK-INNAQ<flertal<sin<Instrumentalis+LUUNNIIT
fiistinngiffikkui	fiister-NNGIT+FIK-KKUT<flertal<hans<Absolut
fiistinngiffilereqquassiluunniit	fiister-NNGIT+FIK-LIRI-QQU<Indikativ<JegJer+LUUNNIIT
fiistinngifferujussioqaalli	fiister-NNGIT+FIK-RUJUK+SIUR-QӘ<Indikativ<de+LI
fiistinngifferujussuaana	fiister-NNGIT+FIK-RUJUK=SUAQ<ental<hans<Absolut+UNA
fiistinngifferujussuili	fiister-NNGIT+FIK-RUJUK=SUAQ<flertal<deres<Absolut+LI
fiistinngifferujussui	fiister-NNGIT+FIK-RUJUK=SUAQ<flertal<hans<Absolut
fiistinngilanga	fiister-NNGIT<Indikativ<jeg
fiistinnginnera	fiister-NNGIT+NIQ<ental<hans<Absolut
fiistinnginninilu	fiister-NNGIT+NIQ<ental<sin<Absolut+LU
fiistinngitsulli	fiister-NNGIT<Participium<de+LI
fiistinngitsoq	fiister-NNGIT+TUQ<ental<Absolut
fiistinngitsukoorusunnerpaannili	fiister-NNGIT+TUQ-KU-U+GUSUP+NIRPAAQv<flertal<min<Lokalis+LI
fiisteqqaarfeqaannarmatali	fiister-QQAAR+FIK-QAR-INNAR<Causativ<de+LI
fiisteqqaarferujulli	fiister-QQAAR+FIK-RUJUK<ental<Absolut+LI
fiisteqqaarpunga	fiister-QQAAR<Indikativ<jeg
fiisteqqaarpit	fiister-QQAAR<Interrogativ<du
fiisteqqaarlutilli	fiister-QQAAR<Ledsagemåde<de_selv+LI
fiisteqqaarlutinguna	fiister-QQAAR<Ledsagemåde<de_selv+UNA
fiisteqqaarnerata	fiister-QQAAR+NIQ<ental<deres<Relativ
fiisteqqaarnerillu	fiister-QQAAR+NIQ<flertal<Absolut+LU
fiisteqqaarnerpaatullu	fiister-QQAAR+NIRPAAQv<ental<Aequalis+LU
fiisteqqaartut	fiister-QQAAR<Participium<de
fiisteqqaartulli	fiister-QQAAR<Participium<de+LI
fiisteqqugakku	fiister-QQU<Causativ<JegHam
fiisteqqugakkuluunniit	fiister-QQU<Causativ<JegHam+LUUNNIIT
fiisteqqutigit	fiister-QQU<Imperativ<ViDem
fiisteqqutigilli	fiister-QQU<Imperativ<ViDem+LI
fiisteqqutiginuna	fiister-QQU<Imperativ<ViDem+UNA
fiisteqquaa	fiister-QQU<Indikativ<HanHam
fiisteqqullunga	fiister-QQU<Ledsagemåde<mig
fiisteqqularaluunniit	fiister-QQU<Optativ<JegHam+LUUNNIIT
fiisteqimmatali	fiister-QӘ<Causativ<de+LI
fiisteqigatta	fiister-QӘ<Causativ<vi
fiisteqaat	fiister-QӘ<Indikativ<de
fiisteqaaq	fiister-QӘ<Indikativ<han
fiisteqaagut	fiister-QӘ<Indikativ<vi
fiisteqaagulli	fiister-QӘ<Indikativ<vi+LI
fiisteqaat	fiister-QӘ<Interrogativ<du
fiisteqalutilli	fiister-QӘ<Ledsagemåde<de_selv+LI
fiisteqalutinguna	fiister-QӘ<Ledsagemåde<de_selv+UNA
fiisteqisorluunniit	fiister-QӘ<Participium<han+LUUNNIIT
fiisteqisunga	fiister-QӘ<Participium<jeg
fiisteqisorujussuili	fiister-QӘ+TUQ-RUJUK=SUAQ<flertal<hans<Absolut+LI
fiisteriarferujussuata	fiister-RIAR+FIK-RUJUK=SUAQ<ental<deres<Relativ
fiisteriarnerlu	fiister-RIAR+NIQ<ental<Absolut+LU
fiisteriarnini	fiister-RIAR+NIQ<ental<sin<Absolut
fiisteriarnerit	fiister-RIAR+NIQ<flertal<Absolut
fiisteriarnerilluunniit	fiister-RIAR+NIQ<flertal<Absolut+LUUNNIIT
fiistereerfeqavillutinguna	fiister-RIIR+FIK-QAR-VIP<Ledsagemåde<de_selv+UNA
fiistereerpungali	fiister-RIIR<Indikativ<jeg+LI
fiistereerpit	fiister-RIIR<Interrogativ<du
fiistereernernullu	fiister-RIIR+NIQ<flertal<Terminalis+LU
fiistereernerpaannguinnerpaaq	fiister-RIIR+NIRPAAQ-NNGUR-VIP+NIRPAAQ<ental<Absolut
fiistereernerpaannguittoqavippunga	fiister-RIIR+NIRPAAQ-NNGUR-VIP+TUQ-QAR-VIP<Indikativ<jeg
fiistereertut	fiister-RIIR<Participium<de
fiistereertunga	fiister-RIIR<Participium<jeg
fiistersimava	fiister+SIMA<Interrogativ<han
fiistersinnaagama	fiister+SINNAA<Causativ<jeg
fiistersinnaaffioqisununa	fiister+SINNAA+FIK-U-QӘ<Participium<de+UNA
fiistersinnaasulilerlaraana	fiister+SINNAA+TUQ-LIR_nv-LIR<Optativ<JegHam+UNA
fiistissammat	fiister-SSA<Causativ<han
fiistissagaluarmata	fiister-SSA=GALUAR<Causativ<de
fiistissagaluarfeqalerferujussuata	fiister-SSA=GALUAR+FIK-QAR-LIR+FIK-RUJUK=SUAQ<ental<hans<Relativ
fiistissagaluarferujoorusullutik	fiister-SSA=GALUAR+FIK-RUJUK-U+GUSUP<Ledsagemåde<de_selv
fiistissagaluarfioqqullugillu	fiister-SSA=GALUAR+FIK-U-QQU<Ledsagemåde<dem+LU
fiistissagaluarlutik	fiister-SSA=GALUAR<Ledsagemåde<de_selv
fiistissagaluarnerpaaqarsinnaanerpaameereerlutilluunniit	fiister-SSA=GALUAR+NIRPAAQ-QAR+SINNAA+NIRPAAQ<ental<Instrumentalis-IR-RIIR<Ledsagemåde<de_selv+LUUNNIIT
fiistissagaluarnerpaanneeqqulara	fiister-SSA=GALUAR+NIRPAAQv<flertal<min<Lokalis+IP-QQU<Optativ<JegHam
fiistissagaluartungalu	fiister-SSA=GALUAR<Participium<jeg+LU
fiistissappullu	fiister-SSA<Indikativ<de+LU
fiistissaagut	fiister-SSA<Indikativ<vi
fiistissavit	fiister-SSA<Interrogativ<du
fiistissallutik	fiister-SSA<Ledsagemåde<de_selv
fiistissasoq	fiister-SSA<Participium<han
fiistissasunga	fiister-SSA<Participium<jeg
fiistertaraluartussaagaluit	fiister+TAR=GALUAR+TUQ-SSAQ=U=GALUAQ<flertal<Absolut
fiistertikkakkuli	fiister+TIP<Causativ<JegHam+LI
fiistertitsigit	fiister+TIP<Imperativ<ViDem
fiistertipparpununa	fiister+TIP<Indikativ<ViHam+UNA
fiistertorujorujussuullutilli	fiister+TUQ=RUJUK=RUJUK=SUAQ=U<Ledsagemåde<de_selv+LI
fiistertorujussuuffeqassagaluartununa	fiister+TUQ=RUJUK=SUAQ=U+FIK-QAR-SSA=GALUAR<Participium<de+UNA
fiistertorujussuusunngulaartarnerpaarsioqqummanga	fiister+TUQ=RUJUK=SUAQ=U+TUQ-NNGUR-LAAR=TAR+NIRPAAQ+SIUR-QQU<Causativ<HanMig
fiistertussaafferujussuaq	fiister+TUQ=SSAQ=U+FIK-RUJUK=SUAQ<ental<Absolut
fiisterpallaarlutik	fiister+VALLAAR<Ledsagemåde<de_selv
fiisterpallaartumeeqqaarpugulluunniit	fiister+VALLAAR+TUQ<ental<Lokalis+IP-QQAAR<Indikativ<vi+LUUNNIIT
fiistivimmalluunniit	fiister-VIP<Causativ<han+LUUNNIIT
fiistivimmanuna	fiister-VIP<Causativ<han+UNA
fiistivikkama	fiister-VIP<Causativ<jeg
fiistiviffiiuna	fiister-VIP+FIK<flertal<hans<Absolut+UNA
fiistivippungali	fiister-VIP<Indikativ<jeg+LI
fiistivippit	fiister-VIP<Interrogativ<du
fiistivippisi	fiister-VIP<Interrogativ<I
fiistivinnerat	fiister-VIP+NIQ<ental<deres
fiistivinnerpaaqavinnerpaanniissasunga	fiister-VIP+NIRPAAQ-QAR-VIP+NIRPAAQv<flertal<min<Lokalis+IP-SSA<Participium<jeg
Finland	Finland<Absolut
Finlandili	Finland<Absolut+LI
Finlandiluunniit	Finland<Absolut+LUUNNIIT
Finlandiuna	Finland<Absolut+UNA
Finlandimik	Finland<Instrumentalis
Finlandimilli	Finland<Instrumentalis+LI
Finlandimillu	Finland<Instrumentalis+LU
Finlandimilluunniit	Finland<Instrumentalis+LUUNNIIT
Finlandiminguna	Finland<Instrumentalis+UNA
Finlandimi	Finland<Lokalis
Finlandimiimmatali	Finland<Lokalis+IP<Causativ<de+LI
Finlandimiiginnarpunga	Finland<Lokalis+IP-INNAR<Indikativ<jeg
Finlandimiilaarpoq	Finland<Lokalis+IP-LAAR<Indikativ<han
Finlandimiilaartulli	Finland<Lokalis+IP-LAAR<Participium<de+LI
Finlandimiinnerullutik	Finland<Lokalis+IP+NIRU<Ledsagemåde<de_selv
Finlandimeeqqaarlutik	Finland<Lokalis+IP-QQAAR<Ledsagemåde<de_selv
Finlandimeeqqaarlutillu	Finland<Lokalis+IP-QQAAR<Ledsagemåde<de_selv+LU
Finlandimeeqqaarneruna	Finland<Lokalis+IP-QQAAR+NIQ<ental<Absolut+UNA
Finlandimeeqqaartoq	Finland<Lokalis+IP-QQAAR<Participium<han
Finlandimeeqqaartoqanngilaq	Finland<Lokalis+IP-QQAAR+TUQ-QAR-NNGIT<Indikativ<han
Finlandimeeqqugakku	Finland<Lokalis+IP-QQU<Causativ<JegHam
Finlandimeeqqugakkuuna	Finland<Lokalis+IP-QQU<Causativ<JegHam+UNA
Finlandimeeqqutiginuna	Finland<Lokalis+IP-QQU<Imperativ<ViDem+UNA
Finlandimeeqquai	Finland<Lokalis+IP-QQU<Indikativ<HanDem
Finlandimeeqquiuk	Finland<Lokalis+IP-QQU<Interrogativ<DuHam
Finlandimeeqqullugu	Finland<Lokalis+IP-QQU<Ledsagemåde<ham
Finlandimeeqqulara	Finland<Lokalis+IP-QQU<Optativ<JegHam
Finlandimeeriarmatali	Finland<Lokalis+IP-RIAR<Causativ<de+LI
Finlandimeeriarfinneereerpunga	Finland<Lokalis+IP-RIAR+FIK<flertal<Instrumentalis-IR-RIIR<Indikativ<jeg
Finlandimeeriarlutik	Finland<Lokalis+IP-RIAR<Ledsagemåde<de_selv
Finlandimeereerpit	Finland<Lokalis+IP-RIIR<Interrogativ<du
Finlandimeereerlutik	Finland<Lokalis+IP-RIIR<Ledsagemåde<de_selv
Finlandimeereerneq	Finland<Lokalis+IP-RIIR+NIQ<ental<Absolut
Finlandimeereertoruna	Finland<Lokalis+IP-RIIR<Participium<han+UNA
Finlandimeereertunga	Finland<Lokalis+IP-RIIR<Participium<jeg
Finlandimiivinnerluunniit	Finland<Lokalis+IP-VIP+NIQ<ental<Absolut+LUUNNIIT
Finlandimili	Finland<Lokalis+LI
Finlandimilu	Finland<Lokalis+LU
Finlandimiluunniit	Finland<Lokalis+LUUNNIIT
Finlandimiu	Finland+MIU<ental<Absolut
Finlandimiumili	Finland+MIU<ental<Lokalis+LI
Finlandimiumulli	Finland+MIU<ental<Terminalis+LI
Finlandimiuneeqqaarmalli	Finland+MIU<flertal<Lokalis+IP-QQAAR<Causativ<han+LI
Finlandimiuniuna	Finland+MIU<flertal<Lokalis+UNA
Finlandimiulereqqaarpit	Finland+MIU-LIRI-QQAAR<Interrogativ<du
Finlandimiulereqqaartulluunniit	Finland+MIU-LIRI-QQAAR<Participium<de+LUUNNIIT
Finlandimiunngunnginnatta	Finland+MIU-NNGUR-NNGIT<Causativ<vi
Finlandimiunngoqqaarnerpaanngoqisulissagaluarlara	Finland+MIU-NNGUR-QQAAR+NIRPAAQ-NNGUR-QӘ+TUQ-LIR_nv-SSA=GALUAR<Optativ<JegHam
Finlandimiunngoqquarput	Finland+MIU-NNGUR-QQU<Indikativ<ViHam
Finlandimiunngoqisoq	Finland+MIU-NNGUR-QӘ<Participium<han
Finlandimiunngoriaratta	Finland+MIU-NNGUR-RIAR<Causativ<vi
Finlandimioqarporluunniit	Finland+MIU-QAR<Indikativ<han+LUUNNIIT
Finlandimioqarpa	Finland+MIU-QAR<Interrogativ<han
Finlandimioqarneq	Finland+MIU-QAR+NIQ<ental<Absolut
Finlandimioqartoq	Finland+MIU-QAR<Participium<han
Finlandimioqartoq	Finland+MIU-QAR+TUQ<ental<Absolut
Finlandimioqartorlu	Finland+MIU-QAR+TUQ<ental<Absolut+LU
Finlandimioqartorluunniit	Finland+MIU-QAR+TUQ<ental<Absolut+LUUNNIIT
Finlandimioqartoruna	Finland+MIU-QAR+TUQ<ental<Absolut+UNA
Finlandimioorusuttunga	Finland+MIU-U+GUSUP<Participium<jeg
Finlandimiuuinnarlutinguna	Finland+MIU-U-INNAR<Ledsagemåde<de_selv+UNA
Finlandimiuua	Finland+MIU-U<Interrogativ<han
Finlandimiuuniaratta	Finland+MIU-U+NIAR<Causativ<vi
Finlandimiuuniarpunga	Finland+MIU-U+NIAR<Indikativ<jeg
Finlandimiuuniarnatilli	Finland+MIU-U+NIAR=NNGIT<Ledsagemåde<de_selv+LI
Finlandimiuuneratalu	Finland+MIU-U+NIQ<ental<hans<Relativ+LU
Finlandimiooqimmata	Finland+MIU-U-QӘ<Causativ<de
Finlandimiooqisunga	Finland+MIU-U-QӘ<Participium<jeg
Finlandimiooqisussaneerpallaarlutilli	Finland+MIU-U-QӘ+TUQ-SSAQ<flertal<Instrumentalis-IR+VALLAAR<Ledsagemåde<de_selv+LI
Finlandimiooriarmallu	Finland+MIU-U-RIAR<Causativ<han+LU
Finlandimiooriarama	Finland+MIU-U-RIAR<Causativ<jeg
Finlandimiooriarnernullu	Finland+MIU-U-RIAR+NIQ<flertal<Terminalis+LU
Finlandimiooreerfissaagaluamininguna	Finland+MIU-U-RIIR+FIK-SSAQ=U=GALUAQ<flertal<sin<Instrumentalis+UNA
Finlandimiuusimanerilli	Finland+MIU-U+SIMA+NIQ<flertal<Relativ+LI
Finlandimiuusarferujooqalutillu	Finland+MIU-U+TAR+FIK-RUJUK-U-QӘ<Ledsagemåde<de_selv+LU
Finlandimiuuallaarnerpaameeriarlutillu	Finland+MIU-U+VALLAAR+NIRPAAQ<ental<Instrumentalis-IR-RIAR<Ledsagemåde<de_selv+LU
Finlandimut	Finland<Terminalis
Finlandimukarpungaluunniit	Finland<Terminalis-KAR<Indikativ<jeg+LUUNNIIT
Finlandimukaannartoqanngilaq	Finland<Terminalis-KAR-INNAR+TUQ-QAR-NNGIT<Indikativ<han
Finlandimukalaarlutilli	Finland<Terminalis-KAR-LAAR<Ledsagemåde<de_selv+LI
Finlandimukalaarnerli	Finland<Terminalis-KAR-LAAR+NIQ<ental<Absolut+LI
Finlandimukalerpununa	Finland<Terminalis-KAR-LIR<Indikativ<de+UNA
Finlandimukanngitsullu	Finland<Terminalis-KAR-NNGIT<Participium<de+LU
Finlandimukaqquaajuna	Finland<Terminalis-KAR-QQU<Indikativ<HanHam+UNA
Finlandimukaqquiuk	Finland<Terminalis-KAR-QQU<Interrogativ<DuHam
Finlandimukaqqulluguli	Finland<Terminalis-KAR-QQU<Ledsagemåde<ham+LI
Finlandimukaqqullunga	Finland<Terminalis-KAR-QQU<Ledsagemåde<mig
Finlandimukariarlutinguna	Finland<Terminalis-KAR-RIAR<Ledsagemåde<de_selv+UNA
Finlandimukariartullit	Finland<Terminalis-KAR-RIAR+TUQ-LIK<flertal<Absolut
Finlandimukassagaluarmatalu	Finland<Terminalis-KAR-SSA=GALUAR<Causativ<de+LU
Finlandimukassagaluartorlu	Finland<Terminalis-KAR-SSA=GALUAR<Participium<han+LU
Finlandimukassappulli	Finland<Terminalis-KAR-SSA<Indikativ<de+LI
Finlandimukavimmallu	Finland<Terminalis-KAR-VIP<Causativ<han+LU
Finlandimukavikkamali	Finland<Terminalis-KAR-VIP<Causativ<jeg+LI
Finlandimukavippungali	Finland<Terminalis-KAR-VIP<Indikativ<jeg+LI
Finlandimulli	Finland<Terminalis+LI
Finlandimullu	Finland<Terminalis+LU
Finlandimulluunniit	Finland<Terminalis+LUUNNIIT
Finlandimununa	Finland<Terminalis+UNA
Finlandikkut	Finland<Vialis
Finlandikkulli	Finland<Vialis+LI
Finlandikkullu	Finland<Vialis+LU
Finlandikkulluunniit	Finland<Vialis+LUUNNIIT
Finlandikkununa	Finland<Vialis+UNA
Gentofte	Gentofte<Absolut
Gentofteli	Gentofte<Absolut+LI
Gentoftelu	Gentofte<Absolut+LU
Gentofteluunniit	Gentofte<Absolut+LUUNNIIT
Gentofteuna	Gentofte<Absolut+UNA
Gentoftemik	Gentofte<Instrumentalis
Gentoftemilli	Gentofte<Instrumentalis+LI
Gentoftemillu	Gentofte<Instrumentalis+LU
Gentoftemilluunniit	Gentofte<Instrumentalis+LUUNNIIT
Gentofteminguna	Gentofte<Instrumentalis+UNA
Gentoftemi	Gentofte<Lokalis
Gentoftemiikkiartorlutinguna	Gentofte<Lokalis+IP+GIARTUR<Ledsagemåde<de_selv+UNA
Gentoftemiilaartartununa	Gentofte<Lokalis+IP-LAAR=TAR<Participium<de+UNA
Gentoftemiilluarnerlu	Gentofte<Lokalis+IP+LUAR+NIQ<ental<Absolut+LU
Gentoftemeeqqaarattalu	Gentofte<Lokalis+IP-QQAAR<Causativ<vi+LU
Gentoftemeeqqaarpungalu	Gentofte<Lokalis+IP-QQAAR<Indikativ<jeg+LU
Gentoftemeeqqaarpugut	Gentofte<Lokalis+IP-QQAAR<Indikativ<vi
Gentoftemeeqqaartungalu	Gentofte<Lokalis+IP-QQAAR<Participium<jeg+LU
Gentoftemeeqqulara	Gentofte<Lokalis+IP-QQU<Optativ<JegHam
Gentoftemeeriarmata	Gentofte<Lokalis+IP-RIAR<Causativ<de
Gentoftemeeriarfeqalaartartunga	Gentofte<Lokalis+IP-RIAR+FIK-QAR-LAAR=TAR<Participium<jeg
Gentoftemeeriarferujussuaq	Gentofte<Lokalis+IP-RIAR+FIK-RUJUK=SUAQ<ental<Absolut
Gentoftemeeriarlutik	Gentofte<Lokalis+IP-RIAR<Ledsagemåde<de_selv
Gentoftemeereermatali	Gentofte<Lokalis+IP-RIIR<Causativ<de+LI
Gentoftemeereerlutillu	Gentofte<Lokalis+IP-RIIR<Ledsagemåde<de_selv+LU
Gentoftemeereerneruna	Gentofte<Lokalis+IP-RIIR+NIQ<ental<Absolut+UNA
Gentoftemeereertunga	Gentofte<Lokalis+IP-RIIR<Participium<jeg
Gentoftemili	Gentofte<Lokalis+LI
Gentoftemilu	Gentofte<Lokalis+LU
Gentoftemiluunniit	Gentofte<Lokalis+LUUNNIIT
Gentoftemiuna	Gentofte<Lokalis+UNA
Gentoftemiua	Gentofte+MIU<ental<hans<Absolut
Gentoftemiumeeqqaartungali	Gentofte+MIU<ental<Instrumentalis-IR-QQAAR<Participium<jeg+LI
Gentoftemiumeeqqulluguli	Gentofte+MIU<ental<Instrumentalis-IR-QQU<Ledsagemåde<ham+LI
Gentoftemiunukareerpununa	Gentofte+MIU<flertal<flertal<Terminalis-KAR-RIIR<Indikativ<de+UNA
Gentoftemiuniilaartoq	Gentofte+MIU<flertal<Instrumentalis-IR-LAAR+TUQ<ental<Absolut
Gentoftemiuneeriarneralli	Gentofte+MIU<flertal<Instrumentalis-IR-RIAR+NIQ<ental<deres+LI
Gentoftemiuneerpallaannginneq	Gentofte+MIU<flertal<Instrumentalis-IR+VALLAAR=NNGIT+NIQ<ental<Absolut
Gentoftemiuneereermalli	Gentofte+MIU<flertal<Lokalis+IP-RIIR<Causativ<han+LI
Gentoftemiunili	Gentofte+MIU<flertal<Lokalis+LI
Gentoftemiunngoreerpoq	Gentofte+MIU-NNGUR-RIIR<Indikativ<han
Gentoftemioqalaarpa	Gentofte+MIU-QAR-LAAR<Interrogativ<han
Gentoftemioqalerpoq	Gentofte+MIU-QAR-LIR<Indikativ<han
Gentoftemioqanngimmanuna	Gentofte+MIU-QAR-NNGIT<Causativ<han+UNA
Gentoftemioqanngitsoq	Gentofte+MIU-QAR-NNGIT+TUQ
Gentoftemioqanngitsoruna	Gentofte+MIU-QAR-NNGIT+TUQ+UNA
Gentoftemioqaqqaarneq	Gentofte+MIU-QAR-QQAAR+NIQ<ental<Absolut
Gentoftemioqaqqullugu	Gentofte+MIU-QAR-QQU<Ledsagemåde<ham
Gentoftemioqariaratta	Gentofte+MIU-QAR-RIAR<Causativ<vi
Gentoftemioqassaarli	Gentofte+MIU-QAR-SSA<Indikativ<han+LI
Gentoftemiusioraluarpa	Gentofte+MIU+SIUR+GALUAR<Interrogativ<han
Gentoftemiusiuinnartoq	Gentofte+MIU+SIUR-INNAR<Participium<han
Gentoftemiusioqqaarpa	Gentofte+MIU+SIUR-QQAAR<Interrogativ<han
Gentoftemiusioqqaartoq	Gentofte+MIU+SIUR-QQAAR+TUQ<ental<Absolut
Gentoftemiusiussagaluarnerluunniit	Gentofte+MIU+SIUR-SSA=GALUAR+NIQ<ental<Absolut+LUUNNIIT
Gentoftemiutaalaartartorli	Gentofte+MIU+TAAR-LAAR=TAR+TUQ<ental<Absolut+LI
Gentoftemiutaaqquassi	Gentofte+MIU+TAAR-QQU<Indikativ<JegJer
Gentoftemiutaariartunnguatununa	Gentofte+MIU+TAAR-RIAR+TUQ-NNGUAQ<ental<Aequalis+UNA
Gentoftemiutaareerneq	Gentofte+MIU+TAAR-RIIR+NIQ<ental<Absolut
Gentoftemioorusukkattali	Gentofte+MIU-U+GUSUP<Causativ<vi+LI
Gentoftemiooqqaarporluunniit	Gentofte+MIU-U-QQAAR<Indikativ<han+LUUNNIIT
Gentoftemiooqqaarnerpaamininguna	Gentofte+MIU-U-QQAAR+NIRPAAQ<ental<sin<Instrumentalis+UNA
Gentoftemiooqaanga	Gentofte+MIU-U-QӘ<Indikativ<jeg
Gentoftemiooriarlutilluunniit	Gentofte+MIU-U-RIAR<Ledsagemåde<de_selv+LUUNNIIT
Gentoftemiooriarnerilluunniit	Gentofte+MIU-U-RIAR+NIQ<flertal<Absolut+LUUNNIIT
Gentoftemiooreeratta	Gentofte+MIU-U-RIIR<Causativ<vi
Gentoftemiuusimasarfinnununa	Gentofte+MIU-U+SIMA=TAR+FIK<flertal<Terminalis+UNA
Gentoftemiuusorujussuuvoq	Gentofte+MIU-U+TUQ=RUJUK=SUAQ=U<Indikativ<han
Gentoftemut	Gentofte<Terminalis
Gentoftemukaannartoqanngilaq	Gentofte<Terminalis-KAR-INNAR+TUQ-QAR-NNGIT<Indikativ<han
Gentoftemukalaarama	Gentofte<Terminalis-KAR-LAAR<Causativ<jeg
Gentoftemukalaartarpugulli	Gentofte<Terminalis-KAR-LAAR=TAR<Indikativ<vi+LI
Gentoftemukalaartartoq	Gentofte<Terminalis-KAR-LAAR=TAR<Participium<han
Gentoftemukalerneruna	Gentofte<Terminalis-KAR-LIR+NIQ<ental<Absolut+UNA
Gentoftemukannginnama	Gentofte<Terminalis-KAR-NNGIT<Causativ<jeg
Gentoftemukaqqaarlutilluunniit	Gentofte<Terminalis-KAR-QQAAR<Ledsagemåde<de_selv+LUUNNIIT
Gentoftemukareertoqarpoq	Gentofte<Terminalis-KAR-RIIR+TUQ-QAR<Indikativ<han
Gentoftemukarsimavugullu	Gentofte<Terminalis-KAR+SIMA<Indikativ<vi+LU
Gentoftemukassagatta	Gentofte<Terminalis-KAR-SSA<Causativ<vi
Gentoftemukassagaluaratta	Gentofte<Terminalis-KAR-SSA=GALUAR<Causativ<vi
Gentoftemukassagaluarporli	Gentofte<Terminalis-KAR-SSA=GALUAR<Indikativ<han+LI
Gentoftemukassagaluartorli	Gentofte<Terminalis-KAR-SSA=GALUAR<Participium<han+LI
Gentoftemukassagaluartunga	Gentofte<Terminalis-KAR-SSA=GALUAR<Participium<jeg
Gentoftemukavillutilli	Gentofte<Terminalis-KAR-VIP<Ledsagemåde<de_selv+LI
Gentoftemulli	Gentofte<Terminalis+LI
Gentoftemulluunniit	Gentofte<Terminalis+LUUNNIIT
Gentoftemununa	Gentofte<Terminalis+UNA
Gentoftekkut	Gentofte<Vialis
Gentoftekkulli	Gentofte<Vialis+LI
Gentoftekkullu	Gentofte<Vialis+LU
Gentoftekkulluunniit	Gentofte<Vialis+LUUNNIIT
Gentoftekkununa	Gentofte<Vialis+UNA
guitarermallu	guitarer<Causativ<han+LU
guitarerfigisorujorujussuulara	guitarer+FIK+GӘ+TUQ=RUJUK=RUJUK=SUAQ=U<Optativ<JegHam
guitarerfikkunni	guitarer+FIK-KKUT<flertal<Lokalis
guitarerferujussuit	guitarer+FIK-RUJUK=SUAQ<flertal<Absolut
guitareriartortorli	guitarer+GIARTUR<Participium<han+LI
guitarerunnaarneq	guitarer+GUNNAAR+NIQ<ental<Absolut
guitarerunnaartoq	guitarer+GUNNAAR<Participium<han
guitarerusullutinguna	guitarer+GUSUP<Ledsagemåde<de_selv+UNA
guitarerusunnerpaavali	guitarer+GUSUP+NIRPAAQ<ental<hans<Absolut+LI
guitarerpoq	guitarer<Indikativ<han
guitarerpugut	guitarer<Indikativ<vi
guitarerpugulli	guitarer<Indikativ<vi+LI
guitariinnarmatalu	guitarer-INNAR<Causativ<de+LU
guitariinnaratta	guitarer-INNAR<Causativ<vi
guitariinnarferujoorusufferujussuattulluunniit	guitarer-INNAR+FIK-RUJUK-U+GUSUP+FIK-RUJUK=SUAQ<ental<deres<Aequalis+LUUNNIIT
guitariinnarpunga	guitarer-INNAR<Indikativ<jeg
guitariinnarpugulli	guitarer-INNAR<Indikativ<vi+LI
guitariinnarnerillu	guitarer-INNAR+NIQ<flertal<Absolut+LU
guitariinnartulli	guitarer-INNAR<Participium<de+LI
guitariinnartorli	guitarer-INNAR<Participium<han+LI
guitarerpa	guitarer<Interrogativ<han
guitarilaarmat	guitarer-LAAR<Causativ<han
guitarilaarmalli	guitarer-LAAR<Causativ<han+LI
guitarilaaratta	guitarer-LAAR<Causativ<vi
guitarilaarfik	guitarer-LAAR+FIK<ental<Absolut
guitarilaarpisi	guitarer-LAAR<Interrogativ<I
guitarilaarlutik	guitarer-LAAR<Ledsagemåde<de_selv
guitarilaarninili	guitarer-LAAR+NIQ<ental<sin<Absolut+LI
guitarilaarnerpaanngoreerlutik	guitarer-LAAR+NIRPAAQ-NNGUR-RIIR<Ledsagemåde<de_selv
guitarilaartoq	guitarer-LAAR<Participium<han
guitarilaartarmata	guitarer-LAAR=TAR<Causativ<de
guitarilaartarferujussuataluunniit	guitarer-LAAR=TAR+FIK-RUJUK=SUAQ<ental<hans<Relativ+LUUNNIIT
guitarilaartarput	guitarer-LAAR=TAR<Indikativ<de
guitarilaartarpulli	guitarer-LAAR=TAR<Indikativ<de+LI
guitarilaartarpisi	guitarer-LAAR=TAR<Interrogativ<I
guitarilaartarlutilluunniit	guitarer-LAAR=TAR<Ledsagemåde<de_selv+LUUNNIIT
guitarilaartarnerpaata	guitarer-LAAR=TAR+NIRPAAQ<ental<deres<Relativ
guitarilaartartorujussuattulluunniit	guitarer-LAAR=TAR+TUQ-RUJUK=SUAQ<ental<deres<Aequalis+LUUNNIIT
guitarilaartartuujunnaarlutillu	guitarer-LAAR=TAR+TUQ-U+GUNNAAR<Ledsagemåde<de_selv+LU
guitarilaartartooqqutigilli	guitarer-LAAR=TAR+TUQ-U-QQU<Imperativ<ViDem+LI
guitarerlutilli	guitarer<Ledsagemåde<de_selv+LI
guitarileratta	guitarer-LIR<Causativ<vi
guitarilerattali	guitarer-LIR<Causativ<vi+LI
guitarilerpunga	guitarer-LIR<Indikativ<jeg
guitarilerpugulluunniit	guitarer-LIR<Indikativ<vi+LUUNNIIT
guitarilerpit	guitarer-LIR<Interrogativ<du
guitarilerpisi	guitarer-LIR<Interrogativ<I
guitarilerniniluunniit	guitarer-LIR+NIQ<ental<sin<Absolut+LUUNNIIT
guitarilernerilli	guitarer-LIR+NIQ<flertal<Relativ+LI
guitarilertut	guitarer-LIR<Participium<de
guitarilertorlu	guitarer-LIR<Participium<han+LU
guitarilertunga	guitarer-LIR<Participium<jeg
guitarilertukkut	guitarer-LIR+TUQ-KKUT<flertal<Absolut
guitarilertunngoreernini	guitarer-LIR+TUQ-NNGUR-RIIR+NIQ<ental<sin<Absolut
guitarilertorujummeeqqaartungali	guitarer-LIR+TUQ-RUJUK<ental<Instrumentalis-IR-QQAAR<Participium<jeg+LI
guitarilertorujoqariarneruna	guitarer-LIR+TUQ-RUJUK-QAR-RIAR+NIQ<ental<Absolut+UNA
guitarerluinnarnerpaanngoqqaarfissioreerpulli	guitarer+LUINNAR+NIRPAAQ-NNGUR-QQAAR+FIK+SIUR-RIIR<Indikativ<de+LI
guitarerniarnermali	guitarer+NIAR+NIQ<ental<min<Relativ+LI
guitarerniarnerpaartaassagaluartuinnaleqqaarakkuli	guitarer+NIAR+NIRPAAQ+TAAR-SSA=GALUAR+TUQ-INNAQ-LIR_nv-QQAAR<Causativ<JegHam+LI
guitarerniarnatilluunniit	guitarer+NIAR=NNGIT<Ledsagemåde<de_selv+LUUNNIIT
guitarernianngitsukoqaqimmallu	guitarer+NIAR=NNGIT+TUQ-KU-QAR-QӘ<Causativ<han+LU
guitarerniartoqaqaangali	guitarer+NIAR+TUQ-QAR-QӘ<Indikativ<jeg+LI
guitarerniartooreertussaagaluakkalu	guitarer+NIAR+TUQ-U-RIIR+TUQ-SSAQ=U=GALUAQ<flertal<min<Absolut+LU
guitarernerpaaminillu	guitarer+NIRPAAQ<ental<sin<Instrumentalis+LU
guitarernerpaaqaannarpa	guitarer+NIRPAAQ-QAR-INNAR<Interrogativ<han
guitarernertoq	guitarer+NIR<Participium<han
guitarernerufferujussuata	guitarer+NIRU+FIK-RUJUK=SUAQ<ental<deres<Relativ
guitarernerusoqassallutik	guitarer+NIRU+TUQ-QAR-SSA<Ledsagemåde<de_selv
guitarinngimmata	guitarer-NNGIT<Causativ<de
guitarinnginnattaluunniit	guitarer-NNGIT<Causativ<vi+LUUNNIIT
guitarinngila	guitarer-NNGIT<Interrogativ<han
guitarertoruna	guitarer<Participium<han+UNA
guitareqqaarferujulerissaagut	guitarer-QQAAR+FIK-RUJUK-LIRI-SSA<Indikativ<vi
guitareqqaarferujussuata	guitarer-QQAAR+FIK-RUJUK=SUAQ<ental<hans<Relativ
guitareqqaarpunga	guitarer-QQAAR<Indikativ<jeg
guitareqqaarnerpaaninguna	guitarer-QQAAR+NIRPAAQ<flertal<Instrumentalis+UNA
guitareqqaartungaana	guitarer-QQAAR<Participium<jeg+UNA
guitareqqaartoorusuffeqaqalutik	guitarer-QQAAR+TUQ-U+GUSUP+FIK-QAR-QӘ<Ledsagemåde<de_selv
guitareqqummangali	guitarer-QQU<Causativ<HanMig+LI
guitareqqugakku	guitarer-QQU<Causativ<JegHam
guitareqqutigit	guitarer-QQU<Imperativ<ViDem
guitareqqutigilli	guitarer-QQU<Imperativ<ViDem+LI
guitareqqutiginuna	guitarer-QQU<Imperativ<ViDem+UNA
guitareqquaajuna	guitarer-QQU<Indikativ<HanDem+UNA
guitareqquaa	guitarer-QQU<Indikativ<HanHam
guitareqquiuk	guitarer-QQU<Interrogativ<DuHam
guitareqqullungaluunniit	guitarer-QQU<Ledsagemåde<mig+LUUNNIIT
guitareqqulara	guitarer-QQU<Optativ<JegHam
guitareqalutinguna	guitarer-QӘ<Ledsagemåde<de_selv+UNA
guitareqisunga	guitarer-QӘ<Participium<jeg
guitareriarmatali	guitarer-RIAR<Causativ<de+LI
guitareriarmat	guitarer-RIAR<Causativ<han
guitareriaramaana	guitarer-RIAR<Causativ<jeg+UNA
guitareriaratta	guitarer-RIAR<Causativ<vi
guitareriarfippassui	guitarer-RIAR+FIK+PASSUAQ<flertal<hans<Absolut
guitareriarfeqalaartarfissaagaluannilu	guitarer-RIAR+FIK-QAR-LAAR=TAR+FIK-SSAQ=U=GALUAQ<ental<min<Lokalis+LU
guitareriarfissaagaluanniissallutik	guitarer-RIAR+FIK-SSAQ=U=GALUAQ<ental<min<Lokalis+IP-SSA<Ledsagemåde<de_selv
guitareriarlutik	guitarer-RIAR<Ledsagemåde<de_selv
guitarereermallu	guitarer-RIIR<Causativ<han+LU
guitarereerama	guitarer-RIIR<Causativ<jeg
guitarereerpunga	guitarer-RIIR<Indikativ<jeg
guitarereerlutillu	guitarer-RIIR<Ledsagemåde<de_selv+LU
guitarereernini	guitarer-RIIR+NIQ<ental<sin<Absolut
guitarereertut	guitarer-RIIR<Participium<de
guitarereertunga	guitarer-RIIR<Participium<jeg
guitarereertorujuginiarlarali	guitarer-RIIR+TUQ-RUJUK+GӘ+NIAR<Optativ<JegHam+LI
guitarereertorujussui	guitarer-RIIR+TUQ-RUJUK=SUAQ<flertal<deres<Absolut
guitarersimasartussaagaluiluunniit	guitarer+SIMA=TAR+TUQ-SSAQ=U=GALUAQ<flertal<hans<Absolut+LUUNNIIT
guitarissammallu	guitarer-SSA<Causativ<han+LU
guitarissagamali	guitarer-SSA<Causativ<jeg+LI
guitarissagattalu	guitarer-SSA<Causativ<vi+LU
guitarissagaluaramali	guitarer-SSA=GALUAR<Causativ<jeg+LI
guitarissagaluarfinni	guitarer-SSA=GALUAR+FIK<flertal<min<Lokalis
guitarissagaluarpullu	guitarer-SSA=GALUAR<Indikativ<de+LU
guitarissagaluarpunga	guitarer-SSA=GALUAR<Indikativ<jeg
guitarissagaluarpugut	guitarer-SSA=GALUAR<Indikativ<vi
guitarissagaluarpit	guitarer-SSA=GALUAR<Interrogativ<du
guitarissagaluarnerpaanngoqqaarnini	guitarer-SSA=GALUAR+NIRPAAQ-NNGUR-QQAAR+NIQ<ental<sin<Absolut
guitarissagaluarnerpaaqaannarpugut	guitarer-SSA=GALUAR+NIRPAAQ-QAR-INNAR<Indikativ<vi
guitarissagaluartoq	guitarer-SSA=GALUAR<Participium<han
guitarissagaluartungaana	guitarer-SSA=GALUAR<Participium<jeg+UNA
guitarissappulluunniit	guitarer-SSA<Indikativ<de+LUUNNIIT
guitarissaagut	guitarer-SSA<Indikativ<vi
guitarissavit	guitarer-SSA<Interrogativ<du
guitarissasununa	guitarer-SSA<Participium<de+UNA
guitarertaraluarferujulererusunnerpaakkununa	guitarer+TAR=GALUAR+FIK-RUJUK-LIRI+GUSUP+NIRPAAQv<ental<Vialis+UNA
guitarertaraluarnini	guitarer+TAR=GALUAR+NIQ<ental<sin<Absolut
guitarertariaqarnerpaamukassagaluarpisi	guitarer+TARIAQAR+NIRPAAQ<ental<Terminalis-KAR-SSA=GALUAR<Interrogativ<I
guitarertarlutillu	guitarer+TAR<Ledsagemåde<de_selv+LU
guitarertartoqalaarpungaana	guitarer+TAR+TUQ-QAR-LAAR<Indikativ<jeg+UNA
guitarertikkakkuuna	guitarer+TIP<Causativ<JegHam+UNA
guitarertipparpulli	guitarer+TIP<Indikativ<ViHam+LI
guitarertunngortorujussuullutik	guitarer+TUQ-NNGUR+TUQ=RUJUK=SUAQ=U<Ledsagemåde<de_selv
guitarertorujorujussuusorli	guitarer+TUQ=RUJUK=RUJUK=SUAQ=U<Participium<han+LI
guitarertorujussuuisi	guitarer+TUQ=RUJUK=SUAQ=U<Interrogativ<I
guitarertorujussuuninili	guitarer+TUQ=RUJUK=SUAQ=U+NIQ<ental<sin<Absolut+LI
guitarerpallaannginnerata	guitarer+VALLAAR=NNGIT+NIQ<ental<hans<Relativ
guitarerpallaartoorusuttooqqutigilli	guitarer+VALLAAR+TUQ-U+GUSUP+TUQ-U-QQU<Imperativ<ViDem+LI
guitarivimmallu	guitarer-VIP<Causativ<han+LU
guitarivikkattalu	guitarer-VIP<Causativ<vi+LU
guitarivikkattaluunniit	guitarer-VIP<Causativ<vi+LUUNNIIT
guitarivifferujoqalerpugut	guitarer-VIP+FIK-RUJUK-QAR-LIR<Indikativ<vi
guitarivippugut	guitarer-VIP<Indikativ<vi
guitarivinnerit	guitarer-VIP+NIQ<flertal<Relativ
guitarivinnerpaataluunniit	guitarer-VIP+NIRPAAQvv<ental<hans<Relativ+LUUNNIIT
guitarivittunga	guitarer-VIP<Participium<jeg
guitarivittulilaartartigilli	guitarer-VIP+TUQ-LIR_nv-LAAR=TAR<Imperativ<ViDem+LI
ikiorti	ikiurtә<ental<Absolut
ikiortili	ikiurtә<ental<Absolut+LI
ikiortiluunniit	ikiurtә<ental<Absolut+LUUNNIIT
ikiortinniilluarpit	ikiurtә<ental<min<Lokalis+IP+LUAR<Interrogativ<du
ikiortigiilereqqaartunga	ikiurtә+GIIT-LIRI-QQAAR<Participium<jeg
ikiortiginiarlunga	ikiurtә+GӘ+NIAR<Ledsagemåde<mig
ikiortigisariaqartigit	ikiurtә+GӘ+TARIAQAR<Imperativ<ViDem
ikiortaannaat	ikiurtә-INNAQ<flertal<deres<Absolut
ikiortaannaalluunniit	ikiurtә-INNAQ<flertal<Relativ+LUUNNIIT
ikiortaannalerivinnini	ikiurtә-INNAQ-LIRI-VIP+NIQ<ental<sin<Absolut
ikiortaannartaavittunga	ikiurtә-INNAQ+TAAR-VIP<Participium<jeg
ikiortaannaanikuunerpaaqassallutinguna	ikiurtә-INNAQ-U+NIKUU+NIRPAAQ-QAR-SSA<Ledsagemåde<de_selv+UNA
ikiortikkulluunniit	ikiurtә-KKUT<flertal<Absolut+LUUNNIIT
ikiortikkui	ikiurtә-KKUT<flertal<hans<Absolut
ikiortikkunniluunniit	ikiurtә-KKUT<flertal<Lokalis+LUUNNIIT
ikiortikui	ikiurtә-KU<flertal<deres<Absolut
ikiortikoqalaartartullu	ikiurtә-KU-QAR-LAAR=TAR<Participium<de+LU
ikiortikoqariaratta	ikiurtә-KU-QAR-RIAR<Causativ<vi
ikiortikoqassagaluarpulluunniit	ikiurtә-KU-QAR-SSA=GALUAR<Indikativ<de+LUUNNIIT
ikiortillit	ikiurtә-LIK<flertal<Relativ
ikiortililereerpara	ikiurtә-LIK-LIR_nv-RIIR<Indikativ<JegHam
ikiortilerinerummanuna	ikiurtә-LIRI+NIRU<Causativ<han+UNA
ikiortililerpakka	ikiurtә-LIR_nv-LIR<Indikativ<JegDem
ikiortinnguartaalaartarput	ikiurtә-NNGUAQ+TAAR-LAAR=TAR<Indikativ<de
ikiorterpassui	ikiurtә+PASSUAQ<flertal<hans<Absolut
ikiorterpassuanni	ikiurtә+PASSUAQ<flertal<min<Lokalis
ikiorterpassuanneereerlutilli	ikiurtә+PASSUAQ<flertal<min<Lokalis+IP-RIIR<Ledsagemåde<de_selv+LI
ikiorteqalermallu	ikiurtә-QAR-LIR<Causativ<han+LU
ikiorteqaqqugakkuli	ikiurtә-QAR-QQU<Causativ<JegHam+LI
ikiorterujunngoqigama	ikiurtә-RUJUK-NNGUR-QӘ<Causativ<jeg
ikiorterujoqaqqugakkuuna	ikiurtә-RUJUK-QAR-QQU<Causativ<JegHam+UNA
ikiorterujussuanni	ikiurtә-RUJUK=SUAQ<flertal<min<Lokalis
ikiorterujooreerpulli	ikiurtә-RUJUK-U-RIIR<Indikativ<de+LI
ikiortisiornertorujooriarfillu	ikiurtә+SIUR+NIR+TUQ-RUJUK-U-RIAR+FIK<ental<Absolut+LU
ikiortissaq	ikiurtә-SSAQ<ental<Absolut
ikiortissani	ikiurtә-SSAQ<flertal<Lokalis
ikiortitaalaartarama	ikiurtә+TAAR-LAAR=TAR<Causativ<jeg
ikiortitaassagaluarpunga	ikiurtә+TAAR-SSA=GALUAR<Indikativ<jeg
ikiortaavisi	ikiurtә-U<Interrogativ<I
ikiortaallutik	ikiurtә-U<Ledsagemåde<de_selv
ikiortaaniarfeqalaartarnerpaamut	ikiurtә-U+NIAR+FIK-QAR-LAAR=TAR+NIRPAAQ<ental<Terminalis
ikiortaavallaannginnini	ikiurtә-U+VALLAAR=NNGIT+NIQ<ental<sin<Absolut
ilaa	ilaa<Partikel
ilaali	ilaa<Partikel+LI
ilamininguna	ila<flertal<sin<Instrumentalis+UNA
ilagiikka	ila+GIIT<flertal<min<Absolut
ilagivallaarmangaluunniit	ilagә+VALLAAR<Causativ<HanMig+LUUNNIIT
ilakkununa	ila-KKUT<flertal<Absolut+UNA
ilalilaartarlunga	ila-LIR_nv-LAAR=TAR<Ledsagemåde<mig
ilamioorusunnerpaaqavinnermukalaartarmatali	ila+MIU-U+GUSUP+NIRPAAQ-QAR-VIP+NIQ<ental<Terminalis-KAR-LAAR=TAR<Causativ<de+LI
ilimagivara	ilimagә<Indikativ<JegHam
ilimagisimalara	ilimagә+SIMA<Optativ<JegHam
ilinnialernini	ilinniar-LIR+NIQ<ental<sin<Absolut
ilinniareerpit	ilinniar-RIIR<Interrogativ<du
ilinniartorujorujussuusoqarunnaarfiinnalissaviuk	ilinniar+TUQ=RUJUK=RUJUK=SUAQ=U+TUQ-QAR+GUNNAAR+FIK-INNAQ-LIR_nv-SSA<Interrogativ<DuHam
Ilisimatusarfik	Ilisimatusarfik<ental<Absolut
Ilisimatusarfilli	Ilisimatusarfik<ental<Absolut+LI
Ilisimatusarfillu	Ilisimatusarfik<ental<Absolut+LU
Ilisimatusarfimmeeqqaarattaluunniit	Ilisimatusarfik<ental<Instrumentalis-IR-QQAAR<Causativ<vi+LUUNNIIT
Ilisimatusarfimmi	Ilisimatusarfik<ental<Lokalis
Ilisimatusarfinni	Ilisimatusarfik<flertal<Lokalis
Ilisimatusarfigiivilu	Ilisimatusarfik+GIIT<flertal<hans<Absolut+LU
Ilisimatusarfigisinnaatigit	Ilisimatusarfik+GӘ+SINNAA<Imperativ<ViDem
Ilisimatusarfinngui	Ilisimatusarfik-NNGUAQ<flertal<hans<Absolut
Ilisimatusarfippassuilu	Ilisimatusarfik+PASSUAQ<flertal<deres<Absolut+LU
Ilisimatusarfeqariartorporlu	Ilisimatusarfik-QAR+GIARTUR<Indikativ<han+LU
Ilisimatusarfeqaannarporli	Ilisimatusarfik-QAR-INNAR<Indikativ<han+LI
Ilisimatusarfeqaannartoq	Ilisimatusarfik-QAR-INNAR+TUQ<ental<Absolut
Ilisimatusarfeqalaartartoq	Ilisimatusarfik-QAR-LAAR=TAR<Participium<han
Ilisimatusarfeqalerporuna	Ilisimatusarfik-QAR-LIR<Indikativ<han+UNA
Ilisimatusarfeqalernerli	Ilisimatusarfik-QAR-LIR+NIQ<ental<Absolut+LI
Ilisimatusarfeqalertoq	Ilisimatusarfik-QAR-LIR+TUQ<ental<Absolut
Ilisimatusarfeqalertorli	Ilisimatusarfik-QAR-LIR+TUQ<ental<Absolut+LI
Ilisimatusarfeqanngilarli	Ilisimatusarfik-QAR-NNGIT<Indikativ<han+LI
Ilisimatusarfeqannginnernukavittunga	Ilisimatusarfik-QAR-NNGIT+NIQ<flertal<Terminalis-KAR-VIP<Participium<jeg
Ilisimatusarfeqaqqulara	Ilisimatusarfik-QAR-QQU<Optativ<JegHam
Ilisimatusarfeqareerporluunniit	Ilisimatusarfik-QAR-RIIR<Indikativ<han+LUUNNIIT
Ilisimatusarfeqareernerli	Ilisimatusarfik-QAR-RIIR+NIQ<ental<Absolut+LI
Ilisimatusarfissioqqaarnerpaaruna	Ilisimatusarfik+SIUR-QQAAR+NIRPAAQ<ental<Absolut+UNA
Ilisimatusarfissioqqaarnerpaaneereerneq	Ilisimatusarfik+SIUR-QQAAR+NIRPAAQ<flertal<Lokalis+IP-RIIR+NIQ<ental<Absolut
Ilisimatusarfissioqqulara	Ilisimatusarfik+SIUR-QQU<Optativ<JegHam
Ilisimatusarfissiussagaluarfigeqqaarlungali	Ilisimatusarfik+SIUR-SSA=GALUAR+FIK+GӘ-QQAAR<Ledsagemåde<mig+LI
illoqarfittulli	illoqarfik<ental<Aequalis+LI
illoqarfinnguattut	illoqarfik-NNGUAQ<ental<deres<Aequalis
illoqarfippassuillu	illoqarfik+PASSUAQ<flertal<Absolut+LU
illoqarfeqaqqulara	illoqarfik-QAR-QQU<Optativ<JegHam
Illoqqortoormiut	Illoqqortoormiut<Absolut
Illoqqortoormiullu	Illoqqortoormiut<Absolut+LU
Illoqqortoormiununa	Illoqqortoormiut<Absolut+UNA
Illoqqortoormiunik	Illoqqortoormiut<Instrumentalis
Illoqqortoormiuninguna	Illoqqortoormiut<Instrumentalis+UNA
Illoqqortoormiuni	Illoqqortoormiut<Lokalis
Illoqqortoormiuniilaarneq	Illoqqortoormiut<Lokalis+IP-LAAR+NIQ<ental<Absolut
Illoqqortoormiuneeqqullugu	Illoqqortoormiut<Lokalis+IP-QQU<Ledsagemåde<ham
Illoqqortoormiuneeriarmanuna	Illoqqortoormiut<Lokalis+IP-RIAR<Causativ<han+UNA
Illoqqortoormiuneereerlutik	Illoqqortoormiut<Lokalis+IP-RIIR<Ledsagemåde<de_selv
Illoqqortoormiuniivippisi	Illoqqortoormiut<Lokalis+IP-VIP<Interrogativ<I
Illoqqortoormiormiuni	Illoqqortoormiut+MIU<flertal<Lokalis
Illoqqortoormiormiulerilaarnini	Illoqqortoormiut+MIU-LIRI-LAAR+NIQ<ental<sin<Absolut
Illoqqortoormiormioqarnerlu	Illoqqortoormiut+MIU-QAR+NIQ<ental<Absolut+LU
Illoqqortoormiormiuulaarnerpaaneeriarnerata	Illoqqortoormiut+MIU-U-LAAR+NIRPAAQ<flertal<Instrumentalis-IR-RIAR+NIQ<ental<deres<Relativ
Illoqqortoormiormiooqaagut	Illoqqortoormiut+MIU-U-QӘ<Indikativ<vi
Illoqqortoormiormiooreerpugulli	Illoqqortoormiut+MIU-U-RIIR<Indikativ<vi+LI
Illoqqortoormiormiuusariaqartorujoqalerfikkuili	Illoqqortoormiut+MIU-U+TARIAQAR+TUQ-RUJUK-QAR-LIR+FIK-KKUT<flertal<hans<Absolut+LI
Illoqqortoormiunukarmallu	Illoqqortoormiut<Terminalis-KAR<Causativ<han+LU
Illoqqortoormiunukariarlutik	Illoqqortoormiut<Terminalis-KAR-RIAR<Ledsagemåde<de_selv
illuinnaagaluartungali	illu-INNAQ-U+GALUAR<Participium<jeg+LI
illukkunneereertoqanngilarli	illu-KKUT<flertal<Lokalis+IP-RIIR+TUQ-QAR-NNGIT<Indikativ<han+LI
illukusiortarfippassuarnik	illu-KU+SIUR+TAR+FIK+PASSUAQ<flertal<Instrumentalis
illullilluunniit	illu-LIK<flertal<Relativ+LUUNNIIT
illulernerulluguuna	illu-LIR_nv+NIRU<Ledsagemåde<ham+UNA
illunngui	illu-NNGUAQ<flertal<hans<Absolut
illoqanngillat	illu-QAR-NNGIT<Indikativ<de
illoqaqqaartulereqquaa	illu-QAR-QQAAR+TUQ-LIRI-QQU<Indikativ<HanHam
illoqareertungalu	illu-QAR-RIIR<Participium<jeg+LU
illoqassagaluarpoq	illu-QAR-SSA=GALUAR<Indikativ<han
illorujussiussammata	illu-RUJUK+SIUR-SSA<Causativ<de
illorujussui	illu-RUJUK=SUAQ<flertal<hans<Absolut
illusiulerfinguna	illu+SIUR-LIR+FIK<ental<Absolut+UNA
illussaainnarnerpaatuna	illu-SSAQ-U-INNAR+NIRPAAQ<flertal<deres<Absolut+UNA
illooqquara	illu-U-QQU<Indikativ<JegHam
Ilulissalli	Ilulissat<Absolut+LI
Ilulissallu	Ilulissat<Absolut+LU
Ilulissalluunniit	Ilulissat<Absolut+LUUNNIIT
Ilulissanuna	Ilulissat<Absolut+UNA
Ilulissanik	Ilulissat<Instrumentalis
Ilulissanilli	Ilulissat<Instrumentalis+LI
Ilulissanilluunniit	Ilulissat<Instrumentalis+LUUNNIIT
Ilulissaninguna	Ilulissat<Instrumentalis+UNA
Ilulissani	Ilulissat<Lokalis
Ilulissaneeqquiuk	Ilulissat<Lokalis+IP-QQU<Interrogativ<DuHam
Ilulissaneeriarneq	Ilulissat<Lokalis+IP-RIAR+NIQ<ental<Absolut
Ilulissaniluunniit	Ilulissat<Lokalis+LUUNNIIT
Iluliarmiumulli	Ilulissat+MIU<ental<Terminalis+LI
Iluliarmiuniiginnartorluunniit	Ilulissat+MIU<flertal<Lokalis+IP-INNAR+TUQ<ental<Absolut+LUUNNIIT
Iluliarmiulereqaagulli	Ilulissat+MIU-LIRI-QӘ<Indikativ<vi+LI
Iluliarmiunngulaartarnerpaamukanngilatit	Ilulissat+MIU-NNGUR-LAAR=TAR+NIRPAAQ<ental<Terminalis-KAR-NNGIT<Interrogativ<du
Iluliarmiunngoreerferujooqqaarfiorusuppugununa	Ilulissat+MIU-NNGUR-RIIR+FIK-RUJUK-U-QQAAR+FIK-U+GUSUP<Indikativ<vi+UNA
Iluliarmioqarpa	Ilulissat+MIU-QAR<Interrogativ<han
Iluliarmioqarnerluunniit	Ilulissat+MIU-QAR+NIQ<ental<Absolut+LUUNNIIT
Iluliarmioqartoq	Ilulissat+MIU-QAR+TUQ<ental<Absolut
Iluliarmioqartorli	Ilulissat+MIU-QAR+TUQ<ental<Absolut+LI
Iluliarmioorusukkattaluunniit	Ilulissat+MIU-U+GUSUP<Causativ<vi+LUUNNIIT
Iluliarmiooqqaarlutinguna	Ilulissat+MIU-U-QQAAR<Ledsagemåde<de_selv+UNA
Iluliarmiooriarlutinguna	Ilulissat+MIU-U-RIAR<Ledsagemåde<de_selv+UNA
Iluliarmiooreernerpaartaartariaqarlutik	Ilulissat+MIU-U-RIIR+NIRPAAQ+TAAR+TARIAQAR<Ledsagemåde<de_selv
Iluliarmiuusorujorujussuuisi	Ilulissat+MIU-U+TUQ=RUJUK=RUJUK=SUAQ=U<Interrogativ<I
Ilulissanukarusuttorlu	Ilulissat<Terminalis-KAR+GUSUP<Participium<han+LU
Ilulissanulluunniit	Ilulissat<Terminalis+LUUNNIIT
Ilulissanununa	Ilulissat<Terminalis+UNA
imaammataluunniit	imaap<Causativ<de+LUUNNIIT
imaafferujussuata	imaap+FIK-RUJUK=SUAQ<ental<hans<Relativ
imaalluinnarpit	imaap+LUINNAR<Interrogativ<du
imaanniartuataluunniit	imaap+NIAR+TUQ<ental<hans<Relativ+LUUNNIIT
imaanniartui	imaap+NIAR+TUQ<flertal<deres<Absolut
imaassinnaagattaluunniit	imaap+SINNAA<Causativ<vi+LUUNNIIT
imaattaraluaratta	imaap+TAR=GALUAR<Causativ<vi
imaappallaarlutik	imaap+VALLAAR<Ledsagemåde<de_selv
imatut	imatut<Partikel
imatulli	imatut<Partikel+LI
imatununa	imatut<Partikel+UNA
imiinnarnerpaata	imer-INNAR+NIRPAAQvv<ental<hans<Relativ
imilerlutinguna	imer-LIR<Ledsagemåde<de_selv+UNA
imilertunga	imer-LIR<Participium<jeg
imernerugama	imer+NIRU<Causativ<jeg
iminngitsussarli	imer-NNGIT+TUQ-SSAQ<ental<Absolut+LI
imertungali	imer<Participium<jeg+LI
imeqimmalluunniit	imer-QӘ<Causativ<han+LUUNNIIT
imeriarmalluunniit	imer-RIAR<Causativ<han+LUUNNIIT
imeriarnini	imer-RIAR+NIQ<ental<sin<Absolut
imeriartuleriartigilli	imer-RIAR+TUQ-LIR_nv-RIAR<Imperativ<ViDem+LI
imeriartorujussuattullu	imer-RIAR+TUQ-RUJUK=SUAQ<ental<deres<Aequalis+LU
imissagama	imer-SSA<Causativ<jeg
imissaanga	imer-SSA<Indikativ<jeg
imissava	imer-SSA<Interrogativ<han
imertarlutik	imer+TAR<Ledsagemåde<de_selv
imertorujorujussuummata	imer+TUQ=RUJUK=RUJUK=SUAQ=U<Causativ<de
imertorujorujussuuppununa	imer+TUQ=RUJUK=RUJUK=SUAQ=U<Indikativ<de+UNA
imertorujussuullutik	imer+TUQ=RUJUK=SUAQ=U<Ledsagemåde<de_selv
imivippa	imer-VIP<Interrogativ<han
immaqa	immaqa<Partikel
immaqali	immaqa<Partikel+LI
immaqaluunniit	immaqa<Partikel+LUUNNIIT
immaqaana	immaqa<Partikel+UNA
immiussilertorujussuaminilli	immiussi-LIR+TUQ-RUJUK=SUAQ<flertal<sin<Instrumentalis+LI
inequnariartortussaagaluattulli	inequnar+GIARTUR+TUQ-SSAQ=U=GALUAQ<ental<deres<Aequalis+LI
inequnarpisi	inequnar<Interrogativ<I
inequnalaartarfilli	inequnar-LAAR=TAR+FIK<ental<Absolut+LI
inequnarnerusoq	inequnar+NIRU+TUQ<ental<Absolut
inequnassagamali	inequnar-SSA<Causativ<jeg+LI
inersimasoq	inersimasoq<ental<Absolut
inersimasuulaartorujummukarnerugamali	inersimasoq-U-LAAR+TUQ-RUJUK<ental<Terminalis-KAR+NIRU<Causativ<jeg+LI
ingerlajunnaarninilu	ingerla+GUNNAAR+NIQ<ental<sin<Absolut+LU
ingerlaneruvugut	ingerla+NIRU<Indikativ<vi
ingerlassinnaagakkulu	ingerlap+SINNAA<Causativ<JegHam+LU
ingerlatitimmanga	ingerlap+TIP<Causativ<HanMig
ingerlappallaarakku	ingerlap+VALLAAR<Causativ<JegHam
ingerlatippaallu	ingerla+TIP<Indikativ<DeHam+LU
innaallagissiorfimmut	innaallagissiorfik<ental<Terminalis
innaallagissiorfilerisut	innaallagissiorfik-LIRI<Participium<de
innaallagissiorfimmiuunerillu	innaallagissiorfik+MIU-U+NIQ<flertal<Absolut+LU
innaallagissiorfeqassaagut	innaallagissiorfik-QAR-SSA<Indikativ<vi
innaallagissiorferujugali	innaallagissiorfik-RUJUK<ental<min<Absolut+LI
innaallagissiorferujoqanngimmata	innaallagissiorfik-RUJUK-QAR-NNGIT<Causativ<de
innaallagissiorferujussiuinnarnerpaanngoqquaa	innaallagissiorfik-RUJUK+SIUR-INNAR+NIRPAAQ-NNGUR-QQU<Indikativ<HanHam
innaallagissiorferujussuattut	innaallagissiorfik-RUJUK=SUAQ<ental<deres<Aequalis
innaallagissiorferujussuarmi	innaallagissiorfik-RUJUK=SUAQ<ental<Lokalis
innaallagissiorferujuuffeqanngimmat	innaallagissiorfik-RUJUK-U+FIK-QAR-NNGIT<Causativ<han
innaallagissiorfissiussasulli	innaallagissiorfik+SIUR-SSA<Participium<de+LI
innaallagissiorfittaanngiffissaavallaarmata	innaallagissiorfik+TAAR-NNGIT+FIK-SSAQ-U+VALLAAR<Causativ<de
inunguna	inuk<ental<Absolut+UNA
inummeeqqaarlutik	inuk<ental<Lokalis+IP-QQAAR<Ledsagemåde<de_selv
inummununa	inuk<ental<Terminalis+UNA
inui	inuk<flertal<hans<Absolut
inunni	inuk<flertal<Lokalis
inuinnarmiittaraluaratta	inuk-INNAQ<ental<Lokalis+IP+TAR=GALUAR<Causativ<vi
inoqaannartoq	inuk-QAR-INNAR+TUQ<ental<Absolut
inoqalaartoq	inuk-QAR-LAAR+TUQ<ental<Absolut
inussioqqaarlutik	inuk+SIUR-QQAAR<Ledsagemåde<de_selv
inussioqigattalu	inuk+SIUR-QӘ<Causativ<vi+LU
inuttaalaartarporlu	inuk+TAAR-LAAR=TAR<Indikativ<han+LU
inuttaassaagulli	inuk+TAAR-SSA<Indikativ<vi+LI
inuttaavittorujoqaqqaarpungali	inuk+TAAR-VIP+TUQ-RUJUK-QAR-QQAAR<Indikativ<jeg+LI
inoorusuppoq	inuk-U+GUSUP<Indikativ<han
inoorusuttoq	inuk-U+GUSUP+TUQ<ental<Absolut
inooqqaarporli	inuk-U-QQAAR<Indikativ<han+LI
inuttassarsiuussiniminillu	inuttassarsiuussineq<flertal<sin<Instrumentalis+LU
inoorusukkamali	inuu+GUSUP<Causativ<jeg+LI
inoorusuppununa	inuu+GUSUP<Indikativ<de+UNA
inoorusuppit	inuu+GUSUP<Interrogativ<du
inooqisungaluunniit	inuu-QӘ<Participium<jeg+LUUNNIIT
inooreerpugut	inuu-RIIR<Indikativ<vi
inooreertungali	inuu-RIIR<Participium<jeg+LI
isumaa	isuma<flertal<hans<Absolut
isumaannaalli	isuma-INNAQ<flertal<Absolut+LI
isumakkunniissinnaallutilli	isuma-KKUT<flertal<Lokalis+IP+SINNAA<Ledsagemåde<de_selv+LI
isumakooreerpit	isuma-KU-U-RIIR<Interrogativ<du
isumalerinerusuminik	isuma-LIRI+NIRU+TUQ<ental<sin<Instrumentalis
isumanngulaarninili	isuma-NNGUR-LAAR+NIQ<ental<sin<Absolut+LI
isumanngoqquassiuna	isuma-NNGUR-QQU<Indikativ<JegJer+UNA
isumanngoqqullugilli	isuma-NNGUR-QQU<Ledsagemåde<dem+LI
isumarpassui	isuma+PASSUAQ<flertal<hans<Absolut
isumaqaqqaarfinngulerferujussuaminik	isumaqar-QQAAR+FIK-NNGUR-LIR+FIK-RUJUK=SUAQ<flertal<sin<Instrumentalis
isumaqaqaanga	isuma-QAR-QӘ<Indikativ<jeg
isumarujussuili	isuma-RUJUK=SUAQ<flertal<deres<Absolut+LI
isumassaagaluali	isuma-SSAQ=U=GALUAQ<ental<hans<Absolut+LI
isumassaagalui	isuma-SSAQ=U=GALUAQ<flertal<hans<Absolut
isumataalaartarniniluunniit	isuma+TAAR-LAAR=TAR+NIQ<ental<sin<Absolut+LUUNNIIT
isilu	isә<ental<Absolut+LU
isaata	isә<ental<hans<Relativ
isimulli	isә<ental<Terminalis+LI
isikkut	isә<ental<Vialis
isikkulli	isә<ental<Vialis+LI
isigiinnukareerpunga	isә+GIIT<flertal<Terminalis-KAR-RIIR<Indikativ<jeg
isigiilerereerferujulluunniit	isә+GIIT-LIRI-RIIR+FIK-RUJUK<ental<Absolut+LUUNNIIT
isigilluinnarlara	isә+GӘ+LUINNAR<Optativ<JegHam
isikulereqisuma	isә-KU-LIRI-QӘ+TUQ<ental<min<Relativ
isilerivallaanngila	isә-LIRI+VALLAAR=NNGIT<Interrogativ<han
isinngulaartartungalu	isә-NNGUR-LAAR=TAR<Participium<jeg+LU
iserpassuakkaluunniit	isә+PASSUAQ<flertal<min<Absolut+LUUNNIIT
iseqassagaluarpugulluunniit	isә-QAR-SSA=GALUAR<Indikativ<vi+LUUNNIIT
isisiunngilaq	isә+SIUR-NNGIT<Indikativ<han
isissaagaluattununa	isә-SSAQ=U=GALUAQ<ental<deres<Aequalis+UNA
isissaagaluanniilertoq	isә-SSAQ=U=GALUAQ<ental<min<Lokalis+IP-LIR<Participium<han
isissaagaluillu	isә-SSAQ=U=GALUAQ<flertal<Absolut+LU
isissaagaluanni	isә-SSAQ=U=GALUAQ<flertal<min<Lokalis
isitaassavit	isә+TAAR-SSA<Interrogativ<du
Ivittuut	Ivittuut<Absolut
Ivittuulli	Ivittuut<Absolut+LI
Ivittuununa	Ivittuut<Absolut+UNA
Ivittuunik	Ivittuut<Instrumentalis
Ivittuunilli	Ivittuut<Instrumentalis+LI
Ivittuunillu	Ivittuut<Instrumentalis+LU
Ivittuunilluunniit	Ivittuut<Instrumentalis+LUUNNIIT
Ivittuuninguna	Ivittuut<Instrumentalis+UNA
Ivittuuni	Ivittuut<Lokalis
Ivittuuniilertungalu	Ivittuut<Lokalis+IP-LIR<Participium<jeg+LU
Ivittuuneereertunga	Ivittuut<Lokalis+IP-RIIR<Participium<jeg
Ivittoormiumik	Ivittuut+MIU<ental<Instrumentalis
Ivittoormiumilli	Ivittuut+MIU<ental<Instrumentalis+LI
Ivittoormiumilluunniit	Ivittuut+MIU<ental<Instrumentalis+LUUNNIIT
Ivittoormiumukaannarpungaluunniit	Ivittuut+MIU<ental<Terminalis-KAR-INNAR<Indikativ<jeg+LUUNNIIT
Ivittoormiunilli	Ivittuut+MIU<flertal<Instrumentalis+LI
Ivittoormiuninguna	Ivittuut+MIU<flertal<Instrumentalis+UNA
Ivittoormiuniiginnarlutilli	Ivittuut+MIU<flertal<Lokalis+IP-INNAR<Ledsagemåde<de_selv+LI
Ivittoormiuneeriarmatalu	Ivittuut+MIU<flertal<Lokalis+IP-RIAR<Causativ<de+LU
Ivittoormiulererusummata	Ivittuut+MIU-LIRI+GUSUP<Causativ<de
Ivittoormiulerilaartartut	Ivittuut+MIU-LIRI-LAAR=TAR<Participium<de
Ivittoormiulerillutinguna	Ivittuut+MIU-LIRI<Ledsagemåde<de_selv+UNA
Ivittoormiunngoqaat	Ivittuut+MIU-NNGUR-QӘ<Interrogativ<du
Ivittoormiunngoriarlutilli	Ivittuut+MIU-NNGUR-RIAR<Ledsagemåde<de_selv+LI
Ivittoormiunngoreernerma	Ivittuut+MIU-NNGUR-RIIR+NIQ<ental<min<Relativ
Ivittoormiunngussagaluarferujuunerama	Ivittuut+MIU-NNGUR-SSA=GALUAR+FIK-RUJUK-U+NIR<Causativ<jeg
Ivittoormioqarpoq	Ivittuut+MIU-QAR<Indikativ<han
Ivittoormioqarneq	Ivittuut+MIU-QAR+NIQ<ental<Absolut
Ivittoormioqarnerli	Ivittuut+MIU-QAR+NIQ<ental<Absolut+LI
Ivittoormioqarnerlu	Ivittuut+MIU-QAR+NIQ<ental<Absolut+LU
Ivittoormioqarnerluunniit	Ivittuut+MIU-QAR+NIQ<ental<Absolut+LUUNNIIT
Ivittoormioqarneruna	Ivittuut+MIU-QAR+NIQ<ental<Absolut+UNA
Ivittoormioqartorlu	Ivittuut+MIU-QAR<Participium<han+LU
Ivittoormioqartoruna	Ivittuut+MIU-QAR<Participium<han+UNA
Ivittoormioqartoq	Ivittuut+MIU-QAR+TUQ<ental<Absolut
Ivittoormioqartorluunniit	Ivittuut+MIU-QAR+TUQ<ental<Absolut+LUUNNIIT
Ivittoormiuujunnaarmata	Ivittuut+MIU-U+GUNNAAR<Causativ<de
Ivittoormioorusuttunngulaartarnerpaaqalaarlutik	Ivittuut+MIU-U+GUSUP+TUQ-NNGUR-LAAR=TAR+NIRPAAQ-QAR-LAAR<Ledsagemåde<de_selv
Ivittoormiuuleramaluunniit	Ivittuut+MIU-U-LIR<Causativ<jeg+LUUNNIIT
Ivittoormiuunerninili	Ivittuut+MIU-U+NIR+NIQ<ental<sin<Absolut+LI
Ivittoormiuuneruvunga	Ivittuut+MIU-U+NIRU<Indikativ<jeg
Ivittoormiooqqaarama	Ivittuut+MIU-U-QQAAR<Causativ<jeg
Ivittoormiooqqummangali	Ivittuut+MIU-U-QQU<Causativ<HanMig+LI
Ivittoormiooqqutigilli	Ivittuut+MIU-U-QQU<Imperativ<ViDem+LI
Ivittoormiooriarfilluunniit	Ivittuut+MIU-U-RIAR+FIK<ental<Absolut+LUUNNIIT
Ivittoormiooriarnini	Ivittuut+MIU-U-RIAR+NIQ<ental<sin<Absolut
Ivittoormiooreerniniuna	Ivittuut+MIU-U-RIIR+NIQ<ental<sin<Absolut+UNA
Ivittoormiuusinnaaffeqariartorujunniivikkamali	Ivittuut+MIU-U+SINNAA+FIK-QAR-RIAR+TUQ-RUJUK<flertal<Instrumentalis-IR-VIP<Causativ<jeg+LI
Ivittoormiuusorujorujussuufferujuata	Ivittuut+MIU-U+TUQ=RUJUK=RUJUK=SUAQ=U+FIK-RUJUK<ental<hans<Relativ
Ivittuunut	Ivittuut<Terminalis
Ivittuunukariartornerlu	Ivittuut<Terminalis-KAR+GIARTUR+NIQ<ental<Absolut+LU
Ivittuunukaannartunga	Ivittuut<Terminalis-KAR-INNAR<Participium<jeg
Ivittuunukalaartarmata	Ivittuut<Terminalis-KAR-LAAR=TAR<Causativ<de
Ivittuunukalerlutilli	Ivittuut<Terminalis-KAR-LIR<Ledsagemåde<de_selv+LI
Ivittuunukarluinnartorluunniit	Ivittuut<Terminalis-KAR+LUINNAR+TUQ<ental<Absolut+LUUNNIIT
Ivittuunukareerneq	Ivittuut<Terminalis-KAR-RIIR+NIQ<ental<Absolut
Ivittuunukassasungali	Ivittuut<Terminalis-KAR-SSA<Participium<jeg+LI
Ivittuunulli	Ivittuut<Terminalis+LI
Ivittuunullu	Ivittuut<Terminalis+LU
Ivittuunulluunniit	Ivittuut<Terminalis+LUUNNIIT
Ivittuunununa	Ivittuut<Terminalis+UNA
januaariallu	januaari<ental<Absolut<deres+LU
januaaria	januaari<ental<hans<Absolut
januaariali	januaari<ental<hans<Absolut+LI
januaarimeeqqullugu	januaari<ental<Lokalis+IP-QQU<Ledsagemåde<ham
januaarimeeriartorujussuataluunniit	januaari<ental<Lokalis+IP-RIAR+TUQ-RUJUK=SUAQ<ental<hans<Relativ+LUUNNIIT
januaarimilu	januaari<ental<Lokalis+LU
januaarimiluunniit	januaari<ental<Lokalis+LUUNNIIT
januaarimiuna	januaari<ental<Lokalis+UNA
januaarimukareerpisi	januaari<ental<Terminalis-KAR-RIIR<Interrogativ<I
januaarimulli	januaari<ental<Terminalis+LI
januaarimullu	januaari<ental<Terminalis+LU
januaarimununa	januaari<ental<Terminalis+UNA
januaarikkut	januaari<ental<Vialis
januaarikkununa	januaari<ental<Vialis+UNA
januaarinulli	januaari<flertal<flertal<Terminalis+LI
januaarinununa	januaari<flertal<flertal<Terminalis+UNA
januaarii	januaari<flertal<hans<Absolut
januaariili	januaari<flertal<hans<Absolut+LI
januaarineerneq	januaari<flertal<Instrumentalis-IR+NIQ<ental<Absolut
januaarineeqqaarpit	januaari<flertal<Instrumentalis-IR-QQAAR<Interrogativ<du
januaarineeqqaarlutillu	januaari<flertal<Instrumentalis-IR-QQAAR<Ledsagemåde<de_selv+LU
januaariniivippit	januaari<flertal<Instrumentalis-IR-VIP<Interrogativ<du
januaariniivittoruna	januaari<flertal<Instrumentalis-IR-VIP<Participium<han+UNA
januaarininguna	januaari<flertal<Instrumentalis+UNA
januaarineeqqaarpunga	januaari<flertal<Lokalis+IP-QQAAR<Indikativ<jeg
januaarineeqqullungaluunniit	januaari<flertal<Lokalis+IP-QQU<Ledsagemåde<mig+LUUNNIIT
januaarineereertoq	januaari<flertal<Lokalis+IP-RIIR+TUQ<ental<Absolut
januaarinnguinnarneq	januaari-NNGUR-INNAR+NIQ<ental<Absolut
januaarinngulaartarporluunniit	januaari-NNGUR-LAAR=TAR<Indikativ<han+LUUNNIIT
januaarinngulaartartoq	januaari-NNGUR-LAAR=TAR+TUQ<ental<Absolut
januaarinngulerpoq	januaari-NNGUR-LIR<Indikativ<han
januaarinngulerporli	januaari-NNGUR-LIR<Indikativ<han+LI
januaarinngorneruit	januaari-NNGUR+NIRU<Interrogativ<du
januaarinngoqqaarporli	januaari-NNGUR-QQAAR<Indikativ<han+LI
januaarinngoqqugakkuli	januaari-NNGUR-QQU<Causativ<JegHam+LI
januaarinngoqqutigilli	januaari-NNGUR-QQU<Imperativ<ViDem+LI
januaarinngoqquaanga	januaari-NNGUR-QQU<Indikativ<HanMig
januaarinngoqqullungaluunniit	januaari-NNGUR-QQU<Ledsagemåde<mig+LUUNNIIT
januaarinngoriarfiataana	januaari-NNGUR-RIAR+FIK<ental<deres<Relativ+UNA
januaarinngoriarferujoqassagaluarnerali	januaari-NNGUR-RIAR+FIK-RUJUK-QAR-SSA=GALUAR+NIQ<ental<hans<Absolut+LI
januaarinngoriarferujussuattununa	januaari-NNGUR-RIAR+FIK-RUJUK=SUAQ<ental<deres<Aequalis+UNA
januaarinngoriartussaraana	januaari-NNGUR-RIAR+TUQ-SSAQ<ental<min<Absolut+UNA
januaarinngussagaluarpoq	januaari-NNGUR-SSA=GALUAR<Indikativ<han
januaarinngussaaq	januaari-NNGUR-SSA<Indikativ<han
januaarinngortaraluarneq	januaari-NNGUR+TAR=GALUAR+NIQ<ental<Absolut
januaareqariartorneruna	januaari-QAR+GIARTUR+NIQ<ental<Absolut+UNA
januaareqariartortorli	januaari-QAR+GIARTUR+TUQ<ental<Absolut+LI
januaareqarunnaartoq	januaari-QAR+GUNNAAR+TUQ<ental<Absolut
januaareqaannarpoq	januaari-QAR-INNAR<Indikativ<han
januaareqaannarneq	januaari-QAR-INNAR+NIQ<ental<Absolut
januaareqaannarnerli	januaari-QAR-INNAR+NIQ<ental<Absolut+LI
januaareqaannartoq	januaari-QAR-INNAR+TUQ<ental<Absolut
januaareqaannartorluunniit	januaari-QAR-INNAR+TUQ<ental<Absolut+LUUNNIIT
januaareqalaartoq	januaari-QAR-LAAR<Participium<han
januaareqalaartarporluunniit	januaari-QAR-LAAR=TAR<Indikativ<han+LUUNNIIT
januaareqalaartarnerlu	januaari-QAR-LAAR=TAR+NIQ<ental<Absolut+LU
januaareqalaartartorli	januaari-QAR-LAAR=TAR<Participium<han+LI
januaareqalaartartorli	januaari-QAR-LAAR=TAR+TUQ<ental<Absolut+LI
januaareqalaartartorlu	januaari-QAR-LAAR=TAR+TUQ<ental<Absolut+LU
januaareqalaartartoruna	januaari-QAR-LAAR=TAR+TUQ<ental<Absolut+UNA
januaareqalaartoq	januaari-QAR-LAAR+TUQ<ental<Absolut
januaareqalaartorluunniit	januaari-QAR-LAAR+TUQ<ental<Absolut+LUUNNIIT
januaareqalerporli	januaari-QAR-LIR<Indikativ<han+LI
januaareqalerporluunniit	januaari-QAR-LIR<Indikativ<han+LUUNNIIT
januaareqalerpa	januaari-QAR-LIR<Interrogativ<han
januaareqalerneq	januaari-QAR-LIR+NIQ<ental<Absolut
januaareqalertoq	januaari-QAR-LIR<Participium<han
januaareqalertoq	januaari-QAR-LIR+TUQ<ental<Absolut
januaareqalertoruna	januaari-QAR-LIR+TUQ<ental<Absolut+UNA
januaareqarnianngilarluunniit	januaari-QAR+NIAR=NNGIT<Indikativ<han+LUUNNIIT
januaareqanngimmat	januaari-QAR-NNGIT<Causativ<han
januaareqannginninili	januaari-QAR-NNGIT+NIQ<ental<sin<Absolut+LI
januaareqanngitsorli	januaari-QAR-NNGIT<Participium<han+LI
januaareqanngitsoq	januaari-QAR-NNGIT+TUQ
januaareqaqqaarpoq	januaari-QAR-QQAAR<Indikativ<han
januaareqaqqaarpa	januaari-QAR-QQAAR<Interrogativ<han
januaareqaqqaarneq	januaari-QAR-QQAAR+NIQ<ental<Absolut
januaareqaqqaartorluunniit	januaari-QAR-QQAAR<Participium<han+LUUNNIIT
januaareqaqqaartoq	januaari-QAR-QQAAR+TUQ<ental<Absolut
januaareqaqqaartoruna	januaari-QAR-QQAAR+TUQ<ental<Absolut+UNA
januaareqaqqummangali	januaari-QAR-QQU<Causativ<HanMig+LI
januaareqaqqugakku	januaari-QAR-QQU<Causativ<JegHam
januaareqaqqutiginuna	januaari-QAR-QQU<Imperativ<ViDem+UNA
januaareqaqquiuk	januaari-QAR-QQU<Interrogativ<DuHam
januaareqaqqullunga	januaari-QAR-QQU<Ledsagemåde<mig
januaareqaqqulara	januaari-QAR-QQU<Optativ<JegHam
januaareqaqqularali	januaari-QAR-QQU<Optativ<JegHam+LI
januaareqaqqularaana	januaari-QAR-QQU<Optativ<JegHam+UNA
januaareqariarmatali	januaari-QAR-RIAR<Causativ<de+LI
januaareqariarmataana	januaari-QAR-RIAR<Causativ<de+UNA
januaareqariarmat	januaari-QAR-RIAR<Causativ<han
januaareqariarmalluunniit	januaari-QAR-RIAR<Causativ<han+LUUNNIIT
januaareqariarattalu	januaari-QAR-RIAR<Causativ<vi+LU
januaareqariarfik	januaari-QAR-RIAR+FIK<ental<Absolut
januaareqariarfima	januaari-QAR-RIAR+FIK<flertal<min<Relativ
januaareqariarlutik	januaari-QAR-RIAR<Ledsagemåde<de_selv
januaareqariarlutinguna	januaari-QAR-RIAR<Ledsagemåde<de_selv+UNA
januaareqariarnerata	januaari-QAR-RIAR+NIQ<ental<deres<Relativ
januaareqariarnerilli	januaari-QAR-RIAR+NIQ<flertal<Absolut+LI
januaareqariartussaniuna	januaari-QAR-RIAR+TUQ-SSAQ<flertal<Lokalis+UNA
januaareqareerporlu	januaari-QAR-RIIR<Indikativ<han+LU
januaareqareerporluunniit	januaari-QAR-RIIR<Indikativ<han+LUUNNIIT
januaareqareerneq	januaari-QAR-RIIR+NIQ<ental<Absolut
januaareqareernerli	januaari-QAR-RIIR+NIQ<ental<Absolut+LI
januaareqareernerluunniit	januaari-QAR-RIIR+NIQ<ental<Absolut+LUUNNIIT
januaareqareertoq	januaari-QAR-RIIR+TUQ<ental<Absolut
januaareqareertorlu	januaari-QAR-RIIR+TUQ<ental<Absolut+LU
januaareqassagaluarporluunniit	januaari-QAR-SSA=GALUAR<Indikativ<han+LUUNNIIT
januaareqassagaluarneq	januaari-QAR-SSA=GALUAR+NIQ<ental<Absolut
januaareqassagaluarnerli	januaari-QAR-SSA=GALUAR+NIQ<ental<Absolut+LI
januaareqassagaluarnerlu	januaari-QAR-SSA=GALUAR+NIQ<ental<Absolut+LU
januaareqassagaluarneruna	januaari-QAR-SSA=GALUAR+NIQ<ental<Absolut+UNA
januaareqassaaq	januaari-QAR-SSA<Indikativ<han
januaareqassava	januaari-QAR-SSA<Interrogativ<han
januaareqassasorlu	januaari-QAR-SSA<Participium<han+LU
januaareqartaraluarnerli	januaari-QAR+TAR=GALUAR+NIQ<ental<Absolut+LI
januaareqartorujorujussuua	januaari-QAR+TUQ=RUJUK=RUJUK=SUAQ=U<Interrogativ<han
januaareqartorujorujussuunerli	januaari-QAR+TUQ=RUJUK=RUJUK=SUAQ=U+NIQ<ental<Absolut+LI
januaareqavippoq	januaari-QAR-VIP<Indikativ<han
januaareqavipporuna	januaari-QAR-VIP<Indikativ<han+UNA
januaareqavippa	januaari-QAR-VIP<Interrogativ<han
januaareqavinneq	januaari-QAR-VIP+NIQ<ental<Absolut
januaareqavittorli	januaari-QAR-VIP<Participium<han+LI
januaareqavittoq	januaari-QAR-VIP+TUQ<ental<Absolut
januaareqavittorli	januaari-QAR-VIP+TUQ<ental<Absolut+LI
januaarisiuinnarpa	januaari+SIUR-INNAR<Interrogativ<han
januaarisiuinnartoq	januaari+SIUR-INNAR<Participium<han
januaarisiuinnartoq	januaari+SIUR-INNAR+TUQ<ental<Absolut
januaarisiulaartoq	januaari+SIUR-LAAR<Participium<han
januaarisiulaartorli	januaari+SIUR-LAAR<Participium<han+LI
januaarisiorniartoq	januaari+SIUR+NIAR<Participium<han
januaarisioqqaartorlu	januaari+SIUR-QQAAR<Participium<han+LU
januaarisioqqaartoq	januaari+SIUR-QQAAR+TUQ<ental<Absolut
januaarisioqqutigilluunniit	januaari+SIUR-QQU<Imperativ<ViDem+LUUNNIIT
januaarisioreertoq	januaari+SIUR-RIIR+TUQ<ental<Absolut
januaarisiortaraluarneq	januaari+SIUR+TAR=GALUAR+NIQ<ental<Absolut
januaarisiortariaqartoruna	januaari+SIUR+TARIAQAR<Participium<han+UNA
januaaritaannarpoq	januaari+TAAR-INNAR<Indikativ<han
januaaritaannartorluunniit	januaari+TAAR-INNAR+TUQ<ental<Absolut+LUUNNIIT
januaaritaalaartarpoq	januaari+TAAR-LAAR=TAR<Indikativ<han
januaaritaalaartarnerli	januaari+TAAR-LAAR=TAR+NIQ<ental<Absolut+LI
januaaritaalaartartorli	januaari+TAAR-LAAR=TAR<Participium<han+LI
januaaritaalertoq	januaari+TAAR-LIR<Participium<han
januaaritaalertorlu	januaari+TAAR-LIR<Participium<han+LU
januaaritaalertoq	januaari+TAAR-LIR+TUQ<ental<Absolut
januaaritaalertorlu	januaari+TAAR-LIR+TUQ<ental<Absolut+LU
januaaritaaqqummanga	januaari+TAAR-QQU<Causativ<HanMig
januaaritaariarnini	januaari+TAAR-RIAR+NIQ<ental<sin<Absolut
januaaritaassagaluartorluunniit	januaari+TAAR-SSA=GALUAR+TUQ<ental<Absolut+LUUNNIIT
januaaritaavittoq	januaari+TAAR-VIP<Participium<han
januaariummata	januaari-U<Causativ<de
januaariorusuttoqaannarlutik	januaari-U+GUSUP+TUQ-QAR-INNAR<Ledsagemåde<de_selv
januaarioqqaarama	januaari-U-QQAAR<Causativ<jeg
januaarioqqaarpulli	januaari-U-QQAAR<Indikativ<de+LI
januaarioqqaartungalu	januaari-U-QQAAR<Participium<jeg+LU
januaarioqquatillu	januaari-U-QQU<Indikativ<DuDem+LU
januaarioqqulluginuna	januaari-U-QQU<Ledsagemåde<dem+UNA
januaarioqqulara	januaari-U-QQU<Optativ<JegHam
januaarioriarfik	januaari-U-RIAR+FIK<ental<Absolut
januaarioriarlutilluunniit	januaari-U-RIAR<Ledsagemåde<de_selv+LUUNNIIT
januaariusinnaasorujussuattut	januaari-U+SINNAA+TUQ-RUJUK=SUAQ<ental<deres<Aequalis
januaariussaagullu	januaari-U-SSA<Indikativ<vi+LU
januaariusaraluartussaq	januaari-U+TAR=GALUAR+TUQ-SSAQ<ental<Absolut
januaariusussaanini	januaari-U+TUQ=SSAQ=U+NIQ<ental<sin<Absolut
januaariuallaanngitsorujunguna	januaari-U+VALLAAR=NNGIT+TUQ-RUJUK<ental<Absolut+UNA
januaariuittulli	januaari-U-VIP<Participium<de+LI
kalaaleq	kalaaleq<ental<Absolut
kalaallimeeqqaartorlu	kalaaleq<ental<Instrumentalis-IR-QQAAR+TUQ<ental<Absolut+LU
kalaallimi	kalaaleq<ental<Lokalis
kalaallimeereerpit	kalaaleq<ental<Lokalis+IP-RIIR<Interrogativ<du
kalaallimukareerpisi	kalaaleq<ental<Terminalis-KAR-RIIR<Interrogativ<I
kalaallimulli	kalaaleq<ental<Terminalis+LI
kalaallikkulli	kalaaleq<ental<Vialis+LI
kalaallineertariaqarlutik	kalaaleq<flertal<Instrumentalis-IR+TARIAQAR<Ledsagemåde<de_selv
kalaallini	kalaaleq<flertal<Lokalis
kalaallineeqqaartungaluunniit	kalaaleq<flertal<Lokalis+IP-QQAAR<Participium<jeg+LUUNNIIT
kalaaleriittut	kalaaleq+GIIT<flertal<Aequalis
kalaaleriinneereerlutik	kalaaleq+GIIT<flertal<Lokalis+IP-RIIR<Ledsagemåde<de_selv
kalaaleriilerpiuk	kalaaleq+GIIT-LIR_nv<Interrogativ<DuHam
kalaalikkunneeqqaartoqanngilaq	kalaaleq-KKUT<flertal<Instrumentalis-IR-QQAAR+TUQ-QAR-NNGIT<Indikativ<han
kalaalillit	kalaaleq-LIK<flertal<Relativ
kalaalinnguataluunniit	kalaaleq-NNGUAQ<ental<deres<Relativ+LUUNNIIT
kalaalinngorluarfinnguuffeqassasungali	kalaaleq-NNGUR+LUAR+FIK-NNGUAQ-U+FIK-QAR-SSA<Participium<jeg+LI
kalaalinngoqqaarniniuna	kalaaleq-NNGUR-QQAAR+NIQ<ental<sin<Absolut+UNA
kalaalerpassui	kalaaleq+PASSUAQ<flertal<hans<Absolut
kalaaleqalaartarpoq	kalaaleq-QAR-LAAR=TAR<Indikativ<han
kalaalerujoqaqquiuk	kalaaleq-RUJUK-QAR-QQU<Interrogativ<DuHam
kalaalersioriartorama	kalaaleq+SIUR+GIARTUR<Causativ<jeg
kalaalissaagaluattullu	kalaaleq-SSAQ=U=GALUAQ<ental<deres<Aequalis+LU
kalaalertaannginnerillu	kalaaleq+TAAR-NNGIT+NIQ<flertal<Absolut+LU
kalaaliunerusunnguakkut	kalaaleq-U+NIRU+TUQ-NNGUAQ<ental<Vialis
kalaalioqqutigit	kalaaleq-U-QQU<Imperativ<ViDem
kalaallisulli	kalaallisut<Partikel+LI
kalaallisullu	kalaallisut<Partikel+LU
kalaallisununa	kalaallisut<Partikel+UNA
Kangaatsiaq	Kangaatsiaq<ental<Absolut
Kangaatsiarli	Kangaatsiaq<ental<Absolut+LI
Kangaatsiarlu	Kangaatsiaq<ental<Absolut+LU
Kangaatsiarluunniit	Kangaatsiaq<ental<Absolut+LUUNNIIT
Kangaatsiaruna	Kangaatsiaq<ental<Absolut+UNA
Kangaatsiamik	Kangaatsiaq<Instrumentalis
Kangaatsiamilluunniit	Kangaatsiaq<Instrumentalis+LUUNNIIT
Kangaatsiaminguna	Kangaatsiaq<Instrumentalis+UNA
Kangaatsiami	Kangaatsiaq<Lokalis
Kangaatsiameereerpisi	Kangaatsiaq<Lokalis+IP-RIIR<Interrogativ<I
Kangaatsiamiissallutinguna	Kangaatsiaq<Lokalis+IP-SSA<Ledsagemåde<de_selv+UNA
Kangaatsiamiippallaannginatilli	Kangaatsiaq<Lokalis+IP+VALLAAR=NNGIT<Ledsagemåde<de_selv+LI
Kangaatsiamiluunniit	Kangaatsiaq<Lokalis+LUUNNIIT
Kangaatsiarmiulu	Kangaatsiaq+MIU<ental<Absolut+LU
Kangaatsiarmiuniluunniit	Kangaatsiaq+MIU<flertal<Lokalis+LUUNNIIT
Kangaatsiarmiulerilluarfikunik	Kangaatsiaq+MIU-LIRI+LUAR+FIK-KU<flertal<Instrumentalis
Kangaatsiarmiunngussavit	Kangaatsiaq+MIU-NNGUR-SSA<Interrogativ<du
Kangaatsiarmioqarpoq	Kangaatsiaq+MIU-QAR<Indikativ<han
Kangaatsiarmioqarneq	Kangaatsiaq+MIU-QAR+NIQ<ental<Absolut
Kangaatsiarmioqarnerlu	Kangaatsiaq+MIU-QAR+NIQ<ental<Absolut+LU
Kangaatsiarmiooqquassi	Kangaatsiaq+MIU-U-QQU<Indikativ<JegJer
Kangaatsiarmiooqalutik	Kangaatsiaq+MIU-U-QӘ<Ledsagemåde<de_selv
Kangaatsiarmiooriaratta	Kangaatsiaq+MIU-U-RIAR<Causativ<vi
Kangaatsiarmiooriarlutinguna	Kangaatsiaq+MIU-U-RIAR<Ledsagemåde<de_selv+UNA
Kangaatsiarmiooreertunga	Kangaatsiaq+MIU-U-RIIR<Participium<jeg
Kangaatsiarmiuutipparaluunniit	Kangaatsiaq+MIU-U+TIP<Indikativ<JegHam+LUUNNIIT
Kangaatsiamut	Kangaatsiaq<Terminalis
Kangaatsiamukassagaluarlutik	Kangaatsiaq<Terminalis-KAR-SSA=GALUAR<Ledsagemåde<de_selv
Kangaatsiamulli	Kangaatsiaq<Terminalis+LI
Kangaatsiamullu	Kangaatsiaq<Terminalis+LU
Kangaatsiamununa	Kangaatsiaq<Terminalis+UNA
Kangaatsiakkut	Kangaatsiaq<Vialis
Kangaatsiakkulli	Kangaatsiaq<Vialis+LI
Kangaatsiakkullu	Kangaatsiaq<Vialis+LU
Kangerlussuaq	Kangerlussuaq<ental<Absolut
Kangerlussuarli	Kangerlussuaq<ental<Absolut+LI
Kangerlussuarmik	Kangerlussuaq<Instrumentalis
Kangerlussuarminguna	Kangerlussuaq<Instrumentalis+UNA
Kangerlussuarmi	Kangerlussuaq<Lokalis
Kangerlussuarmiikkiartornerluunniit	Kangerlussuaq<Lokalis+IP+GIARTUR+NIQ<ental<Absolut+LUUNNIIT
Kangerlussuarmeereerpugununa	Kangerlussuaq<Lokalis+IP-RIIR<Indikativ<vi+UNA
Kangerlussuarmeereertut	Kangerlussuaq<Lokalis+IP-RIIR<Participium<de
Kangerlussuarmili	Kangerlussuaq<Lokalis+LI
Kangerlussuarmilu	Kangerlussuaq<Lokalis+LU
Kangerlussuarmiumukaannaramali	Kangerlussuaq+MIU<ental<Terminalis-KAR-INNAR<Causativ<jeg+LI
Kangerlussuarmioqarneq	Kangerlussuaq+MIU-QAR+NIQ<ental<Absolut
Kangerlussuarmioqarnerlu	Kangerlussuaq+MIU-QAR+NIQ<ental<Absolut+LU
Kangerlussuarmioqartorluunniit	Kangerlussuaq+MIU-QAR+TUQ<ental<Absolut+LUUNNIIT
Kangerlussuarmiuulermata	Kangerlussuaq+MIU-U-LIR<Causativ<de
Kangerlussuarmut	Kangerlussuaq<Terminalis
Kangerlussuarmukannginnattalu	Kangerlussuaq<Terminalis-KAR-NNGIT<Causativ<vi+LU
Kangerlussuarmukareertoqarporluunniit	Kangerlussuaq<Terminalis-KAR-RIIR+TUQ-QAR<Indikativ<han+LUUNNIIT
Kangerlussuarmukassagatta	Kangerlussuaq<Terminalis-KAR-SSA<Causativ<vi
Kangerlussuarmulli	Kangerlussuaq<Terminalis+LI
Kangerlussuakkut	Kangerlussuaq<Vialis
Kangerlussuakkulli	Kangerlussuaq<Vialis+LI
Kangerlussuakkullu	Kangerlussuaq<Vialis+LU
Kangerlussuakkulluunniit	Kangerlussuaq<Vialis+LUUNNIIT
Kangerlussuakkununa	Kangerlussuaq<Vialis+UNA
kapitaligivaanngalu	kapitali+GӘ<Indikativ<DeMig+LU
kapitaligalunga	kapitali+GӘ<Ledsagemåde<mig
kapitalikkulli	kapitali-KKUT<flertal<Absolut+LI
kapitalilereriarfeqaannarput	kapitali-LIRI-RIAR+FIK-QAR-INNAR<Indikativ<de
kapitalilerivallaanngimmatali	kapitali-LIRI+VALLAAR=NNGIT<Causativ<de+LI
kapitalimioqartorli	kapitali+MIU-QAR<Participium<han+LI
kapitalinnguiluunniit	kapitali-NNGUAQ<flertal<hans<Absolut+LUUNNIIT
kapitalinnguinnarneq	kapitali-NNGUR-INNAR+NIQ<ental<Absolut
kapitalerpassuilli	kapitali+PASSUAQ<flertal<Absolut+LI
kapitalerpassui	kapitali+PASSUAQ<flertal<deres<Absolut
kapitalerpassuili	kapitali+PASSUAQ<flertal<hans<Absolut+LI
kapitalerpassuarnut	kapitali+PASSUAQ<flertal<Terminalis
kapitaleqalaartarama	kapitali-QAR-LAAR=TAR<Causativ<jeg
kapitaleqalaartarlutinguna	kapitali-QAR-LAAR=TAR<Ledsagemåde<de_selv+UNA
kapitaleqariarmalli	kapitali-QAR-RIAR<Causativ<han+LI
kapitaleqareertoqaannartorujussuarmeeqqulara	kapitali-QAR-RIIR+TUQ-QAR-INNAR+TUQ-RUJUK=SUAQ<ental<Instrumentalis-IR-QQU<Optativ<JegHam
kapitalerujukkali	kapitali-RUJUK<flertal<min<Absolut+LI
kapitalerujussuaq	kapitali-RUJUK=SUAQ<ental<Absolut
kapitalerujussuatalu	kapitali-RUJUK=SUAQ<ental<deres<Relativ+LU
kapitalerujussuataluunniit	kapitali-RUJUK=SUAQ<ental<deres<Relativ+LUUNNIIT
kapitalerujussuili	kapitali-RUJUK=SUAQ<flertal<hans<Absolut+LI
kapitalisiulerlutik	kapitali+SIUR-LIR<Ledsagemåde<de_selv
kapitalissarsioreerlutinguna	kapitali-SSAQ+SIUR-RIIR<Ledsagemåde<de_selv+UNA
kapitalissaagaluata	kapitali-SSAQ=U=GALUAQ<ental<hans<Relativ
kiisa	kiisa<Partikel
kiisalu	kiisa<Partikel+LU
kiisaluunniit	kiisa<Partikel+LUUNNIIT
kiisaana	kiisa<Partikel+UNA
kingulleq	kingulleq<ental<Absolut
kingullerilara	kingulleq+GӘ<Optativ<JegHam
kingullikkulluunniit	kingulleq-KKUT<flertal<Absolut+LUUNNIIT
kingullikkunni	kingulleq-KKUT<flertal<Lokalis
kingullileriunnaarniniluunniit	kingulleq-LIRI+GUNNAAR+NIQ<ental<sin<Absolut+LUUNNIIT
kingullilerisussaagattali	kingulleq-LIRI+TUQ=SSAQ=U<Causativ<vi+LI
kingulleqalertulli	kingulleq-QAR-LIR<Participium<de+LI
kingullerujussuanneereertunga	kingulleq-RUJUK=SUAQ<flertal<min<Lokalis+IP-RIIR<Participium<jeg
kingullerujooreerfissiulaarmat	kingulleq-RUJUK-U-RIIR+FIK+SIUR-LAAR<Causativ<han
kingullersiussammalli	kingulleq+SIUR-SSA<Causativ<han+LI
kisimi	kisimi<Adjektiv
kisimili	kisimi<Adjektiv+LI
kisimilu	kisimi<Adjektiv+LU
kisimiluunniit	kisimi<Adjektiv+LUUNNIIT
kitaaneeqqullugu	kitә<ental<Lokalis<hans+IP-QQU<Ledsagemåde<ham
kitima	kitә<ental<min<Relativ
kitimali	kitә<ental<min<Relativ+LI
kitimaluunniit	kitә<ental<min<Relativ+LUUNNIIT
kitinili	kitә<ental<sin<Absolut+LI
kitaanulli	kitә<ental<Terminalis<hans+LI
kitaannaat	kitә-INNAQ<flertal<Absolut
kitaannalerereernerilluunniit	kitә-INNAQ-LIRI-RIIR+NIQ<flertal<Relativ+LUUNNIIT
kitaannaqalaarfikkunniissavit	kitә-INNAQ-QAR-LAAR+FIK-KKUT<flertal<Instrumentalis-IR-SSA<Interrogativ<du
kitaannaqariarlutilli	kitә-INNAQ-QAR-RIAR<Ledsagemåde<de_selv+LI
kitilia	kitә-LIK<ental<hans<Absolut
kitillit	kitә-LIK<flertal<Relativ
kitilissiulaarfigiittullu	kitә-LIK+SIUR-LAAR+FIK+GIIT<flertal<Aequalis+LU
kitilittaanngitsormioqartoq	kitә-LIK+TAAR-NNGIT+TUQ+MIU-QAR+TUQ<ental<Absolut
kitinnguatununa	kitә-NNGUAQ<ental<Aequalis+UNA
kitinngoorusummatalu	kitә-NNGUAQ-U+GUSUP<Causativ<de+LU
kitissakkali	kitә-SSAQ<flertal<min<Absolut+LI
kitissanngulaartarfiinnaq	kitә-SSAQ-NNGUR-LAAR=TAR+FIK-INNAQ<ental<Absolut
kitissanngunngitsui	kitә-SSAQ-NNGUR-NNGIT+TUQ<flertal<hans<Absolut
kitissanngussaagut	kitә-SSAQ-NNGUR-SSA<Indikativ<vi
kitissannguiffittaartorujussuullutilli	kitә-SSAQ-NNGUR-VIP+FIK+TAAR+TUQ=RUJUK=SUAQ=U<Ledsagemåde<de_selv+LI
kitissartaalaartartormioqarneq	kitә-SSAQ+TAAR-LAAR=TAR+TUQ+MIU-QAR+NIQ<ental<Absolut
kunngiata	kunngi<ental<hans<Relativ
kunngimeeqquiuk	kunngi<ental<Lokalis+IP-QQU<Interrogativ<DuHam
kunngigiilereertigilli	kunngi+GIIT-LIR_nv-RIIR<Imperativ<ViDem+LI
kunngiginikuutigillu	kunngi+GӘ+NIKUU<Imperativ<ViDem+LU
kunngiinnalissagaluarmanga	kunngi-INNAQ-LIR_nv-SSA=GALUAR<Causativ<HanMig
kunngikkuiluunniit	kunngi-KKUT<flertal<hans<Absolut+LUUNNIIT
kunngikunngussagaluarpulluunniit	kunngi-KU-NNGUR-SSA=GALUAR<Indikativ<de+LUUNNIIT
kunngikooqaa	kunngi-KU-U-QӘ<Interrogativ<han
kunngikooriarnerit	kunngi-KU-U-RIAR+NIQ<flertal<Relativ
kunngikooreerpugut	kunngi-KU-U-RIIR<Indikativ<vi
kunngilialli	kunngi-LIK<ental<deres+LI
kunngillilluunniit	kunngi-LIK<flertal<Absolut+LUUNNIIT
kunngillilluunniit	kunngi-LIK<flertal<Relativ+LUUNNIIT
kunngilinnukannginnamaana	kunngi-LIK<flertal<Terminalis-KAR-NNGIT<Causativ<jeg+UNA
kunngilinngoqqaarpungali	kunngi-LIK-NNGUR-QQAAR<Indikativ<jeg+LI
kunngilereqqutigit	kunngi-LIRI-QQU<Imperativ<ViDem
kunngilerisinnaanerpaanni	kunngi-LIRI+SINNAA+NIRPAAQv<flertal<min<Lokalis
kunngimioqarnerluunniit	kunngi+MIU-QAR+NIQ<ental<Absolut+LUUNNIIT
kunngimiooqqaarnerinuna	kunngi+MIU-U-QQAAR+NIQ<flertal<Relativ+UNA
kunnginngoqquiuk	kunngi-NNGUR-QQU<Interrogativ<DuHam
kunnginnguimmalluunniit	kunngi-NNGUR-VIP<Causativ<han+LUUNNIIT
kunngerpassui	kunngi+PASSUAQ<flertal<hans<Absolut
kunngerpassuarni	kunngi+PASSUAQ<flertal<Lokalis
kunngerpassuarniissagaluarpunga	kunngi+PASSUAQ<flertal<Lokalis+IP-SSA=GALUAR<Indikativ<jeg
kunngerpassuakka	kunngi+PASSUAQ<flertal<min<Absolut
kunngerpassuanni	kunngi+PASSUAQ<flertal<min<Lokalis
kunngeqarunnaarmalluunniit	kunngi-QAR+GUNNAAR<Causativ<han+LUUNNIIT
kunngeqalerpugut	kunngi-QAR-LIR<Indikativ<vi
kunngeqanngitsullit	kunngi-QAR-NNGIT+TUQ-LIK<flertal<Absolut
kunngeqaqimmalli	kunngi-QAR-QӘ<Causativ<han+LI
kunngeqariarfii	kunngi-QAR-RIAR+FIK<flertal<hans<Absolut
kunngeqassappununa	kunngi-QAR-SSA<Indikativ<de+UNA
kunngerujulli	kunngi-RUJUK<ental<Absolut+LI
kunngerujulerisorujussuuninilu	kunngi-RUJUK-LIRI+TUQ=RUJUK=SUAQ=U+NIQ<ental<sin<Absolut+LU
kunngerujoqanngitsumeeqqaarnerli	kunngi-RUJUK-QAR-NNGIT+TUQ<ental<Lokalis+IP-QQAAR+NIQ<ental<Absolut+LI
kunngerujoqassagaluarninili	kunngi-RUJUK-QAR-SSA=GALUAR+NIQ<ental<sin<Absolut+LI
kunngerujussuaq	kunngi-RUJUK=SUAQ<ental<Absolut
kunngerujussuata	kunngi-RUJUK=SUAQ<ental<deres<Relativ
kunngerujussuatalu	kunngi-RUJUK=SUAQ<ental<hans<Relativ+LU
kunngerujussuanneereertoq	kunngi-RUJUK=SUAQ<ental<min<Lokalis+IP-RIIR+TUQ<ental<Absolut
kunngerujussuinuna	kunngi-RUJUK=SUAQ<flertal<Absolut+UNA
kunngerujussui	kunngi-RUJUK=SUAQ<flertal<deres<Absolut
kunngerujussuili	kunngi-RUJUK=SUAQ<flertal<hans<Absolut+LI
kunngerujussuilu	kunngi-RUJUK=SUAQ<flertal<hans<Absolut+LU
kunngerujussuamininguna	kunngi-RUJUK=SUAQ<flertal<sin<Instrumentalis+UNA
kunngerujoorusummataluunniit	kunngi-RUJUK-U+GUSUP<Causativ<de+LUUNNIIT
kunngisiulaartarpunga	kunngi+SIUR-LAAR=TAR<Indikativ<jeg
kunngissaagaluata	kunngi-SSAQ=U=GALUAQ<ental<hans<Relativ
kunngitaalermata	kunngi+TAAR-LIR<Causativ<de
kunngitaaqqummanga	kunngi+TAAR-QQU<Causativ<HanMig
kunngioriartoqariarlutik	kunngi-U-RIAR+TUQ-QAR-RIAR<Ledsagemåde<de_selv
maajinngoqquiuk	maaji-NNGUR-QQU<Interrogativ<DuHam
maajeqalaartartoq	maaji-QAR-LAAR=TAR<Participium<han
maajeqanngimmalli	maaji-QAR-NNGIT<Causativ<han+LI
maajitaaqqulara	maaji+TAAR-QQU<Optativ<JegHam
maajitaareertorluunniit	maaji+TAAR-RIIR+TUQ<ental<Absolut+LUUNNIIT
maani	maani<Partikel
maanilu	maani<Partikel+LU
makku	makku<Pronomen<flertal<Absolut
makkuli	makku<Pronomen<flertal<Absolut+LI
makkunani	makku<Pronomen<flertal<Lokalis
makkunaneeqqaarput	makku<Pronomen<flertal<Lokalis+IP-QQAAR<Indikativ<de
makkunaneeriarninili	makku<Pronomen<flertal<Lokalis+IP-RIAR+NIQ<ental<sin<Absolut+LI
makkunaniissallutinguna	makku<Pronomen<flertal<Lokalis+IP-SSA<Ledsagemåde<de_selv+UNA
makkunaniuna	makku<Pronomen<flertal<Lokalis+UNA
malikkiartorlara	malip+GIARTUR<Optativ<JegHam
malilertigilli	malip-LIR<Imperativ<ViDem+LI
malilluarlara	malip+LUAR<Optativ<JegHam
malillara	malip<Optativ<JegHam
maleqqaarlaralu	malip-QQAAR<Optativ<JegHam+LU
maleqqutigilluunniit	malip-QQU<Imperativ<ViDem+LUUNNIIT
maleqaajuk	malip-QӘ<Interrogativ<DuHam
malissimallungalu	malip+SIMA<Ledsagemåde<mig+LU
malissinnaatiginuna	malip+SINNAA<Imperativ<ViDem+UNA
malissinnaallunga	malip+SINNAA<Ledsagemåde<mig
Maniitsoq	Maniitsoq<ental<Absolut
Maniitsorli	Maniitsoq<ental<Absolut+LI
Maniitsorlu	Maniitsoq<ental<Absolut+LU
Maniitsorluunniit	Maniitsoq<ental<Absolut+LUUNNIIT
Maniitsoruna	Maniitsoq<ental<Absolut+UNA
Maniitsumik	Maniitsoq<Instrumentalis
Maniitsumilli	Maniitsoq<Instrumentalis+LI
Maniitsumillu	Maniitsoq<Instrumentalis+LU
Maniitsumilluunniit	Maniitsoq<Instrumentalis+LUUNNIIT
Maniitsuminguna	Maniitsoq<Instrumentalis+UNA
Maniitsumi	Maniitsoq<Lokalis
Maniitsumiileratta	Maniitsoq<Lokalis+IP-LIR<Causativ<vi
Maniitsumiilerpulli	Maniitsoq<Lokalis+IP-LIR<Indikativ<de+LI
Maniitsumeeqqaarporli	Maniitsoq<Lokalis+IP-QQAAR<Indikativ<han+LI
Maniitsumeeqqaarpunga	Maniitsoq<Lokalis+IP-QQAAR<Indikativ<jeg
Maniitsumeeqqaarlutinguna	Maniitsoq<Lokalis+IP-QQAAR<Ledsagemåde<de_selv+UNA
Maniitsumeeqqaarneq	Maniitsoq<Lokalis+IP-QQAAR+NIQ<ental<Absolut
Maniitsumeeqqugakku	Maniitsoq<Lokalis+IP-QQU<Causativ<JegHam
Maniitsumeeqqullugu	Maniitsoq<Lokalis+IP-QQU<Ledsagemåde<ham
Maniitsumeeqqullunga	Maniitsoq<Lokalis+IP-QQU<Ledsagemåde<mig
Maniitsumeereerneq	Maniitsoq<Lokalis+IP-RIIR+NIQ<ental<Absolut
Maniitsumeereertulluunniit	Maniitsoq<Lokalis+IP-RIIR<Participium<de+LUUNNIIT
Maniitsumili	Maniitsoq<Lokalis+LI
Maniitsumilu	Maniitsoq<Lokalis+LU
Maniitsormiumillu	Maniitsoq+MIU<ental<Instrumentalis+LU
Maniitsormiumeeriarferujussuata	Maniitsoq+MIU<ental<Lokalis+IP-RIAR+FIK-RUJUK=SUAQ<ental<deres<Relativ
Maniitsormiumukarusukkama	Maniitsoq+MIU<ental<Terminalis-KAR+GUSUP<Causativ<jeg
Maniitsormiumununa	Maniitsoq+MIU<ental<Terminalis+UNA
Maniitsormiuninguna	Maniitsoq+MIU<flertal<Instrumentalis+UNA
Maniitsormiuni	Maniitsoq+MIU<flertal<Lokalis
Maniitsormiuniinnatik	Maniitsoq+MIU<flertal<Lokalis+IP-NNGIT<Ledsagemåde<de_selv
Maniitsormiuneereerlutilluunniit	Maniitsoq+MIU<flertal<Lokalis+IP-RIIR<Ledsagemåde<de_selv+LUUNNIIT
Maniitsormiulereqquaa	Maniitsoq+MIU-LIRI-QQU<Indikativ<HanHam
Maniitsormiunngoriartortooqqularalu	Maniitsoq+MIU-NNGUR+GIARTUR+TUQ-U-QQU<Optativ<JegHam+LU
Maniitsormiunngulerlutinguna	Maniitsoq+MIU-NNGUR-LIR<Ledsagemåde<de_selv+UNA
Maniitsormiunngoriarmata	Maniitsoq+MIU-NNGUR-RIAR<Causativ<de
Maniitsormiunngoriarlutinguna	Maniitsoq+MIU-NNGUR-RIAR<Ledsagemåde<de_selv+UNA
Maniitsormiunngoreermalluunniit	Maniitsoq+MIU-NNGUR-RIIR<Causativ<han+LUUNNIIT
Maniitsormioqarpoq	Maniitsoq+MIU-QAR<Indikativ<han
Maniitsormioqarpa	Maniitsoq+MIU-QAR<Interrogativ<han
Maniitsormioqarneq	Maniitsoq+MIU-QAR+NIQ<ental<Absolut
Maniitsormioqartoq	Maniitsoq+MIU-QAR+TUQ<ental<Absolut
Maniitsormioqartorli	Maniitsoq+MIU-QAR+TUQ<ental<Absolut+LI
Maniitsormioqartorluunniit	Maniitsoq+MIU-QAR+TUQ<ental<Absolut+LUUNNIIT
Maniitsormioqartoruna	Maniitsoq+MIU-QAR+TUQ<ental<Absolut+UNA
Maniitsormiuugaluarnerpaaqaqqaarnerpaarli	Maniitsoq+MIU-U+GALUAR+NIRPAAQ-QAR-QQAAR+NIRPAAQ<ental<Absolut+LI
Maniitsormioorusullutilli	Maniitsoq+MIU-U+GUSUP<Ledsagemåde<de_selv+LI
Maniitsormiuuinnartussaagaluinuna	Maniitsoq+MIU-U-INNAR+TUQ-SSAQ=U=GALUAQ<flertal<Absolut+UNA
Maniitsormiuulaartarlutilli	Maniitsoq+MIU-U-LAAR=TAR<Ledsagemåde<de_selv+LI
Maniitsormiuulertussalereerparaluunniit	Maniitsoq+MIU-U-LIR+TUQ-SSAQ-LIR_nv-RIIR<Indikativ<JegHam+LUUNNIIT
Maniitsormiooqqullugu	Maniitsoq+MIU-U-QQU<Ledsagemåde<ham
Maniitsormiooqigattali	Maniitsoq+MIU-U-QӘ<Causativ<vi+LI
Maniitsormiooriarlutik	Maniitsoq+MIU-U-RIAR<Ledsagemåde<de_selv
Maniitsormiooreermata	Maniitsoq+MIU-U-RIIR<Causativ<de
Maniitsormiooreertunga	Maniitsoq+MIU-U-RIIR<Participium<jeg
Maniitsormiuussavisi	Maniitsoq+MIU-U-SSA<Interrogativ<I
Maniitsormiuussasorli	Maniitsoq+MIU-U-SSA<Participium<han+LI
Maniitsormiuusarput	Maniitsoq+MIU-U+TAR<Indikativ<de
Maniitsormiuuallaarpunga	Maniitsoq+MIU-U+VALLAAR<Indikativ<jeg
Maniitsormiuuallaarnertulli	Maniitsoq+MIU-U+VALLAAR+NIQ<ental<Aequalis+LI
Maniitsumut	Maniitsoq<Terminalis
Maniitsumukareermatalu	Maniitsoq<Terminalis-KAR-RIIR<Causativ<de+LU
Maniitsumukassagaluarnerluunniit	Maniitsoq<Terminalis-KAR-SSA=GALUAR+NIQ<ental<Absolut+LUUNNIIT
Maniitsumukassallutik	Maniitsoq<Terminalis-KAR-SSA<Ledsagemåde<de_selv
Maniitsumukavikkatta	Maniitsoq<Terminalis-KAR-VIP<Causativ<vi
Maniitsumukavinneruna	Maniitsoq<Terminalis-KAR-VIP+NIQ<ental<Absolut+UNA
Maniitsumulli	Maniitsoq<Terminalis+LI
Maniitsumullu	Maniitsoq<Terminalis+LU
Maniitsumulluunniit	Maniitsoq<Terminalis+LUUNNIIT
Maniitsumununa	Maniitsoq<Terminalis+UNA
Maniitsukkut	Maniitsoq<Vialis
Maniitsukkulli	Maniitsoq<Vialis+LI
Maniitsukkulluunniit	Maniitsoq<Vialis+LUUNNIIT
Maniitsukkununa	Maniitsoq<Vialis+UNA
manna	manna<Pronomen<ental<Absolut
mannali	manna<Pronomen<ental<Absolut+LI
mannaluunniit	manna<Pronomen<ental<Absolut+LUUNNIIT
marluinnalerereertungali	marluk-INNAQ-LIRI-RIIR<Participium<jeg+LI
marlussaavisi	marluk-SSAQ-U<Interrogativ<I
marlulli	marluk<Talord<flertal<Absolut+LI
marlunullu	marluk<Talord<flertal<Terminalis+LU
marlunununa	marluk<Talord<flertal<Terminalis+UNA
marlulissama	marluliaq<ental<min<Relativ
marluliarujussuanneeqqaarneq	marluliaq-RUJUK=SUAQ<flertal<min<Lokalis+IP-QQAAR+NIQ<ental<Absolut
marluliassaagaluillu	marluliaq-SSAQ=U=GALUAQ<flertal<Absolut+LU
massakkut	massakkut<Partikel
massakkulli	massakkut<Partikel+LI
massakkullu	massakkut<Partikel+LU
massakkununa	massakkut<Partikel+UNA
meeqqerivittut	meeqqerivik<ental<Aequalis
meeqqerivittununa	meeqqerivik<ental<Aequalis+UNA
meeqqerivimmiivippugut	meeqqerivik<ental<Instrumentalis-IR-VIP<Indikativ<vi
meeqqerivimmeeqqaartoqanngilaq	meeqqerivik<ental<Lokalis+IP-QQAAR+TUQ-QAR-NNGIT<Indikativ<han
meeqqerivimmeeqqugakkuluunniit	meeqqerivik<ental<Lokalis+IP-QQU<Causativ<JegHam+LUUNNIIT
meeqqerivigaluunniit	meeqqerivik<ental<min<Absolut+LUUNNIIT
meeqqerivinneeqqullunga	meeqqerivik<flertal<Lokalis+IP-QQU<Ledsagemåde<mig
meeqqerivigiittununa	meeqqerivik+GIIT<flertal<Aequalis+UNA
meeqqerivigiviuk	meeqqerivik+GӘ<Interrogativ<DuHam
meeqqerivikoqalaartarpisi	meeqqerivik-KU-QAR-LAAR=TAR<Interrogativ<I
meeqqerivimmiunnguimmanuna	meeqqerivik+MIU-NNGUR-VIP<Causativ<han+UNA
meeqqerivippassuiluunniit	meeqqerivik+PASSUAQ<flertal<hans<Absolut+LUUNNIIT
meeqqerivippassuarni	meeqqerivik+PASSUAQ<flertal<Lokalis
meeqqeriveqaqisoq	meeqqerivik-QAR-QӘ<Participium<han
meeqqeriveqaqisoruna	meeqqerivik-QAR-QӘ<Participium<han+UNA
meeqqeriveqavipput	meeqqerivik-QAR-VIP<Indikativ<de
meeqqeriverujuleqalunga	meeqqerivik-RUJUK-LIR_nv-QӘ<Ledsagemåde<mig
meeqqeriverujussuattut	meeqqerivik-RUJUK=SUAQ<ental<deres<Aequalis
meeqqeriverujussui	meeqqerivik-RUJUK=SUAQ<flertal<deres<Absolut
meeqqeriviunerata	meeqqerivik-U+NIQ<ental<deres<Relativ
meeraq	meeraq<ental<Absolut
meeqqatullu	meeraq<ental<Aequalis+LU
meeqqatulluunniit	meeraq<ental<Aequalis+LUUNNIIT
meeraatalu	meeraq<ental<hans<Relativ+LU
meeqqama	meeraq<ental<min<Relativ
meeqqamalu	meeraq<ental<min<Relativ+LU
meeqqamaana	meeraq<ental<min<Relativ+UNA
meeqqamukartippiuk	meeraq<ental<Terminalis-KAR+TIP<Interrogativ<DuHam
meeqqamununa	meeraq<ental<Terminalis+UNA
meeqqakkullu	meeraq<ental<Vialis+LU
meeqqaneeqqummanga	meeraq<flertal<Instrumentalis-IR-QQU<Causativ<HanMig
meeqqaneeriarlutilluunniit	meeraq<flertal<Instrumentalis-IR-RIAR<Ledsagemåde<de_selv+LUUNNIIT
meeqqaneeriartumulli	meeraq<flertal<Instrumentalis-IR-RIAR+TUQ<ental<Terminalis+LI
meeqqaniissasulluunniit	meeraq<flertal<Instrumentalis-IR-SSA<Participium<de+LUUNNIIT
meeqqaninguna	meeraq<flertal<Instrumentalis+UNA
meeqqani	meeraq<flertal<Lokalis
meeqqaneeqqaarlutillu	meeraq<flertal<Lokalis+IP-QQAAR<Ledsagemåde<de_selv+LU
meeqqaneeqqulara	meeraq<flertal<Lokalis+IP-QQU<Optativ<JegHam
meeqqakkali	meeraq<flertal<min<Absolut+LI
meeqqanniluunniit	meeraq<flertal<min<Lokalis+LUUNNIIT
meeqqama	meeraq<flertal<min<Relativ
meeqqanullu	meeraq<flertal<Terminalis+LU
meerariilererusullutinguna	meeraq+GIIT-LIRI+GUSUP<Ledsagemåde<de_selv+UNA
meerariinngoqqutigilli	meeraq+GIIT-NNGUR-QQU<Imperativ<ViDem+LI
meerallilli	meeraq-LIK<flertal<Absolut+LI
meeralererusunnini	meeraq-LIRI+GUSUP+NIQ<ental<sin<Absolut
meeralerinngillallu	meeraq-LIRI-NNGIT<Indikativ<de+LU
meeralereqisunga	meeraq-LIRI-QӘ<Participium<jeg
meerarmioqarnerli	meeraq+MIU-QAR+NIQ<ental<Absolut+LI
meerarpassuanni	meeraq+PASSUAQ<flertal<min<Lokalis
meerarujussuattut	meeraq-RUJUK=SUAQ<ental<deres<Aequalis
meerarsiuinnarpisi	meeraq+SIUR-INNAR<Interrogativ<I
meerartaariartorujunneereertunga	meeraq+TAAR-RIAR+TUQ-RUJUK<ental<min<Lokalis+IP-RIIR<Participium<jeg
meerartaassavisi	meeraq+TAAR-SSA<Interrogativ<I
mittarfik	mittarfik<ental<Absolut
mittarfilli	mittarfik<ental<Absolut+LI
mittarfillu	mittarfik<ental<Absolut+LU
mittarfilluunniit	mittarfik<ental<Absolut+LUUNNIIT
mittarfittut	mittarfik<ental<Aequalis
mittarfittulli	mittarfik<ental<Aequalis+LI
mittarfimmeeriarninili	mittarfik<ental<Instrumentalis-IR-RIAR+NIQ<ental<sin<Absolut+LI
mittarfiga	mittarfik<ental<min<Absolut
mittarfigali	mittarfik<ental<min<Absolut+LI
mittarfinni	mittarfik<ental<sin<Absolut
mittarfinniuna	mittarfik<ental<sin<Absolut+UNA
mittarfimminik	mittarfik<ental<sin<Instrumentalis
mittarfimmununa	mittarfik<ental<Terminalis+UNA
mittarfinneeqqummangali	mittarfik<flertal<Lokalis+IP-QQU<Causativ<HanMig+LI
mittarfigiileqqutigilluunniit	mittarfik+GIIT-LIR_nv-QQU<Imperativ<ViDem+LUUNNIIT
mittarfiinnaavugut	mittarfik-INNAQ-U<Indikativ<vi
mittarfimmioqarpoq	mittarfik+MIU-QAR<Indikativ<han
mittarfippassuit	mittarfik+PASSUAQ<flertal<Absolut
mittarfippassui	mittarfik+PASSUAQ<flertal<hans<Absolut
mittarfippassuarneeqquaanuna	mittarfik+PASSUAQ<flertal<Instrumentalis-IR-QQU<Indikativ<DeHam+UNA
mittarfippassuarninguna	mittarfik+PASSUAQ<flertal<Instrumentalis+UNA
mittarfeqaannarnerpaarli	mittarfik-QAR-INNAR+NIRPAAQ<ental<Absolut+LI
mittarfeqalertulerereertoq	mittarfik-QAR-LIR+TUQ-LIRI-RIIR<Participium<han
mittarfeqanngifferujussuattununa	mittarfik-QAR-NNGIT+FIK-RUJUK=SUAQ<ental<deres<Aequalis+UNA
mittarfeqarnatinguna	mittarfik-QAR-NNGIT<Ledsagemåde<de_selv+UNA
mittarfeqariarnini	mittarfik-QAR-RIAR+NIQ<ental<sin<Absolut
mittarfeqareertut	mittarfik-QAR-RIIR<Participium<de
mittarfeqassagaluarferujussui	mittarfik-QAR-SSA=GALUAR+FIK-RUJUK=SUAQ<flertal<deres<Absolut
mittarfeqavillutik	mittarfik-QAR-VIP<Ledsagemåde<de_selv
mittarferujulli	mittarfik-RUJUK<ental<Absolut+LI
mittarferujulluunniit	mittarfik-RUJUK<ental<Absolut+LUUNNIIT
mittarferujua	mittarfik-RUJUK<ental<hans<Absolut
mittarferujugaluunniit	mittarfik-RUJUK<ental<min<Absolut+LUUNNIIT
mittarferujukkulli	mittarfik-RUJUK<ental<Vialis+LI
mittarferujussioreertoruna	mittarfik-RUJUK+SIUR-RIIR<Participium<han+UNA
mittarferujussuata	mittarfik-RUJUK=SUAQ<ental<deres<Relativ
mittarferujussua	mittarfik-RUJUK=SUAQ<ental<hans<Absolut
mittarferujussuarmiitsikkakku	mittarfik-RUJUK=SUAQ<ental<Lokalis+IP+TIP<Causativ<JegHam
mittarferujussuara	mittarfik-RUJUK=SUAQ<ental<min<Absolut
mittarferujussuanniilluinnarlutik	mittarfik-RUJUK=SUAQ<ental<min<Lokalis+IP+LUINNAR<Ledsagemåde<de_selv
mittarferujussuinuna	mittarfik-RUJUK=SUAQ<flertal<Absolut+UNA
mittarferujussui	mittarfik-RUJUK=SUAQ<flertal<deres<Absolut
mittarferujussui	mittarfik-RUJUK=SUAQ<flertal<hans<Absolut
mittarferujussuakka	mittarfik-RUJUK=SUAQ<flertal<min<Absolut
mittarferujussuamininguna	mittarfik-RUJUK=SUAQ<flertal<sin<Instrumentalis+UNA
mittarferujuuniarattali	mittarfik-RUJUK-U+NIAR<Causativ<vi+LI
mittarferujooqqaarneq	mittarfik-RUJUK-U-QQAAR+NIQ<ental<Absolut
mittarferujooqimmat	mittarfik-RUJUK-U-QӘ<Causativ<han
mittarferujooreertorujooqquiuk	mittarfik-RUJUK-U-RIIR+TUQ-RUJUK-U-QQU<Interrogativ<DuHam
mittarfissiuinnartunga	mittarfik+SIUR-INNAR<Participium<jeg
mittarfissiulaarnerpaanngoqqaarfeqaqqummanga	mittarfik+SIUR-LAAR+NIRPAAQ-NNGUR-QQAAR+FIK-QAR-QQU<Causativ<HanMig
mittarfissiussagamaluunniit	mittarfik+SIUR-SSA<Causativ<jeg+LUUNNIIT
mittarfissaqareertut	mittarfik-SSAQ-QAR-RIIR<Participium<de
mittarfittaalaartarpugulli	mittarfik+TAAR-LAAR=TAR<Indikativ<vi+LI
mittarfittaalaartarlutinguna	mittarfik+TAAR-LAAR=TAR<Ledsagemåde<de_selv+UNA
mittarfittaaqisungalu	mittarfik+TAAR-QӘ<Participium<jeg+LU
naammasserusuppara	naammassi+GUSUP<Indikativ<JegHam
naammassilerpaannga	naammassi-LIR<Indikativ<DeMig
naammassineqarpugununa	naammassi+NIQAR<Indikativ<vi+UNA
naammasseqquiuk	naammassi-QQU<Interrogativ<DuHam
naammasseqqulara	naammassi-QQU<Optativ<JegHam
naammassereerpaannga	naammassi-RIIR<Indikativ<DeMig
naammassereerpassili	naammassi-RIIR<Indikativ<JegJer+LI
naammassisarparput	naammassi+TAR<Indikativ<ViHam
naammassivallaarmanga	naammassi+VALLAAR<Causativ<HanMig
najakkununa	naja<ental<Vialis+UNA
najarpassui	naja+PASSUAQ<flertal<deres<Absolut
najarpassuaminillu	naja+PASSUAQ<flertal<sin<Instrumentalis+LU
najasiunngila	naja+SIUR-NNGIT<Interrogativ<han
najugaqartartunga	najugaqar+TAR<Participium<jeg
najukkamaana	najugaq<ental<min<Relativ+UNA
najukkamut	najugaq<ental<Terminalis
najukkamulli	najugaq<ental<Terminalis+LI
najugariivi	najugaq+GIIT<flertal<deres<Absolut
nakkarfeqassagaluarlutillu	nakkar+FIK-QAR-SSA=GALUAR<Ledsagemåde<de_selv+LU
nakkarpungaluunniit	nakkar<Indikativ<jeg+LUUNNIIT
nakkaqqaartunngoreerpugulli	nakkar-QQAAR+TUQ-NNGUR-RIIR<Indikativ<vi+LI
nakkarsimallutilli	nakkar+SIMA<Ledsagemåde<de_selv+LI
nakkavikkattali	nakkar-VIP<Causativ<vi+LI
nakkavippit	nakkar-VIP<Interrogativ<du
nakkavinnerpaarli	nakkar-VIP+NIRPAAQ<ental<Absolut+LI
naleqartitannguittulluunniit	naleqartitaq-NNGUR-VIP<Participium<de+LUUNNIIT
naleqartitarujussuit	naleqartitaq-RUJUK=SUAQ<flertal<Absolut
nalujartorpaanga	nalu+GIARTUR<Indikativ<HanMig
nalorusummangaana	nalu+GUSUP<Causativ<HanMig+UNA
naluinnartigillu	nalu-INNAR<Imperativ<ViDem+LU
nalullunga	nalu<Ledsagemåde<mig
naluallaanngilaannga	nalu+VALLAAR=NNGIT<Indikativ<DeMig
namminerli	nammineq<Adjektiv+LI
namminerluunniit	nammineq<Adjektiv+LUUNNIIT
nangeqilara	nangip-QӘ<Optativ<JegHam
nangeriarakku	nangip-RIAR<Causativ<JegHam
nangeriartigit	nangip-RIAR<Imperativ<ViDem
nangereerlunga	nangip-RIIR<Ledsagemåde<mig
nangitsillarali	nangip+TIP<Optativ<JegHam+LI
Nanortalik	Nanortalik<ental<Absolut
Nanortalilli	Nanortalik<ental<Absolut+LI
Nanortalillu	Nanortalik<ental<Absolut+LU
Nanortalinguna	Nanortalik<ental<Absolut+UNA
Nanortalimmilli	Nanortalik<Instrumentalis+LI
Nanortalimmillu	Nanortalik<Instrumentalis+LU
Nanortalimminguna	Nanortalik<Instrumentalis+UNA
Nanortalimmiillutik	Nanortalik<Lokalis+IP<Ledsagemåde<de_selv
Nanortalimmeeqqaarporuna	Nanortalik<Lokalis+IP-QQAAR<Indikativ<han+UNA
Nanortalimmeeqqaarlutik	Nanortalik<Lokalis+IP-QQAAR<Ledsagemåde<de_selv
Nanortalimmeereernerli	Nanortalik<Lokalis+IP-RIIR+NIQ<ental<Absolut+LI
Nanortalimmiuneeqqaarpoq	Nanortalik+MIU<flertal<Lokalis+IP-QQAAR<Indikativ<han
Nanortalimmiunilu	Nanortalik+MIU<flertal<Lokalis+LU
Nanortalimmioqarnerlu	Nanortalik+MIU-QAR+NIQ<ental<Absolut+LU
Nanortalimmioqartoq	Nanortalik+MIU-QAR+TUQ<ental<Absolut
Nanortalimmut	Nanortalik<Terminalis
Nanortalimmukanngilatit	Nanortalik<Terminalis-KAR-NNGIT<Interrogativ<du
Nanortalimmulluunniit	Nanortalik<Terminalis+LUUNNIIT
Nanortalimmununa	Nanortalik<Terminalis+UNA
Nanortalikkut	Nanortalik<Vialis
Nanortalikkulli	Nanortalik<Vialis+LI
Nanortalikkullu	Nanortalik<Vialis+LU
Nanortalikkununa	Nanortalik<Vialis+UNA
Narsaq	Narsaq<ental<Absolut
Narsarli	Narsaq<ental<Absolut+LI
Narsarlu	Narsaq<ental<Absolut+LU
Narsarluunniit	Narsaq<ental<Absolut+LUUNNIIT
Narsameeqqutigillu	Narsaq<Lokalis+IP-QQU<Imperativ<ViDem+LU
Narsamiissagaluarmata	Narsaq<Lokalis+IP-SSA=GALUAR<Causativ<de
Narsamiuna	Narsaq<Lokalis+UNA
Narsarmiuleriartornerpaaqalerferujussualuunniit	Narsaq+MIU-LIRI+GIARTUR+NIRPAAQ-QAR-LIR+FIK-RUJUK=SUAQ<ental<hans<Absolut+LUUNNIIT
Narsarmioqarpa	Narsaq+MIU-QAR<Interrogativ<han
Narsarmioqarneq	Narsaq+MIU-QAR+NIQ<ental<Absolut
Narsarmioqartoq	Narsaq+MIU-QAR+TUQ<ental<Absolut
Narsarmioqartoruna	Narsaq+MIU-QAR+TUQ<ental<Absolut+UNA
Narsarmiooqqaarnerpaatununa	Narsaq+MIU-U-QQAAR+NIRPAAQv<ental<Aequalis+UNA
Narsarmiooriartulereqqutiginuna	Narsaq+MIU-U-RIAR+TUQ-LIRI-QQU<Imperativ<ViDem+UNA
Narsarmiuutillara	Narsaq+MIU-U+TIP<Optativ<JegHam
Narsamukariartoqalaarpungaana	Narsaq<Terminalis-KAR-RIAR+TUQ-QAR-LAAR<Indikativ<jeg+UNA
Narsamukavippullu	Narsaq<Terminalis-KAR-VIP<Indikativ<de+LU
Narsamullu	Narsaq<Terminalis+LU
Narsamununa	Narsaq<Terminalis+UNA
Narsakkulli	Narsaq<Vialis+LI
Narsakkulluunniit	Narsaq<Vialis+LUUNNIIT
Narsarsuaq	Narsarsuaq<ental<Absolut
Narsarsuarminguna	Narsarsuaq<Instrumentalis+UNA
Narsarsuarmut	Narsarsuaq<Terminalis
Narsarsuakkulli	Narsarsuaq<Vialis+LI
Narsarsuakkulluunniit	Narsarsuaq<Vialis+LUUNNIIT
Narsarsuakkununa	Narsarsuaq<Vialis+UNA
nassiussaq	nassiussaq<ental<Absolut
nassiussarilaarlara	nassiussaq+GӘ-LAAR<Optativ<JegHam
nassiussannguaminilluunniit	nassiussaq-NNGUAQ<ental<sin<Instrumentalis+LUUNNIIT
nassiussaqassagama	nassiussaq-QAR-SSA<Causativ<jeg
nassiussarsiunngiffissalilaartartigit	nassiussaq+SIUR-NNGIT+FIK-SSAQ-LIR_nv-LAAR=TAR<Imperativ<ViDem
nassuialaarlugulu	nassuiar-LAAR<Ledsagemåde<ham+LU
nassuialaartartigit	nassuiar-LAAR=TAR<Imperativ<ViDem
nassuialaartarlarali	nassuiar-LAAR=TAR<Optativ<JegHam+LI
nassuiassagaluarlungali	nassuiar-SSA=GALUAR<Ledsagemåde<mig+LI
nillerattalu	niller<Causativ<vi+LU
nillerferujussuanni	niller+FIK-RUJUK=SUAQ<flertal<min<Lokalis
nillerusuttussara	niller+GUSUP+TUQ-SSAQ<ental<min<Absolut
nilliinnarferujussui	niller-INNAR+FIK-RUJUK=SUAQ<flertal<hans<Absolut
nilliinnartungali	niller-INNAR<Participium<jeg+LI
nillilaarmalli	niller-LAAR<Causativ<han+LI
nillilaartunga	niller-LAAR<Participium<jeg
nillilaartarpit	niller-LAAR=TAR<Interrogativ<du
nillilaartarpisi	niller-LAAR=TAR<Interrogativ<I
nillilaartartorujooreerlutik	niller-LAAR=TAR+TUQ-RUJUK-U-RIIR<Ledsagemåde<de_selv
nillilaartussaq	niller-LAAR+TUQ-SSAQ<ental<Absolut
nillilerpit	niller-LIR<Interrogativ<du
nillilernerpaarli	niller-LIR+NIRPAAQ<ental<Absolut+LI
nillerluinnartooriarnini	niller+LUINNAR+TUQ-U-RIAR+NIQ<ental<sin<Absolut
nillinngilarli	niller-NNGIT<Indikativ<han+LI
nilleqqaarfittununa	niller-QQAAR+FIK<ental<Aequalis+UNA
nilleqqaartukkununa	niller-QQAAR+TUQ<ental<Vialis+UNA
nilleqqaartoriilereriarmalli	niller-QQAAR+TUQ+GIIT-LIRI-RIAR<Causativ<han+LI
nilleqqutigit	niller-QQU<Imperativ<ViDem
nilleriarnerata	niller-RIAR+NIQ<ental<hans<Relativ
nilleriartora	niller-RIAR+TUQ<ental<min<Absolut
nillereermalli	niller-RIIR<Causativ<han+LI
nillissagaluarmata	niller-SSA=GALUAR<Causativ<de
nillissagaluarneq	niller-SSA=GALUAR+NIQ<ental<Absolut
nillissallutik	niller-SSA<Ledsagemåde<de_selv
nillivikkattalu	niller-VIP<Causativ<vi+LU
nillivinnerilluunniit	niller-VIP+NIQ<flertal<Relativ+LUUNNIIT
nipilersoraluarnini	nipilersor+GALUAR+NIQ<ental<sin<Absolut
nipilersuinnaramaluunniit	nipilersor-INNAR<Causativ<jeg+LUUNNIIT
nipilersuinnarninili	nipilersor-INNAR+NIQ<ental<sin<Absolut+LI
nipilersulaarmataana	nipilersor-LAAR<Causativ<de+UNA
nipilersulaartarniniluunniit	nipilersor-LAAR=TAR+NIQ<ental<sin<Absolut+LUUNNIIT
nipilersulaartarnerpaamiissasunga	nipilersor-LAAR=TAR+NIRPAAQ<ental<Instrumentalis-IR-SSA<Participium<jeg
nipilersulaartarnerpaartaassallutik	nipilersor-LAAR=TAR+NIRPAAQ+TAAR-SSA<Ledsagemåde<de_selv
nipilersulerfissiulaartarfileqitigillu	nipilersor-LIR+FIK+SIUR-LAAR=TAR+FIK-LIR_nv-QӘ<Imperativ<ViDem+LU
nipilersorluarpit	nipilersor+LUAR<Interrogativ<du
nipilersorluarlutilli	nipilersor+LUAR<Ledsagemåde<de_selv+LI
nipilersorluarnerillu	nipilersor+LUAR+NIQ<flertal<Relativ+LU
nipilersornikuuffeqaqqaartorli	nipilersor+NIKUU+FIK-QAR-QQAAR<Participium<han+LI
nipilersoqqutigillu	nipilersor-QQU<Imperativ<ViDem+LU
nipilersoriarfeqalaarpungaana	nipilersor-RIAR+FIK-QAR-LAAR<Indikativ<jeg+UNA
nipilersoreertulissaviuk	nipilersor-RIIR+TUQ-LIR_nv-SSA<Interrogativ<DuHam
nipilersussagaluarnerpaaqannginnini	nipilersor-SSA=GALUAR+NIRPAAQ-QAR-NNGIT+NIQ<ental<sin<Absolut
nipilersussaangaluunniit	nipilersor-SSA<Indikativ<jeg+LUUNNIIT
nipilersussasunga	nipilersor-SSA<Participium<jeg
nipilersuinnerpaaruna	nipilersor-VIP+NIRPAAQ<ental<Absolut+UNA
nuannarerusullungali	nuannarә+GUSUP<Ledsagemåde<mig+LI
nuannarisimasarmangaluunniit	nuannarә+SIMA=TAR<Causativ<HanMig+LUUNNIIT
nuannarissalluginuna	nuannarә-SSA<Ledsagemåde<dem+UNA
nuannarisariaqarakkulu	nuannarә+TARIAQAR<Causativ<JegHam+LU
nuannarisartigilli	nuannarә+TAR<Imperativ<ViDem+LI
nujaq	nujaq<ental<Absolut
nujanneeqqaartoq	nujaq<ental<min<Lokalis+IP-QQAAR<Participium<han
nutsama	nujaq<ental<min<Relativ
nutsakkaluunniit	nujaq<flertal<min<Absolut+LUUNNIIT
nutsanut	nujaq<flertal<Terminalis
nutsanukavikkattalu	nujaq<flertal<Terminalis-KAR-VIP<Causativ<vi+LU
nujartaalaartarneq	nujaq+TAAR-LAAR=TAR+NIQ<ental<Absolut
nukamioqarpa	nuka+MIU-QAR<Interrogativ<han
nukinneeqqularalu	nukik<ental<min<Lokalis+IP-QQU<Optativ<JegHam+LU
nukerujulli	nukik-RUJUK<ental<Absolut+LI
nukerujumma	nukik-RUJUK<ental<min<Relativ
nukerujussui	nukik-RUJUK=SUAQ<flertal<deres<Absolut
nukerujooqigatta	nukik-RUJUK-U-QӘ<Causativ<vi
nuliaq	nuliaq<ental<Absolut
nuliara	nuliaq<ental<min<Absolut
nuliaraluunniit	nuliaq<ental<min<Absolut+LUUNNIIT
nuliarpassuarneereertoqarporli	nuliaq+PASSUAQ<flertal<Instrumentalis-IR-RIIR+TUQ-QAR<Indikativ<han+LI
nuliarpassuaminik	nuliaq+PASSUAQ<flertal<sin<Instrumentalis
nuliartaaqigama	nuliaq+TAAR-QӘ<Causativ<jeg
nunameertimmangali	nuna<ental<Instrumentalis-IR+TIP<Causativ<HanMig+LI
nunagiilerisimagamali	nuna+GIIT-LIRI+SIMA<Causativ<jeg+LI
nunagivallaarlungaluunniit	nuna+GӘ+VALLAAR<Ledsagemåde<mig+LUUNNIIT
nunakkui	nuna-KKUT<flertal<hans<Absolut
nunarpassuartut	nuna+PASSUAQ<flertal<Aequalis
nunarpassui	nuna+PASSUAQ<flertal<hans<Absolut
nunarujussuiluunniit	nuna-RUJUK=SUAQ<flertal<deres<Absolut+LUUNNIIT
nutaanngussagaluarnerli	nutaaq-NNGUR-SSA=GALUAR+NIQ<ental<Absolut+LI
nutaaqaqqaarnerli	nutaaq-QAR-QQAAR+NIQ<ental<Absolut+LI
nutserisuniivipporuna	nutserisoq<flertal<Instrumentalis-IR-VIP<Indikativ<han+UNA
nutserisukooreerlutik	nutserisoq-KU-U-RIIR<Ledsagemåde<de_selv
nutserisussalerisussaagaluaminik	nutserisoq-SSAQ-LIRI+TUQ-SSAQ=U=GALUAQ<flertal<sin<Instrumentalis
nutserisussaagaluata	nutserisoq-SSAQ=U=GALUAQ<ental<hans<Relativ
Nuuk	Nuuk<ental<Absolut
Nuulli	Nuuk<ental<Absolut+LI
Nuullu	Nuuk<ental<Absolut+LU
Nuulluunniit	Nuuk<ental<Absolut+LUUNNIIT
Nuunguna	Nuuk<ental<Absolut+UNA
Nuummik	Nuuk<Instrumentalis
Nuummilli	Nuuk<Instrumentalis+LI
Nuumminguna	Nuuk<Instrumentalis+UNA
Nuummeeqqaarnerlu	Nuuk<Lokalis+IP-QQAAR+NIQ<ental<Absolut+LU
Nuummeeqqaartorlu	Nuuk<Lokalis+IP-QQAAR+TUQ<ental<Absolut+LU
Nuummeeqqualli	Nuuk<Lokalis+IP-QQU<Indikativ<DuHam+LI
Nuummeeqqullugu	Nuuk<Lokalis+IP-QQU<Ledsagemåde<ham
Nuummeeriarlutik	Nuuk<Lokalis+IP-RIAR<Ledsagemåde<de_selv
Nuummeeriartorujussualu	Nuuk<Lokalis+IP-RIAR+TUQ-RUJUK=SUAQ<ental<hans<Absolut+LU
Nuummeereermat	Nuuk<Lokalis+IP-RIIR<Causativ<han
Nuummeereerpit	Nuuk<Lokalis+IP-RIIR<Interrogativ<du
Nuummeereerlutilli	Nuuk<Lokalis+IP-RIIR<Ledsagemåde<de_selv+LI
Nuummiunngoqimmata	Nuuk+MIU-NNGUR-QӘ<Causativ<de
Nuummioqarnerli	Nuuk+MIU-QAR+NIQ<ental<Absolut+LI
Nuummioqartorli	Nuuk+MIU-QAR<Participium<han+LI
Nuummiooreerpa	Nuuk+MIU-U-RIIR<Interrogativ<han
Nuummiuuallaanngilasi	Nuuk+MIU-U+VALLAAR=NNGIT<Interrogativ<I
Nuummut	Nuuk<Terminalis
Nuummukalaartungali	Nuuk<Terminalis-KAR-LAAR<Participium<jeg+LI
Nuummukareerpa	Nuuk<Terminalis-KAR-RIIR<Interrogativ<han
Nuummukassammanuna	Nuuk<Terminalis-KAR-SSA<Causativ<han+UNA
Nuummukassaagulluunniit	Nuuk<Terminalis-KAR-SSA<Indikativ<vi+LUUNNIIT
Nuummununa	Nuuk<Terminalis+UNA
Nuukkut	Nuuk<Vialis
Nuukkulli	Nuuk<Vialis+LI
Nuukkullu	Nuuk<Vialis+LU
Nuukkulluunniit	Nuuk<Vialis+LUUNNIIT
Nuukkununa	Nuuk<Vialis+UNA
nuuffilittaalaartarlutik	nuup+FIK-LIK+TAAR-LAAR=TAR<Ledsagemåde<de_selv
nuufferujussuanni	nuup+FIK-RUJUK=SUAQ<ental<min<Lokalis
nuukkunnaarpunga	nuup+GUNNAAR<Indikativ<jeg
nuulluarnini	nuup+LUAR+NIQ<ental<sin<Absolut
nuulluinnarnini	nuup+LUINNAR+NIQ<ental<sin<Absolut
nuulluinnartorujussuata	nuup+LUINNAR+TUQ-RUJUK=SUAQ<ental<hans<Relativ
nuunnianngitsooriarferujoqassallutilli	nuup+NIAR=NNGIT+TUQ-U-RIAR+FIK-RUJUK-QAR-SSA<Ledsagemåde<de_selv+LI
nooqqaarfinnguinnarama	nuup-QQAAR+FIK-NNGUR-INNAR<Causativ<jeg
nooqqaarpunga	nuup-QQAAR<Indikativ<jeg
nooqqaarlutilluunniit	nuup-QQAAR<Ledsagemåde<de_selv+LUUNNIIT
nooqqaarnerpaaq	nuup-QQAAR+NIRPAAQ<ental<Absolut
nooqqaarnerpaakkununa	nuup-QQAAR+NIRPAAQv<ental<Vialis+UNA
nooqqaarnerpaanneeqquakkaluunniit	nuup-QQAAR+NIRPAAQv<flertal<min<Lokalis+IP-QQU<Indikativ<JegDem+LUUNNIIT
nooqqaartungali	nuup-QQAAR<Participium<jeg+LI
nooqqummanga	nuup-QQU<Causativ<HanMig
nooqqugakkuli	nuup-QQU<Causativ<JegHam+LI
nooqqutigit	nuup-QQU<Imperativ<ViDem
nooqqutigilli	nuup-QQU<Imperativ<ViDem+LI
nooqqutigilluunniit	nuup-QQU<Imperativ<ViDem+LUUNNIIT
nooqqutiginuna	nuup-QQU<Imperativ<ViDem+UNA
nooqquiuk	nuup-QQU<Interrogativ<DuHam
nooqqullugu	nuup-QQU<Ledsagemåde<ham
nooqqulara	nuup-QQU<Optativ<JegHam
nooqimmallu	nuup-QӘ<Causativ<han+LU
nooqigama	nuup-QӘ<Causativ<jeg
nooqaagulli	nuup-QӘ<Indikativ<vi+LI
nooqaat	nuup-QӘ<Interrogativ<du
nooqalutillu	nuup-QӘ<Ledsagemåde<de_selv+LU
nooqisooqqaarninili	nuup-QӘ+TUQ-U-QQAAR+NIQ<ental<sin<Absolut+LI
nooriarama	nuup-RIAR<Causativ<jeg
nooriarfeqalerneq	nuup-RIAR+FIK-QAR-LIR+NIQ<ental<Absolut
nooriarfeqariarnerillu	nuup-RIAR+FIK-QAR-RIAR+NIQ<flertal<Absolut+LU
nooriarfioriarfippassui	nuup-RIAR+FIK-U-RIAR+FIK+PASSUAQ<flertal<deres<Absolut
nooriarlutinguna	nuup-RIAR<Ledsagemåde<de_selv+UNA
nooriartoqavippit	nuup-RIAR+TUQ-QAR-VIP<Interrogativ<du
nooriartorujussuata	nuup-RIAR+TUQ-RUJUK=SUAQ<ental<deres<Relativ
nooreermat	nuup-RIIR<Causativ<han
nooreerfiit	nuup-RIIR+FIK<flertal<Relativ
nooreerfilissagaluarparaana	nuup-RIIR+FIK-LIR_nv-SSA=GALUAR<Indikativ<JegHam+UNA
nooreerferujussuanneeriarlutik	nuup-RIIR+FIK-RUJUK=SUAQ<ental<min<Lokalis+IP-RIAR<Ledsagemåde<de_selv
nooreerlutik	nuup-RIIR<Ledsagemåde<de_selv
nooreerlutillu	nuup-RIIR<Ledsagemåde<de_selv+LU
nooreernernili	nuup-RIIR+NIQ<flertal<Lokalis+LI
nooreernerpaannguinnartunga	nuup-RIIR+NIRPAAQ-NNGUR-INNAR<Participium<jeg
nooreernerpaanngoqqaarneralli	nuup-RIIR+NIRPAAQ-NNGUR-QQAAR+NIQ<ental<deres+LI
nooreertunngualerivallaarnerpaarsioqalutinguna	nuup-RIIR+TUQ-NNGUAQ-LIRI+VALLAAR+NIRPAAQ+SIUR-QӘ<Ledsagemåde<de_selv+UNA
nuussimasartulli	nuup+SIMA=TAR<Participium<de+LI
nuussinnaava	nuup+SINNAA<Interrogativ<han
oqaaseq	oqaaseq<ental<Absolut
oqaasiat	oqaaseq<ental<Absolut<deres
oqaatsitullu	oqaaseq<ental<Aequalis+LU
oqaatsitulluunniit	oqaaseq<ental<Aequalis+LUUNNIIT
oqaatsimeerniarnerluunniit	oqaaseq<ental<Instrumentalis-IR+NIAR+NIQ<ental<Absolut+LUUNNIIT
oqaatsimillu	oqaaseq<ental<Instrumentalis+LU
oqaatsimi	oqaaseq<ental<Lokalis
oqaatsimeereertulli	oqaaseq<ental<Lokalis+IP-RIIR<Participium<de+LI
oqaatsimili	oqaaseq<ental<Lokalis+LI
oqaasera	oqaaseq<ental<min<Absolut
oqaatsinni	oqaaseq<ental<min<Lokalis
oqaatsini	oqaaseq<ental<sin<Absolut
oqaatsiminilli	oqaaseq<ental<sin<Instrumentalis+LI
oqaatsiminillu	oqaaseq<ental<sin<Instrumentalis+LU
oqaatsimininguna	oqaaseq<ental<sin<Instrumentalis+UNA
oqaatsimut	oqaaseq<ental<Terminalis
oqaasii	oqaaseq<flertal<deres<Absolut
oqaasiili	oqaaseq<flertal<deres<Absolut+LI
oqaatsinut	oqaaseq<flertal<flertal<Terminalis
oqaatsinukaqquaa	oqaaseq<flertal<flertal<Terminalis-KAR-QQU<Indikativ<HanHam
oqaatsiniilaartartorli	oqaaseq<flertal<Instrumentalis-IR-LAAR=TAR<Participium<han+LI
oqaatsini	oqaaseq<flertal<Lokalis
oqaatsineeqqaarput	oqaaseq<flertal<Lokalis+IP-QQAAR<Indikativ<de
oqaatsineeqqaarnerluunniit	oqaaseq<flertal<Lokalis+IP-QQAAR+NIQ<ental<Absolut+LUUNNIIT
oqaatsineeriartorpassui	oqaaseq<flertal<Lokalis+IP-RIAR+TUQ+PASSUAQ<flertal<hans<Absolut
oqaatsinili	oqaaseq<flertal<Lokalis+LI
oqaatsiniluunniit	oqaaseq<flertal<Lokalis+LUUNNIIT
oqaatsinni	oqaaseq<flertal<min<Lokalis
oqaatsinneeqquaanga	oqaaseq<flertal<min<Lokalis+IP-QQU<Indikativ<HanMig
oqaatsinneereerpungalu	oqaaseq<flertal<min<Lokalis+IP-RIIR<Indikativ<jeg+LU
oqaatsima	oqaaseq<flertal<min<Relativ
oqaatsiminik	oqaaseq<flertal<sin<Instrumentalis
oqaasikoqaqqaarfiinnaqassagattali	oqaaseq-KU-QAR-QQAAR+FIK-INNAQ-QAR-SSA<Causativ<vi+LI
oqaasilissiussallutinguna	oqaaseq-LIK+SIUR-SSA<Ledsagemåde<de_selv+UNA
oqaasilerissavit	oqaaseq-LIRI-SSA<Interrogativ<du
oqaasilivimmanga	oqaaseq-LIR_nv-VIP<Causativ<HanMig
oqaaserujoqaqqaarmallu	oqaaseq-RUJUK-QAR-QQAAR<Causativ<han+LU
oqaasissanngussagaluarnera	oqaaseq-SSAQ-NNGUR-SSA=GALUAR+NIQ<ental<hans<Absolut
oqaasioriartooqqaarpit	oqaaseq-U-RIAR+TUQ-U-QQAAR<Interrogativ<du
oqaasilerinikka	oqaasilerineq<flertal<min<Absolut
oqaasilerineriniarlara	oqaasilerineq+GӘ+NIAR<Optativ<JegHam
oqaasilerinermioqartorluunniit	oqaasilerineq+MIU-QAR+TUQ<ental<Absolut+LUUNNIIT
oqaasilerininngoorusullutilli	oqaasilerineq-NNGUAQ-U+GUSUP<Ledsagemåde<de_selv+LI
oqaasilerininngooriarlutilli	oqaasilerineq-NNGUAQ-U-RIAR<Ledsagemåde<de_selv+LI
oqaasilerinerujussuattununa	oqaasilerineq-RUJUK=SUAQ<ental<deres<Aequalis+UNA
oqaluttuaq	oqaluttuaq<ental<Absolut
oqaluttuarli	oqaluttuaq<ental<Absolut+LI
oqaluttuariittununa	oqaluttuaq+GIIT<flertal<Aequalis+UNA
oqaluttuariinngoqaat	oqaluttuaq+GIIT-NNGUR-QӘ<Indikativ<de
oqaluttualereqisooriartoqassagaluarpugulli	oqaluttuaq-LIRI-QӘ+TUQ-U-RIAR+TUQ-QAR-SSA=GALUAR<Indikativ<vi+LI
oqaluttualereertigillu	oqaluttuaq-LIR_nv-RIIR<Imperativ<ViDem+LU
oqaluttuarmiulereriarnerinuna	oqaluttuaq+MIU-LIRI-RIAR+NIQ<flertal<Relativ+UNA
oqaluttuanngulaarmatali	oqaluttuaq-NNGUR-LAAR<Causativ<de+LI
oqaluttuanngoqqularaluunniit	oqaluttuaq-NNGUR-QQU<Optativ<JegHam+LUUNNIIT
oqaluttuanngoqisorujuga	oqaluttuaq-NNGUR-QӘ+TUQ-RUJUK<ental<min<Absolut
oqaluttuarujoqaqqutigit	oqaluttuaq-RUJUK-QAR-QQU<Imperativ<ViDem
oqaluttuarsiunngiffiuinnarnerilluunniit	oqaluttuaq+SIUR-NNGIT+FIK-U-INNAR+NIQ<flertal<Absolut+LUUNNIIT
oqaluttuarsioqqutigit	oqaluttuaq+SIUR-QQU<Imperativ<ViDem
oqaluttuassalilaarpakkaana	oqaluttuaq-SSAQ-LIR_nv-LAAR<Indikativ<JegDem+UNA
oqaluttuassaagalui	oqaluttuaq-SSAQ=U=GALUAQ<flertal<deres<Absolut
oqaluttuassaagaluili	oqaluttuaq-SSAQ=U=GALUAQ<flertal<hans<Absolut+LI
oqaluttuassaagaluanni	oqaluttuaq-SSAQ=U=GALUAQ<flertal<min<Lokalis
oqaluttuartaaqqaarpisi	oqaluttuaq+TAAR-QQAAR<Interrogativ<I
oqaluttuartaarpallaannginnernukalerpoq	oqaluttuaq+TAAR+VALLAAR=NNGIT+NIQ<flertal<Terminalis-KAR-LIR<Indikativ<han
oqaluttuaalerfikkunnilluunniit	oqaluttuaq-U-LIR+FIK-KKUT<flertal<Instrumentalis+LUUNNIIT
oqaluttuaannartussaagaluanneereerpa	oqaluttuar-INNAR+TUQ-SSAQ=U=GALUAQ<flertal<min<Lokalis+IP-RIIR<Interrogativ<han
oqaluttuarpa	oqaluttuar<Interrogativ<han
oqaluttualaartarama	oqaluttuar-LAAR=TAR<Causativ<jeg
oqaluttuarniarlutinguna	oqaluttuar+NIAR<Ledsagemåde<de_selv+UNA
oqaluttuarniartunga	oqaluttuar+NIAR<Participium<jeg
oqaluttuarnera	oqaluttuar+NIQ<ental<hans<Absolut
oqaluttuarnini	oqaluttuar+NIQ<ental<sin<Absolut
oqaluttuartoq	oqaluttuar<Participium<han
oqaluttuariarferujummut	oqaluttuar-RIAR+FIK-RUJUK<ental<Terminalis
oqaluttuarsimasarporlu	oqaluttuar+SIMA=TAR<Indikativ<han+LU
oqaluttuassasungalu	oqaluttuar-SSA<Participium<jeg+LU
oqaluttuartariaqarpa	oqaluttuar+TARIAQAR<Interrogativ<han
oqaluttuartorujorujussuunerpaaqaqqullunga	oqaluttuar+TUQ=RUJUK=RUJUK=SUAQ=U+NIRPAAQ-QAR-QQU<Ledsagemåde<mig
oqaluttuarpallaannginnamali	oqaluttuar+VALLAAR=NNGIT<Causativ<jeg+LI
oqaluttuarilluinnarpaangali	oqaluttuarә+LUINNAR<Indikativ<HanMig+LI
oqarama	oqar<Causativ<jeg
oqarfigerusullugu	oqarfigә+GUSUP<Ledsagemåde<ham
oqarfimmilluunniit	oqar+FIK<ental<Instrumentalis+LUUNNIIT
oqaraluarferujunguna	oqar+GALUAR+FIK-RUJUK<ental<Absolut+UNA
oqariartorferujussuata	oqar+GIARTUR+FIK-RUJUK=SUAQ<ental<deres<Relativ
oqariartorferujussuaminilli	oqar+GIARTUR+FIK-RUJUK=SUAQ<flertal<sin<Instrumentalis+LI
oqariartorlutik	oqar+GIARTUR<Ledsagemåde<de_selv
oqariartorninili	oqar+GIARTUR+NIQ<ental<sin<Absolut+LI
oqariartortoq	oqar+GIARTUR<Participium<han
oqarunnaartoqassagaluarmat	oqar+GUNNAAR+TUQ-QAR-SSA=GALUAR<Causativ<han
oqarunnaartooreeramalu	oqar+GUNNAAR+TUQ-U-RIIR<Causativ<jeg+LU
oqarpunga	oqar<Indikativ<jeg
oqarpugununa	oqar<Indikativ<vi+UNA
oqaannarfilissagaluarlugu	oqar-INNAR+FIK-LIR_nv-SSA=GALUAR<Ledsagemåde<ham
oqaannarpullu	oqar-INNAR<Indikativ<de+LU
oqaannarnini	oqar-INNAR+NIQ<ental<sin<Absolut
oqarpit	oqar<Interrogativ<du
oqarpa	oqar<Interrogativ<han
oqalaarnerpaata	oqar-LAAR+NIRPAAQ<ental<deres<Relativ
oqalaartunga	oqar-LAAR<Participium<jeg
oqalaartarpit	oqar-LAAR=TAR<Interrogativ<du
oqarlutillu	oqar<Ledsagemåde<de_selv+LU
oqalermanuna	oqar-LIR<Causativ<han+UNA
oqalerfilimmali	oqar-LIR+FIK-LIK<ental<min<Relativ+LI
oqalerfippassui	oqar-LIR+FIK+PASSUAQ<flertal<deres<Absolut
oqalerpulli	oqar-LIR<Indikativ<de+LI
oqalerniniluunniit	oqar-LIR+NIQ<ental<sin<Absolut+LUUNNIIT
oqarluarmata	oqar+LUAR<Causativ<de
oqarluartooqquiuk	oqar+LUAR+TUQ-U-QQU<Interrogativ<DuHam
oqarluinnarmatali	oqar+LUINNAR<Causativ<de+LI
oqarluinnartunngualu	oqar+LUINNAR+TUQ-NNGUAQ<ental<hans<Absolut+LU
oqarnerpaaneeqqaarpugut	oqar+NIRPAAQ<flertal<Lokalis+IP-QQAAR<Indikativ<vi
oqarneruffinngoorusuppugullu	oqar+NIRU+FIK-NNGUAQ-U+GUSUP<Indikativ<vi+LU
oqarnerua	oqar+NIRU<Interrogativ<han
oqarneruneq	oqar+NIRU+NIQ<ental<Absolut
oqarnerunini	oqar+NIRU+NIQ<ental<sin<Absolut
oqannginnatta	oqar-NNGIT<Causativ<vi
oqanngilagulluunniit	oqar-NNGIT<Indikativ<vi+LUUNNIIT
oqanngilatit	oqar-NNGIT<Interrogativ<du
oqannginnini	oqar-NNGIT+NIQ<ental<sin<Absolut
oqanngitsukunnguinnarpa	oqar-NNGIT+TUQ-KU-NNGUR-INNAR<Interrogativ<han
oqartorli	oqar<Participium<han+LI
oqartungali	oqar<Participium<jeg+LI
oqartungalu	oqar<Participium<jeg+LU
oqaqqaarlutilli	oqar-QQAAR<Ledsagemåde<de_selv+LI
oqaqqaarneq	oqar-QQAAR+NIQ<ental<Absolut
oqaqqaartoruna	oqar-QQAAR<Participium<han+UNA
oqaqqummangali	oqar-QQU<Causativ<HanMig+LI
oqaqqugakkuli	oqar-QQU<Causativ<JegHam+LI
oqaqqugakkulu	oqar-QQU<Causativ<JegHam+LU
oqaqqutigit	oqar-QQU<Imperativ<ViDem
oqaqquaali	oqar-QQU<Indikativ<HanDem+LI
oqaqaagullu	oqar-QӘ<Indikativ<vi+LU
oqareerlutilli	oqar-RIIR<Ledsagemåde<de_selv+LI
oqareertunnguittumeeqqullunga	oqar-RIIR+TUQ-NNGUR-VIP+TUQ<ental<Lokalis+IP-QQU<Ledsagemåde<mig
oqarsimaffippassuakka	oqar+SIMA+FIK+PASSUAQ<flertal<min<Absolut
oqarsimasarpisi	oqar+SIMA=TAR<Interrogativ<I
oqarsimasulinniluunniit	oqar+SIMA+TUQ-LIK<flertal<Lokalis+LUUNNIIT
oqassammalluunniit	oqar-SSA<Causativ<han+LUUNNIIT
oqassagaluarpa	oqar-SSA=GALUAR<Interrogativ<han
oqassagaluarlutik	oqar-SSA=GALUAR<Ledsagemåde<de_selv
oqassavit	oqar-SSA<Interrogativ<du
oqassallutik	oqar-SSA<Ledsagemåde<de_selv
oqassasungali	oqar-SSA<Participium<jeg+LI
oqartaraluarnerpaaqartorujussuuneq	oqar+TAR=GALUAR+NIRPAAQ-QAR+TUQ=RUJUK=SUAQ=U+NIQ<ental<Absolut
oqartariaqarpa	oqar+TARIAQAR<Interrogativ<han
oqartartukuusimasarpunga	oqar+TAR+TUQ-KU-U+SIMA=TAR<Indikativ<jeg
oqartartoqaqqugakkulu	oqar+TAR+TUQ-QAR-QQU<Causativ<JegHam+LU
oqartimmanga	oqar+TIP<Causativ<HanMig
oqartillara	oqar+TIP<Optativ<JegHam
oqartorujorujussuugatta	oqar+TUQ=RUJUK=RUJUK=SUAQ=U<Causativ<vi
oqartorujorujussuuffileqqaarlugilli	oqar+TUQ=RUJUK=RUJUK=SUAQ=U+FIK-LIR_nv-QQAAR<Ledsagemåde<dem+LI
oqartorujorujussuullutinguna	oqar+TUQ=RUJUK=RUJUK=SUAQ=U<Ledsagemåde<de_selv+UNA
oqartorujussuummat	oqar+TUQ=RUJUK=SUAQ=U<Causativ<han
oqartorujussuunerpaaneerpallaarattaluunniit	oqar+TUQ=RUJUK=SUAQ=U+NIRPAAQ<flertal<Instrumentalis-IR+VALLAAR<Causativ<vi+LUUNNIIT
oqartussaasunga	oqar+TUQ=SSAQ=U<Participium<jeg
oqarpallaanngimmalluunniit	oqar+VALLAAR=NNGIT<Causativ<han+LUUNNIIT
oqarpallaanngilatit	oqar+VALLAAR=NNGIT<Interrogativ<du
oqarpallaannginatilli	oqar+VALLAAR=NNGIT<Ledsagemåde<de_selv+LI
oqarpallaannginnerilli	oqar+VALLAAR=NNGIT+NIQ<flertal<Relativ+LI
oqavikkama	oqar-VIP<Causativ<jeg
oqavippulluunniit	oqar-VIP<Indikativ<de+LUUNNIIT
oqavippisi	oqar-VIP<Interrogativ<I
oqavittuata	oqar-VIP+TUQ<ental<deres<Relativ
Paamiut	Paamiut<Absolut
Paamiulli	Paamiut<Absolut+LI
Paamiullu	Paamiut<Absolut+LU
Paamiununa	Paamiut<Absolut+UNA
Paamiunik	Paamiut<Instrumentalis
Paamiunilli	Paamiut<Instrumentalis+LI
Paamiunilluunniit	Paamiut<Instrumentalis+LUUNNIIT
Paamiuninguna	Paamiut<Instrumentalis+UNA
Paamiuni	Paamiut<Lokalis
Paamiuneeqqaarpisi	Paamiut<Lokalis+IP-QQAAR<Interrogativ<I
Paamiuneeqqaartoq	Paamiut<Lokalis+IP-QQAAR+TUQ<ental<Absolut
Paamiuneeqqummanga	Paamiut<Lokalis+IP-QQU<Causativ<HanMig
Paamiuneeqquarali	Paamiut<Lokalis+IP-QQU<Indikativ<JegHam+LI
Paamiuneereermallu	Paamiut<Lokalis+IP-RIIR<Causativ<han+LU
Paamiuneereertoqarpoq	Paamiut<Lokalis+IP-RIIR+TUQ-QAR<Indikativ<han
Paamiuniissasunga	Paamiut<Lokalis+IP-SSA<Participium<jeg
Paamiormiu	Paamiut+MIU<ental<Absolut
Paamiormiumi	Paamiut+MIU<ental<Lokalis
Paamiormiumiimmanuna	Paamiut+MIU<ental<Lokalis+IP<Causativ<han+UNA
Paamiormiumeeqqaartunga	Paamiut+MIU<ental<Lokalis+IP-QQAAR<Participium<jeg
Paamiormiunik	Paamiut+MIU<flertal<Instrumentalis
Paamiormiunilli	Paamiut+MIU<flertal<Instrumentalis+LI
Paamiormiuni	Paamiut+MIU<flertal<Lokalis
Paamiormiuneeqquaajuna	Paamiut+MIU<flertal<Lokalis+IP-QQU<Indikativ<HanHam+UNA
Paamiormiuneeriarfilereqqaarlutik	Paamiut+MIU<flertal<Lokalis+IP-RIAR+FIK-LIRI-QQAAR<Ledsagemåde<de_selv
Paamiormiuneereerpugulli	Paamiut+MIU<flertal<Lokalis+IP-RIIR<Indikativ<vi+LI
Paamiormiunilu	Paamiut+MIU<flertal<Lokalis+LU
Paamiormiulererusullutik	Paamiut+MIU-LIRI+GUSUP<Ledsagemåde<de_selv
Paamiormiulerinernerpaarsioreertorlu	Paamiut+MIU-LIRI+NIR+NIRPAAQ+SIUR-RIIR<Participium<han+LU
Paamiormiulerereerpit	Paamiut+MIU-LIRI-RIIR<Interrogativ<du
Paamiormiulerereernerilli	Paamiut+MIU-LIRI-RIIR+NIQ<flertal<Absolut+LI
Paamiormiulerereertulinngoreerattali	Paamiut+MIU-LIRI-RIIR+TUQ-LIK-NNGUR-RIIR<Causativ<vi+LI
Paamiormiulerivallaarpit	Paamiut+MIU-LIRI+VALLAAR<Interrogativ<du
Paamiormiunngulaarferujussuali	Paamiut+MIU-NNGUR-LAAR+FIK-RUJUK=SUAQ<ental<hans<Absolut+LI
Paamiormiunngoqqulara	Paamiut+MIU-NNGUR-QQU<Optativ<JegHam
Paamiormiunngoqqularaluunniit	Paamiut+MIU-NNGUR-QQU<Optativ<JegHam+LUUNNIIT
Paamiormiunngoqaanga	Paamiut+MIU-NNGUR-QӘ<Indikativ<jeg
Paamiormioqarporli	Paamiut+MIU-QAR<Indikativ<han+LI
Paamiormioqarporlu	Paamiut+MIU-QAR<Indikativ<han+LU
Paamiormioqarporuna	Paamiut+MIU-QAR<Indikativ<han+UNA
Paamiormioqarpa	Paamiut+MIU-QAR<Interrogativ<han
Paamiormioqarneq	Paamiut+MIU-QAR+NIQ<ental<Absolut
Paamiormioqarnerli	Paamiut+MIU-QAR+NIQ<ental<Absolut+LI
Paamiormioqarnerluunniit	Paamiut+MIU-QAR+NIQ<ental<Absolut+LUUNNIIT
Paamiormioqartoq	Paamiut+MIU-QAR+TUQ<ental<Absolut
Paamiormioqartorlu	Paamiut+MIU-QAR+TUQ<ental<Absolut+LU
Paamiormioqartorluunniit	Paamiut+MIU-QAR+TUQ<ental<Absolut+LUUNNIIT
Paamiormiuuffissaagaluata	Paamiut+MIU-U+FIK-SSAQ=U=GALUAQ<ental<hans<Relativ
Paamiormiuuinnartoq	Paamiut+MIU-U-INNAR+TUQ<ental<Absolut
Paamiormiuulaartarfippassuaminik	Paamiut+MIU-U-LAAR=TAR+FIK+PASSUAQ<flertal<sin<Instrumentalis
Paamiormiuullutik	Paamiut+MIU-U<Ledsagemåde<de_selv
Paamiormiuulluaratta	Paamiut+MIU-U+LUAR<Causativ<vi
Paamiormiuunikuuffikkut	Paamiut+MIU-U+NIKUU+FIK<ental<Vialis
Paamiormiuunikuusoq	Paamiut+MIU-U+NIKUU+TUQ<ental<Absolut
Paamiormiuuneraana	Paamiut+MIU-U+NIQ<ental<hans<Absolut+UNA
Paamiormiooqquaalli	Paamiut+MIU-U-QQU<Indikativ<DeHam+LI
Paamiormiooqquaanuna	Paamiut+MIU-U-QQU<Indikativ<DeHam+UNA
Paamiormiooriaratta	Paamiut+MIU-U-RIAR<Causativ<vi
Paamiormiooriartooriarferujooqalutinguna	Paamiut+MIU-U-RIAR+TUQ-U-RIAR+FIK-RUJUK-U-QӘ<Ledsagemåde<de_selv+UNA
Paamiormiooreerpoq	Paamiut+MIU-U-RIIR<Indikativ<han
Paamiormiooreernerilluunniit	Paamiut+MIU-U-RIIR+NIQ<flertal<Relativ+LUUNNIIT
Paamiormiooreernerpaatulli	Paamiut+MIU-U-RIIR+NIRPAAQv<ental<Aequalis+LI
Paamiormiooreertukkui	Paamiut+MIU-U-RIIR+TUQ-KKUT<flertal<hans<Absolut
Paamiormiuussasungali	Paamiut+MIU-U-SSA<Participium<jeg+LI
Paamiormiuutikkakkuli	Paamiut+MIU-U+TIP<Causativ<JegHam+LI
Paamiormiuusussaasooqisuleqqaarmanga	Paamiut+MIU-U+TUQ=SSAQ=U+TUQ-U-QӘ+TUQ-LIR_nv-QQAAR<Causativ<HanMig
Paamiunut	Paamiut<Terminalis
Paamiunukaqqaartorli	Paamiut<Terminalis-KAR-QQAAR+TUQ<ental<Absolut+LI
Paamiunukariarniniuna	Paamiut<Terminalis-KAR-RIAR+NIQ<ental<sin<Absolut+UNA
Paamiunukassagaluarlutik	Paamiut<Terminalis-KAR-SSA=GALUAR<Ledsagemåde<de_selv
Paamiunukassagaluartoqanngilarli	Paamiut<Terminalis-KAR-SSA=GALUAR+TUQ-QAR-NNGIT<Indikativ<han+LI
Paamiunukavikkama	Paamiut<Terminalis-KAR-VIP<Causativ<jeg
Paamiunullu	Paamiut<Terminalis+LU
Paamiunulluunniit	Paamiut<Terminalis+LUUNNIIT
Paamiunununa	Paamiut<Terminalis+UNA
paariinnarmanga	paarә-INNAR<Causativ<HanMig
paarilluarpat	paarә+LUAR<Indikativ<DuHam
paarinerullugu	paarә+NIRU<Ledsagemåde<ham
paareqqaarpaajuna	paarә-QQAAR<Indikativ<HanHam+UNA
paarisimavassi	paarә+SIMA<Indikativ<JegJer
paarivipparpulli	paarә-VIP<Indikativ<ViHam+LI
paasitigilli	paasi<Imperativ<ViDem+LI
paasivatilli	paasi<Indikativ<DuDem+LI
paaseriarmanga	paasi-RIAR<Causativ<HanMig
paasereertiginuna	paasi-RIIR<Imperativ<ViDem+UNA
paasissagaluarakku	paasi-SSA=GALUAR<Causativ<JegHam
paasissavassilu	paasi-SSA<Indikativ<JegJer+LU
paninguna	panik<ental<Absolut+UNA
panittut	panik<ental<Aequalis
paniga	panik<ental<min<Absolut
panigiinngulaarpununa	panik+GIIT-NNGUR-LAAR<Indikativ<de+UNA
panigilaarluguli	panik+GӘ-LAAR<Ledsagemåde<ham+LI
panimmiooriarnerni	panik+MIU-U-RIAR+NIQ<flertal<Lokalis
panippassuakkali	panik+PASSUAQ<flertal<min<Absolut+LI
panippassuarnulluunniit	panik+PASSUAQ<flertal<Terminalis+LUUNNIIT
paneqalaarnini	panik-QAR-LAAR+NIQ<ental<sin<Absolut
paneqannginnera	panik-QAR-NNGIT+NIQ<ental<min<Absolut
paneqaqqaarpugununa	panik-QAR-QQAAR<Indikativ<vi+UNA
paneqariartunngunngitsungali	panik-QAR-RIAR+TUQ-NNGUR-NNGIT<Participium<jeg+LI
panerujugigaluartigillu	panik-RUJUK+GӘ+GALUAR<Imperativ<ViDem+LU
panerujulilaarpagullu	panik-RUJUK-LIR_nv-LAAR<Indikativ<ViDem+LU
panerujunngoqqaarpit	panik-RUJUK-NNGUR-QQAAR<Interrogativ<du
panissioreerfissaasinnaasulluunniit	panik+SIUR-RIIR+FIK-SSAQ-U+SINNAA<Participium<de+LUUNNIIT
panissaagaluilu	panik-SSAQ=U=GALUAQ<flertal<hans<Absolut+LU
pavani	pavani<Partikel
pavanili	pavani<Partikel+LI
pavaniluunniit	pavani<Partikel+LUUNNIIT
pavaniuna	pavani<Partikel+UNA
pigakku	pi<Causativ<JegHam
pigaluarlunga	pi+GALUAR<Ledsagemåde<mig
piartormanga	pi+GIARTUR<Causativ<HanMig
piartorpakkali	pi+GIARTUR<Indikativ<JegDem+LI
piunnaarpaallu	pi+GUNNAAR<Indikativ<DeHam+LU
perusummangali	pi+GUSUP<Causativ<HanMig+LI
perusummangalu	pi+GUSUP<Causativ<HanMig+LU
perusukkakku	pi+GUSUP<Causativ<JegHam
perusutsigilluunniit	pi+GUSUP<Imperativ<ViDem+LUUNNIIT
perusuppaannga	pi+GUSUP<Indikativ<DeMig
perusullara	pi+GUSUP<Optativ<JegHam
perusullarali	pi+GUSUP<Optativ<JegHam+LI
pivaalli	pi<Indikativ<DeHam+LI
pivaanngali	pi<Indikativ<DeMig+LI
pivaanngalu	pi<Indikativ<DeMig+LU
piinnarpaat	pi-INNAR<Indikativ<DeHam
piinnarpaa	pi-INNAR<Indikativ<HanHam
piinnarlarali	pi-INNAR<Optativ<JegHam+LI
pilaarlarali	pi-LAAR<Optativ<JegHam+LI
pilersaarullu	pilersaarut<ental<Absolut+LU
pilerlara	pi-LIR<Optativ<JegHam
pilerlarali	pi-LIR<Optativ<JegHam+LI
pilluinnartigit	pi+LUINNAR<Imperativ<ViDem
pingaariartortorli	pingaar+GIARTUR<Participium<han+LI
pingaarnerpaaqareeratta	pingaar+NIRPAAQ-QAR-RIIR<Causativ<vi
pingasuinnarsioqqaarnini	pingasut-INNAQ+SIUR-QQAAR+NIQ<ental<sin<Absolut
piniartigilli	pi+NIAR<Imperativ<ViDem+LI
pinianngiliuk	pi+NIAR=NNGIT<Interrogativ<DuHam
pinikuutigillu	pi+NIKUU<Imperativ<ViDem+LU
pinikuuaalluunniit	pi+NIKUU<Indikativ<DeHam+LUUNNIIT
pinikuullungalu	pi+NIKUU<Ledsagemåde<mig+LU
pinnginnakku	pi-NNGIT<Causativ<JegHam
pinnginnakkuuna	pi-NNGIT<Causativ<JegHam+UNA
pinngilai	pi-NNGIT<Indikativ<HanDem
pinagu	pi-NNGIT<Ledsagemåde<ham
peqqaarakku	pi-QQAAR<Causativ<JegHam
peqqaartigilli	pi-QQAAR<Imperativ<ViDem+LI
peqqaartiginuna	pi-QQAAR<Imperativ<ViDem+UNA
peqqaarpatit	pi-QQAAR<Indikativ<DuDem
peqqaarparpulli	pi-QQAAR<Indikativ<ViHam+LI
peqqaarluginuna	pi-QQAAR<Ledsagemåde<dem+UNA
peqqaarlara	pi-QQAAR<Optativ<JegHam
peqqugakkuli	pi-QQU<Causativ<JegHam+LI
peqqutigillu	pi-QQU<Imperativ<ViDem+LU
peqqutigilluunniit	pi-QQU<Imperativ<ViDem+LUUNNIIT
peqquaa	pi-QQU<Indikativ<HanHam
peqqullugilli	pi-QQU<Ledsagemåde<dem+LI
peqqullunga	pi-QQU<Ledsagemåde<mig
peqimmanga	pi-QӘ<Causativ<HanMig
peqimmangalu	pi-QӘ<Causativ<HanMig+LU
peqigakkuuna	pi-QӘ<Causativ<JegHam+UNA
peqitigilli	pi-QӘ<Imperativ<ViDem+LI
peqaat	pi-QӘ<Indikativ<DeHam
peqaannga	pi-QӘ<Indikativ<DeMig
peqaalu	pi-QӘ<Indikativ<HanDem+LU
peqaarput	pi-QӘ<Indikativ<ViHam
peqalugu	pi-QӘ<Ledsagemåde<ham
peqilara	pi-QӘ<Optativ<JegHam
peqilarali	pi-QӘ<Optativ<JegHam+LI
periarmangaana	pi-RIAR<Causativ<HanMig+UNA
periarakku	pi-RIAR<Causativ<JegHam
periarakkuluunniit	pi-RIAR<Causativ<JegHam+LUUNNIIT
periartigit	pi-RIAR<Imperativ<ViDem
periartigilluunniit	pi-RIAR<Imperativ<ViDem+LUUNNIIT
periarlugu	pi-RIAR<Ledsagemåde<ham
periarlaralu	pi-RIAR<Optativ<JegHam+LU
periarlaraana	pi-RIAR<Optativ<JegHam+UNA
pereermangalu	pi-RIIR<Causativ<HanMig+LU
pereertigilluunniit	pi-RIIR<Imperativ<ViDem+LUUNNIIT
pereerpakka	pi-RIIR<Indikativ<JegDem
pereerpiuk	pi-RIIR<Interrogativ<DuHam
pereerlugillu	pi-RIIR<Ledsagemåde<dem+LU
pereerlungali	pi-RIIR<Ledsagemåde<mig+LI
pereerlara	pi-RIIR<Optativ<JegHam
pisimallugulu	pi+SIMA<Ledsagemåde<ham+LU
pisimasulereqqaarferujooreernerpaataluunniit	pisimasoq-LIRI-QQAAR+FIK-RUJUK-U-RIIR+NIRPAAQvv<ental<hans<Relativ+LUUNNIIT
pissagakkulu	pi-SSA<Causativ<JegHam+LU
pisartigilli	pi+TAR<Imperativ<ViDem+LI
Pituffik	Pituffik<ental<Absolut
Pituffilli	Pituffik<ental<Absolut+LI
Pituffillu	Pituffik<ental<Absolut+LU
Pituffilluunniit	Pituffik<ental<Absolut+LUUNNIIT
Pituffinguna	Pituffik<ental<Absolut+UNA
Pituffimmik	Pituffik<Instrumentalis
Pituffimmilli	Pituffik<Instrumentalis+LI
Pituffimmilluunniit	Pituffik<Instrumentalis+LUUNNIIT
Pituffimminguna	Pituffik<Instrumentalis+UNA
Pituffimmeeqqulluginuna	Pituffik<Lokalis+IP-QQU<Ledsagemåde<dem+UNA
Pituffimmeeriartunnguata	Pituffik<Lokalis+IP-RIAR+TUQ-NNGUAQ<ental<hans<Relativ
Pituffimmeereerpunga	Pituffik<Lokalis+IP-RIIR<Indikativ<jeg
Pituffimmeereerlutilli	Pituffik<Lokalis+IP-RIIR<Ledsagemåde<de_selv+LI
Pituffimmeereerlutilluunniit	Pituffik<Lokalis+IP-RIIR<Ledsagemåde<de_selv+LUUNNIIT
Pituffimmiippallaanngilagulli	Pituffik<Lokalis+IP+VALLAAR=NNGIT<Indikativ<vi+LI
Pituffimmili	Pituffik<Lokalis+LI
Pituffimmiluunniit	Pituffik<Lokalis+LUUNNIIT
Pituffimmiulererusummat	Pituffik+MIU-LIRI+GUSUP<Causativ<han
Pituffimmiulerivugulluunniit	Pituffik+MIU-LIRI<Indikativ<vi+LUUNNIIT
Pituffimmiulerereernerni	Pituffik+MIU-LIRI-RIIR+NIQ<flertal<Lokalis
Pituffimmioqartorluunniit	Pituffik+MIU-QAR+TUQ<ental<Absolut+LUUNNIIT
Pituffimmiooqquaannga	Pituffik+MIU-U-QQU<Indikativ<DeMig
Pituffimmiooriarmanuna	Pituffik+MIU-U-RIAR<Causativ<han+UNA
Pituffimmiooreertukka	Pituffik+MIU-U-RIIR+TUQ<flertal<min<Absolut
Pituffimmut	Pituffik<Terminalis
Pituffimmukalaartoruna	Pituffik<Terminalis-KAR-LAAR<Participium<han+UNA
Pituffimmukareerlutinguna	Pituffik<Terminalis-KAR-RIIR<Ledsagemåde<de_selv+UNA
Pituffimmullu	Pituffik<Terminalis+LU
Pituffimmununa	Pituffik<Terminalis+UNA
Pituffikkut	Pituffik<Vialis
Pituffikkulli	Pituffik<Vialis+LI
Pituffikkullu	Pituffik<Vialis+LU
Pituffikkulluunniit	Pituffik<Vialis+LUUNNIIT
Pituffikkununa	Pituffik<Vialis+UNA
pisorujorujussuutigillu	pi+TUQ=RUJUK=RUJUK=SUAQ=U<Imperativ<ViDem+LU
pisorujorujussuulluguli	pi+TUQ=RUJUK=RUJUK=SUAQ=U<Ledsagemåde<ham+LI
pisorujorujussuularaana	pi+TUQ=RUJUK=RUJUK=SUAQ=U<Optativ<JegHam+UNA
pisorujussuulluguuna	pi+TUQ=RUJUK=SUAQ=U<Ledsagemåde<ham+UNA
pisorujussuularalu	pi+TUQ=RUJUK=SUAQ=U<Optativ<JegHam+LU
pivallaannginnakku	pi+VALLAAR=NNGIT<Causativ<JegHam
poortugaq	poortugaq<ental<Absolut
poortugarli	poortugaq<ental<Absolut+LI
poortukkamik	poortugaq<ental<Instrumentalis
poortukkameeriarfilereerlugilli	poortugaq<ental<Instrumentalis-IR-RIAR+FIK-LIR_nv-RIIR<Ledsagemåde<dem+LI
poortukkameereeramali	poortugaq<ental<Instrumentalis-IR-RIIR<Causativ<jeg+LI
poortukkamiissagatta	poortugaq<ental<Instrumentalis-IR-SSA<Causativ<vi
poortukkami	poortugaq<ental<Lokalis
poortukkameeqqugakku	poortugaq<ental<Lokalis+IP-QQU<Causativ<JegHam
poortukkama	poortugaq<ental<min<Relativ
poortukkamulli	poortugaq<ental<Terminalis+LI
poortukkakkullu	poortugaq<ental<Vialis+LU
poortukkakkulluunniit	poortugaq<ental<Vialis+LUUNNIIT
poortukkakkununa	poortugaq<ental<Vialis+UNA
poortugaallu	poortugaq<flertal<deres<Absolut+LU
poortugaa	poortugaq<flertal<hans<Absolut
poortukkaneeqqaarpa	poortugaq<flertal<Instrumentalis-IR-QQAAR<Interrogativ<han
poortukkaneereerlutinguna	poortugaq<flertal<Instrumentalis-IR-RIIR<Ledsagemåde<de_selv+UNA
poortukkaneereertoqanngilaq	poortugaq<flertal<Instrumentalis-IR-RIIR+TUQ-QAR-NNGIT<Indikativ<han
poortukkani	poortugaq<flertal<Lokalis
poortukkaneereerpulluunniit	poortugaq<flertal<Lokalis+IP-RIIR<Indikativ<de+LUUNNIIT
poortukkanili	poortugaq<flertal<Lokalis+LI
poortukkakkaluunniit	poortugaq<flertal<min<Absolut+LUUNNIIT
poortukkanni	poortugaq<flertal<min<Lokalis
poortukkannili	poortugaq<flertal<min<Lokalis+LI
poortukkama	poortugaq<flertal<min<Relativ
poortukkaminillu	poortugaq<flertal<sin<Instrumentalis+LU
poortukkanut	poortugaq<flertal<Terminalis
poortukkanukaannarlutilli	poortugaq<flertal<Terminalis-KAR-INNAR<Ledsagemåde<de_selv+LI
poortukkanukalaartarneq	poortugaq<flertal<Terminalis-KAR-LAAR=TAR+NIQ<ental<Absolut
poortukkanulluunniit	poortugaq<flertal<Terminalis+LUUNNIIT
poortugarisaraluarlunga	poortugaq+GӘ+TAR=GALUAR<Ledsagemåde<mig
poortugaannarmaana	poortugaq-INNAQ<ental<min<Relativ+UNA
poortugakulerilerama	poortugaq-KU-LIRI-LIR<Causativ<jeg
poortugalii	poortugaq-LIK<flertal<hans<Absolut
poortugallilli	poortugaq-LIK<flertal<Relativ+LI
poortugaleriunnaarfeqassagaluartuma	poortugaq-LIRI+GUNNAAR+FIK-QAR-SSA=GALUAR+TUQ<flertal<min<Relativ
poortugarmiumik	poortugaq+MIU<ental<Instrumentalis
poortugarmioorusunnerpaakkununa	poortugaq+MIU-U+GUSUP+NIRPAAQv<ental<Vialis+UNA
poortugarpassui	poortugaq+PASSUAQ<flertal<hans<Absolut
poortugarujussuata	poortugaq-RUJUK=SUAQ<ental<deres<Relativ
poortugarsiunnginnatta	poortugaq+SIUR-NNGIT<Causativ<vi
poortugarsioqqaartut	poortugaq+SIUR-QQAAR<Participium<de
poortugartaalaarama	poortugaq+TAAR-LAAR<Causativ<jeg
poortugartaalerferujooqigamali	poortugaq+TAAR-LIR+FIK-RUJUK-U-QӘ<Causativ<jeg+LI
poortugaafferujoqalaartarattali	poortugaq-U+FIK-RUJUK-QAR-LAAR=TAR<Causativ<vi+LI
poortugaavallaarmatali	poortugaq-U+VALLAAR<Causativ<de+LI
poortugaavallaanngilagulli	poortugaq-U+VALLAAR=NNGIT<Indikativ<vi+LI
qaammalli	qaammat<ental<Absolut+LI
qaammanuna	qaammat<ental<Absolut+UNA
qaammammi	qaammat<ental<Lokalis
qaammammeereerlutilli	qaammat<ental<Lokalis+IP-RIIR<Ledsagemåde<de_selv+LI
qaammatilererusuppullu	qaammat-LIRI+GUSUP<Indikativ<de+LU
qaammatimiuneeqqaarlutinguna	qaammat+MIU<flertal<Lokalis+IP-QQAAR<Ledsagemåde<de_selv+UNA
qaangiuppit	qaangiup<Interrogativ<du
qaangiunnerinuna	qaangiup+NIQ<flertal<Relativ+UNA
qaangiussinnaanerpaaq	qaangiup+SINNAA+NIRPAAQ<ental<Absolut
qaangiuttaraluarpisi	qaangiup+TAR=GALUAR<Interrogativ<I
qaangiuttoriilerilaartarpisi	qaangiup+TUQ+GIIT-LIRI-LAAR=TAR<Interrogativ<I
qaangiuppallaarlutillu	qaangiup+VALLAAR<Ledsagemåde<de_selv+LU
qaartartorpassuili	qaartartoq+PASSUAQ<flertal<deres<Absolut+LI
qaartartorpassuanni	qaartartoq+PASSUAQ<flertal<min<Lokalis
qallunaarli	qallunaaq<ental<Absolut+LI
qallunaanilluunniit	qallunaaq<flertal<Instrumentalis+LUUNNIIT
qallunaani	qallunaaq<flertal<Lokalis
qallunaanngunngimmallu	qallunaaq-NNGUR-NNGIT<Causativ<han+LU
qallunaanngoqqaarpoq	qallunaaq-NNGUR-QQAAR<Indikativ<han
qallunaaqaannarpa	qallunaaq-QAR-INNAR<Interrogativ<han
qallunaaqalaartarneq	qallunaaq-QAR-LAAR=TAR+NIQ<ental<Absolut
qallunaarsiuinnartoq	qallunaaq+SIUR-INNAR<Participium<han
qallunaarsioqqaarnerlu	qallunaaq+SIUR-QQAAR+NIQ<ental<Absolut+LU
qallunaarsioqqularalu	qallunaaq+SIUR-QQU<Optativ<JegHam+LU
qallunaarsiortussaasorluunniit	qallunaaq+SIUR+TUQ=SSAQ=U+TUQ<ental<Absolut+LUUNNIIT
qallunaartaannarpa	qallunaaq+TAAR-INNAR<Interrogativ<han
qallunaartaareerneq	qallunaaq+TAAR-RIIR+NIQ<ental<Absolut
qangali	qangali<Partikel
qangalili	qangali<Partikel+LI
qangaliuna	qangali<Partikel+UNA
qangali	qanga<Partikel+LI
Qaqortoq	Qaqortoq<ental<Absolut
Qaqortorli	Qaqortoq<ental<Absolut+LI
Qaqortorlu	Qaqortoq<ental<Absolut+LU
Qaqortorluunniit	Qaqortoq<ental<Absolut+LUUNNIIT
Qaqortoruna	Qaqortoq<ental<Absolut+UNA
Qaqortumilli	Qaqortoq<Instrumentalis+LI
Qaqortumillu	Qaqortoq<Instrumentalis+LU
Qaqortuminguna	Qaqortoq<Instrumentalis+UNA
Qaqortumi	Qaqortoq<Lokalis
Qaqortumiikkaluarlutik	Qaqortoq<Lokalis+IP+GALUAR<Ledsagemåde<de_selv
Qaqortumeeqqaartoruna	Qaqortoq<Lokalis+IP-QQAAR+TUQ<ental<Absolut+UNA
Qaqortumeeqqularaana	Qaqortoq<Lokalis+IP-QQU<Optativ<JegHam+UNA
Qaqortumeeriarlutilli	Qaqortoq<Lokalis+IP-RIAR<Ledsagemåde<de_selv+LI
Qaqortumeeriarnini	Qaqortoq<Lokalis+IP-RIAR+NIQ<ental<sin<Absolut
Qaqortumiippallaarpungali	Qaqortoq<Lokalis+IP+VALLAAR<Indikativ<jeg+LI
Qaqortumilu	Qaqortoq<Lokalis+LU
Qaqortormiunik	Qaqortoq+MIU<flertal<Instrumentalis
Qaqortormiuninguna	Qaqortoq+MIU<flertal<Instrumentalis+UNA
Qaqortormiuneeqquarpullu	Qaqortoq+MIU<flertal<Lokalis+IP-QQU<Indikativ<ViHam+LU
Qaqortormiunngoriartooqquassili	Qaqortoq+MIU-NNGUR-RIAR+TUQ-U-QQU<Indikativ<JegJer+LI
Qaqortormiunnguippit	Qaqortoq+MIU-NNGUR-VIP<Interrogativ<du
Qaqortormioqarpa	Qaqortoq+MIU-QAR<Interrogativ<han
Qaqortormioorusummalli	Qaqortoq+MIU-U+GUSUP<Causativ<han+LI
Qaqortormiooqqaarnerpaartaanngiffinngooreerferujussuilu	Qaqortoq+MIU-U-QQAAR+NIRPAAQ+TAAR-NNGIT+FIK-NNGUAQ-U-RIIR+FIK-RUJUK=SUAQ<flertal<deres<Absolut+LU
Qaqortormiooqqugakku	Qaqortoq+MIU-U-QQU<Causativ<JegHam
Qaqortormiooriarfinnulluunniit	Qaqortoq+MIU-U-RIAR+FIK<flertal<Terminalis+LUUNNIIT
Qaqortumukannginnatta	Qaqortoq<Terminalis-KAR-NNGIT<Causativ<vi
Qaqortumukanngilarlu	Qaqortoq<Terminalis-KAR-NNGIT<Indikativ<han+LU
Qaqortumukaqqaartoqarpoq	Qaqortoq<Terminalis-KAR-QQAAR+TUQ-QAR<Indikativ<han
Qaqortumukaqqummanga	Qaqortoq<Terminalis-KAR-QQU<Causativ<HanMig
Qaqortumukassasununa	Qaqortoq<Terminalis-KAR-SSA<Participium<de+UNA
Qaqortumullu	Qaqortoq<Terminalis+LU
Qaqortumununa	Qaqortoq<Terminalis+UNA
Qaqortukkut	Qaqortoq<Vialis
Qaqortukkullu	Qaqortoq<Vialis+LU
Qaqortukkununa	Qaqortoq<Vialis+UNA
qarasaasiaq	qarasaasiaq<ental<Absolut
qarasaasiara	qarasaasiaq<ental<min<Absolut
qarasaasiaa	qarasaasiaq<flertal<hans<Absolut
qarasaasiakkaluunniit	qarasaasiaq<flertal<min<Absolut+LUUNNIIT
qarasaasiaannaqalerpulli	qarasaasiaq-INNAQ-QAR-LIR<Indikativ<de+LI
qarasaasiallilli	qarasaasiaq-LIK<flertal<Absolut+LI
qarasaasialersimatiginuna	qarasaasiaq-LIR_nv+SIMA<Imperativ<ViDem+UNA
qarasaasiannguinnartukkuiluunniit	qarasaasiaq-NNGUR-INNAR+TUQ-KKUT<flertal<hans<Absolut+LUUNNIIT
qarasaasianngussagaluarpungali	qarasaasiaq-NNGUR-SSA=GALUAR<Indikativ<jeg+LI
qarasaasiarujummeeqqaarpununa	qarasaasiaq-RUJUK<ental<Lokalis+IP-QQAAR<Indikativ<de+UNA
qarasaasiarsioriarlutillu	qarasaasiaq+SIUR-RIAR<Ledsagemåde<de_selv+LU
qarasaasiassaagaluata	qarasaasiaq-SSAQ=U=GALUAQ<ental<deres<Relativ
Qasigiannguit	Qasigiannguit<Absolut
Qasigiannguilli	Qasigiannguit<Absolut+LI
Qasigiannguillu	Qasigiannguit<Absolut+LU
Qasigiannguilluunniit	Qasigiannguit<Absolut+LUUNNIIT
Qasigiannguinuna	Qasigiannguit<Absolut+UNA
Qasigiannguanik	Qasigiannguit<Instrumentalis
Qasigiannguanilli	Qasigiannguit<Instrumentalis+LI
Qasigiannguanillu	Qasigiannguit<Instrumentalis+LU
Qasigiannguani	Qasigiannguit<Lokalis
Qasigiannguaniinngitsorli	Qasigiannguit<Lokalis+IP-NNGIT<Participium<han+LI
Qasigiannguaneeqqaarattali	Qasigiannguit<Lokalis+IP-QQAAR<Causativ<vi+LI
Qasigiannguaneeriarmanuna	Qasigiannguit<Lokalis+IP-RIAR<Causativ<han+UNA
Qasigiannguaneereertoruna	Qasigiannguit<Lokalis+IP-RIIR+TUQ<ental<Absolut+UNA
Qasigiannguaniluunniit	Qasigiannguit<Lokalis+LUUNNIIT
Qasigiannguarmiuleriartormatali	Qasigiannguit+MIU-LIRI+GIARTUR<Causativ<de+LI
Qasigiannguarmiuuniarpa	Qasigiannguit+MIU-U+NIAR<Interrogativ<han
Qasigiannguarmiooqalutinguna	Qasigiannguit+MIU-U-QӘ<Ledsagemåde<de_selv+UNA
Qasigiannguarmiooreerpisi	Qasigiannguit+MIU-U-RIIR<Interrogativ<I
Qasigiannguarmiuuippit	Qasigiannguit+MIU-U-VIP<Interrogativ<du
Qasigiannguanut	Qasigiannguit<Terminalis
Qasigiannguanukareerlutinguna	Qasigiannguit<Terminalis-KAR-RIIR<Ledsagemåde<de_selv+UNA
Qasigiannguanukavittorlu	Qasigiannguit<Terminalis-KAR-VIP<Participium<han+LU
Qasigiannguanullu	Qasigiannguit<Terminalis+LU
Qasigiannguanununa	Qasigiannguit<Terminalis+UNA
qatanngummut	qatanngut<ental<Terminalis
qatanngummulli	qatanngut<ental<Terminalis+LI
qatanngummullu	qatanngut<ental<Terminalis+LU
qatanngutiliallu	qatanngut-LIK<ental<deres+LU
qatanngutisioriartuinnaq	qatanngut+SIUR-RIAR+TUQ-INNAQ<ental<Absolut
qatanngutitaannarput	qatanngut+TAAR-INNAR<Indikativ<de
Qeqertarsuaq	Qeqertarsuaq<ental<Absolut
Qeqertarsuarli	Qeqertarsuaq<ental<Absolut+LI
Qeqertarsuarluunniit	Qeqertarsuaq<ental<Absolut+LUUNNIIT
Qeqertarsuarmik	Qeqertarsuaq<Instrumentalis
Qeqertarsuarmilli	Qeqertarsuaq<Instrumentalis+LI
Qeqertarsuarmilluunniit	Qeqertarsuaq<Instrumentalis+LUUNNIIT
Qeqertarsuarminguna	Qeqertarsuaq<Instrumentalis+UNA
Qeqertarsuarmi	Qeqertarsuaq<Lokalis
Qeqertarsuarmiinnikuummat	Qeqertarsuaq<Lokalis+IP+NIKUU<Causativ<han
Qeqertarsuarmiinnginnerluunniit	Qeqertarsuaq<Lokalis+IP-NNGIT+NIQ<ental<Absolut+LUUNNIIT
Qeqertarsuarmeeqqaarneq	Qeqertarsuaq<Lokalis+IP-QQAAR+NIQ<ental<Absolut
Qeqertarsuarmeeqqaartoq	Qeqertarsuaq<Lokalis+IP-QQAAR+TUQ<ental<Absolut
Qeqertarsuarmeeqqutigilli	Qeqertarsuaq<Lokalis+IP-QQU<Imperativ<ViDem+LI
Qeqertarsuarmeeriarattalu	Qeqertarsuaq<Lokalis+IP-RIAR<Causativ<vi+LU
Qeqertarsuarmiuna	Qeqertarsuaq<Lokalis+UNA
Qeqertarsuarmiunilli	Qeqertarsuaq+MIU<flertal<Instrumentalis+LI
Qeqertarsuarmioqarporlu	Qeqertarsuaq+MIU-QAR<Indikativ<han+LU
Qeqertarsuarmioqarneq	Qeqertarsuaq+MIU-QAR+NIQ<ental<Absolut
Qeqertarsuarmioqartorlu	Qeqertarsuaq+MIU-QAR+TUQ<ental<Absolut+LU
Qeqertarsuarmioorusummat	Qeqertarsuaq+MIU-U+GUSUP<Causativ<han
Qeqertarsuarmioorusuppit	Qeqertarsuaq+MIU-U+GUSUP<Interrogativ<du
Qeqertarsuarmukalaartoq	Qeqertarsuaq<Terminalis-KAR-LAAR+TUQ<ental<Absolut
Qeqertarsuarmukareertulluunniit	Qeqertarsuaq<Terminalis-KAR-RIIR<Participium<de+LUUNNIIT
Qeqertarsuarmukassallutik	Qeqertarsuaq<Terminalis-KAR-SSA<Ledsagemåde<de_selv
Qeqertarsuarmulli	Qeqertarsuaq<Terminalis+LI
Qeqertarsuakkut	Qeqertarsuaq<Vialis
Qeqertarsuakkulli	Qeqertarsuaq<Vialis+LI
Qeqertarsuakkullu	Qeqertarsuaq<Vialis+LU
Qeqertarsuakkulluunniit	Qeqertarsuaq<Vialis+LUUNNIIT
Qeqertarsuakkununa	Qeqertarsuaq<Vialis+UNA
qimakkaluartigillu	qimap+GALUAR<Imperativ<ViDem+LU
qimakkunnaarlunga	qimap+GUNNAAR<Ledsagemåde<mig
qimappaangali	qimap<Indikativ<HanMig+LI
qimanniarnagilli	qimap+NIAR=NNGIT<Ledsagemåde<dem+LI
qimannikuulara	qimap+NIKUU<Optativ<JegHam
qimannerutigilluunniit	qimap+NIRU<Imperativ<ViDem+LUUNNIIT
qimannagu	qimap-NNGIT<Ledsagemåde<ham
qimassimavaallu	qimap+SIMA<Indikativ<DeHam+LU
qimassimalara	qimap+SIMA<Optativ<JegHam
qimassimasartigilli	qimap+SIMA=TAR<Imperativ<ViDem+LI
qimattorujorujussuummanga	qimap+TUQ=RUJUK=RUJUK=SUAQ=U<Causativ<HanMig
qimarnguittulluunniit	qimarnguik<ental<Aequalis+LUUNNIIT
qimarnguittununa	qimarnguik<ental<Aequalis+UNA
qimarngueqalerfeqaqqaarnerpaaminguna	qimarnguik-QAR-LIR+FIK-QAR-QQAAR+NIRPAAQ<ental<Instrumentalis+UNA
qimarnguissalilaartarpassi	qimarnguik-SSAQ-LIR_nv-LAAR=TAR<Indikativ<JegJer
qinnullu	qinnut<ental<Absolut+LU
qinnununa	qinnut<ental<Absolut+UNA
qinnummik	qinnut<ental<Instrumentalis
qinnummeeqqaarnerli	qinnut<ental<Instrumentalis-IR-QQAAR+NIQ<ental<Absolut+LI
qinnummeeqqaartoqarporluunniit	qinnut<ental<Instrumentalis-IR-QQAAR+TUQ-QAR<Indikativ<han+LUUNNIIT
qinnummillu	qinnut<ental<Instrumentalis+LU
qinnummi	qinnut<ental<Lokalis
qinnummut	qinnut<ental<Terminalis
qinnummukaqquiuk	qinnut<ental<Terminalis-KAR-QQU<Interrogativ<DuHam
qinnummukareerlutik	qinnut<ental<Terminalis-KAR-RIIR<Ledsagemåde<de_selv
qinnummununa	qinnut<ental<Terminalis+UNA
qinnutaalu	qinnut<flertal<hans<Absolut+LU
qinnutigivillara	qinnut+GӘ-VIP<Optativ<JegHam
qiteq	qiteq<ental<Absolut
qeqqani	qiteq<ental<hans<Lokalis
qeqqanili	qiteq<ental<hans<Lokalis+LI
qeqqaniuna	qiteq<ental<hans<Lokalis+UNA
qiternukalaartartoq	qiteq<flertal<Terminalis-KAR-LAAR=TAR<Participium<han
qiteriilererusullutilluunniit	qiteq+GIIT-LIRI+GUSUP<Ledsagemåde<de_selv+LUUNNIIT
qiteriinngulaartarpisi	qiteq+GIIT-NNGUR-LAAR=TAR<Interrogativ<I
qitilissagaluarlungaana	qiteq-LIR_nv-SSA=GALUAR<Ledsagemåde<mig+UNA
qitinngooriarneraana	qiteq-NNGUAQ-U-RIAR+NIQ<ental<hans<Absolut+UNA
qitinngoqqaaratta	qiteq-NNGUR-QQAAR<Causativ<vi
qitinngussavit	qiteq-NNGUR-SSA<Interrogativ<du
qiteqassagaluarmatali	qiteq-QAR-SSA=GALUAR<Causativ<de+LI
qiterujussua	qiteq-RUJUK=SUAQ<ental<hans<Absolut
qitersioqqaarfeqarfikoqaqisullu	qiteq+SIUR-QQAAR+FIK-QAR+FIK-KU-QAR-QӘ<Participium<de+LU
qitissarsiussagaluarama	qiteq-SSAQ+SIUR-SSA=GALUAR<Causativ<jeg
qitissaagaluattullu	qiteq-SSAQ=U=GALUAQ<ental<deres<Aequalis+LU
qitissaagaluiuna	qiteq-SSAQ=U=GALUAQ<flertal<deres<Absolut+UNA
qularnarunnaarmat	qularnar+GUNNAAR<Causativ<han
qularnarunnaarpisi	qularnar+GUNNAAR<Interrogativ<I
qularnarusuffikkuili	qularnar+GUSUP+FIK-KKUT<flertal<hans<Absolut+LI
qularnalaaramalu	qularnar-LAAR<Causativ<jeg+LU
qularnarniarlutillu	qularnar+NIAR<Ledsagemåde<de_selv+LU
qularnarniarnatillu	qularnar+NIAR=NNGIT<Ledsagemåde<de_selv+LU
qularnaqqaarama	qularnar-QQAAR<Causativ<jeg
qularnaqqutiginuna	qularnar-QQU<Imperativ<ViDem+UNA
qularnaqisorujummeeriarfissioqqaarpugulli	qularnar-QӘ+TUQ-RUJUK<ental<Lokalis+IP-RIAR+FIK+SIUR-QQAAR<Indikativ<vi+LI
qularnartuliinnarlara	qularnar+TUQ-LIR_nv-INNAR<Optativ<JegHam
qulaa	qulә<ental<hans<Absolut
qulinili	qulә<ental<sin<Absolut+LI
qummut	qulә<ental<Terminalis
qulaanulli	qulә<ental<Terminalis<hans+LI
qummukaannarneq	qulә<ental<Terminalis-KAR-INNAR+NIQ<ental<Absolut
qummukalaartoqarporluunniit	qulә<ental<Terminalis-KAR-LAAR+TUQ-QAR<Indikativ<han+LUUNNIIT
qummukannginnerlu	qulә<ental<Terminalis-KAR-NNGIT+NIQ<ental<Absolut+LU
qummukariarfikulereqquaanngalu	qulә<ental<Terminalis-KAR-RIAR+FIK-KU-LIRI-QQU<Indikativ<DeMig+LU
qummukariarnerit	qulә<ental<Terminalis-KAR-RIAR+NIQ<flertal<Relativ
qummukariarnerilli	qulә<ental<Terminalis-KAR-RIAR+NIQ<flertal<Relativ+LI
qummukareerpisi	qulә<ental<Terminalis-KAR-RIIR<Interrogativ<I
qummukassagaluarpunga	qulә<ental<Terminalis-KAR-SSA=GALUAR<Indikativ<jeg
qummukarpallaarpunga	qulә<ental<Terminalis-KAR+VALLAAR<Indikativ<jeg
qummukavikkamaluunniit	qulә<ental<Terminalis-KAR-VIP<Causativ<jeg+LUUNNIIT
qummukavillutik	qulә<ental<Terminalis-KAR-VIP<Ledsagemåde<de_selv
qummulli	qulә<ental<Terminalis+LI
qummullu	qulә<ental<Terminalis+LU
qummulluunniit	qulә<ental<Terminalis+LUUNNIIT
qummununa	qulә<ental<Terminalis+UNA
qulaannaleriniarnerata	qulә-INNAQ-LIRI+NIAR+NIQ<ental<deres<Relativ
qulaannanngulerpit	qulә-INNAQ-NNGUR-LIR<Interrogativ<du
qulilililerlungaluunniit	qulә-LIK-LIR_nv-LIR<Ledsagemåde<mig+LUUNNIIT
qulissaavallaarattaana	qulә-SSAQ-U+VALLAAR<Causativ<vi+UNA
sakkutooq	sakkutooq<ental<Absolut
sakkutuumeereerlutillu	sakkutooq<ental<Instrumentalis-IR-RIIR<Ledsagemåde<de_selv+LU
sakkutoorivallaanngiliuk	sakkutooq+GӘ+VALLAAR=NNGIT<Interrogativ<DuHam
sakkutuukkunneeqqaartorli	sakkutooq-KKUT<flertal<Lokalis+IP-QQAAR<Participium<han+LI
sakkutuunngoreerpit	sakkutooq-NNGUR-RIIR<Interrogativ<du
sakkutooqalaartarlutinguna	sakkutooq-QAR-LAAR=TAR<Ledsagemåde<de_selv+UNA
sammisarerusummangaluunniit	sammisarә+GUSUP<Causativ<HanMig+LUUNNIIT
sammisarivaanga	sammisarә<Indikativ<HanMig
sammisareqqaarlara	sammisarә-QQAAR<Optativ<JegHam
sanarusukkakkuli	sana+GUSUP<Causativ<JegHam+LI
sanalluarlunga	sana+LUAR<Ledsagemåde<mig
sananeqartut	sana+NIQAR<Participium<de
sananeqartullilluunniit	sana+NIQAR+TUQ-LIK<flertal<Relativ+LUUNNIIT
sanariarlugit	sana-RIAR<Ledsagemåde<dem
sanasimasarmangali	sana+SIMA=TAR<Causativ<HanMig+LI
sanasinnaatigit	sana+SINNAA<Imperativ<ViDem
sanavallaarluguluunniit	sana+VALLAAR<Ledsagemåde<ham+LUUNNIIT
sapinngisamik	sapinngisamik<Partikel
sapinngisamilli	sapinngisamik<Partikel+LI
sapinngisamillu	sapinngisamik<Partikel+LU
sapinngisamilluunniit	sapinngisamik<Partikel+LUUNNIIT
sapinngisaminguna	sapinngisamik<Partikel+UNA
sermersuaq	sermersuaq<ental<Absolut
sermersuarli	sermersuaq<ental<Absolut+LI
sermersuattut	sermersuaq<ental<deres<Aequalis
sermersuata	sermersuaq<ental<deres<Relativ
sermersuatali	sermersuaq<ental<deres<Relativ+LI
sermersuatalu	sermersuaq<ental<deres<Relativ+LU
sermersua	sermersuaq<ental<hans<Absolut
sermersuali	sermersuaq<ental<hans<Absolut+LI
sermersualuunniit	sermersuaq<ental<hans<Absolut+LUUNNIIT
sermersuata	sermersuaq<ental<hans<Relativ
sermersuatalu	sermersuaq<ental<hans<Relativ+LU
sermersuarmilu	sermersuaq<ental<Lokalis+LU
sermersuanniilaarpungaana	sermersuaq<ental<min<Lokalis+IP-LAAR<Indikativ<jeg+UNA
sermersuanneeqqaarlutik	sermersuaq<ental<min<Lokalis+IP-QQAAR<Ledsagemåde<de_selv
sermersuanneeqqaartut	sermersuaq<ental<min<Lokalis+IP-QQAAR<Participium<de
sermersuarminik	sermersuaq<ental<sin<Instrumentalis
sermersuarmininguna	sermersuaq<ental<sin<Instrumentalis+UNA
sermersuarmut	sermersuaq<ental<Terminalis
sermersuit	sermersuaq<flertal<Absolut
sermersuilli	sermersuaq<flertal<Absolut+LI
sermersuillu	sermersuaq<flertal<Absolut+LU
sermersui	sermersuaq<flertal<deres<Absolut
sermersuili	sermersuaq<flertal<deres<Absolut+LI
sermersuarniissammanuna	sermersuaq<flertal<Instrumentalis-IR-SSA<Causativ<han+UNA
sermersuarniikkaluarneq	sermersuaq<flertal<Lokalis+IP+GALUAR+NIQ<ental<Absolut
sermersuarniinnginnamaana	sermersuaq<flertal<Lokalis+IP-NNGIT<Causativ<jeg+UNA
sermersuanni	sermersuaq<flertal<min<Lokalis
sermersuanneeqqaartoruna	sermersuaq<flertal<min<Lokalis+IP-QQAAR+TUQ<ental<Absolut+UNA
sermersuarnukalaartarpa	sermersuaq<flertal<Terminalis-KAR-LAAR=TAR<Interrogativ<han
sermersuarnulli	sermersuaq<flertal<Terminalis+LI
sinnerusummanga	sinner+GUSUP<Causativ<HanMig
sinniinnarlara	sinner-INNAR<Optativ<JegHam
sinnilermanga	sinner-LIR<Causativ<HanMig
sinnilertigillu	sinner-LIR<Imperativ<ViDem+LU
sinnerneqarnerpaanni	sinner+NIQAR+NIRPAAQv<flertal<min<Lokalis
sinninngimmanga	sinner-NNGIT<Causativ<HanMig
sinneqqaarmanga	sinner-QQAAR<Causativ<HanMig
sinneqqutigilli	sinner-QQU<Imperativ<ViDem+LI
sinneqquassi	sinner-QQU<Indikativ<JegJer
sinnissaviuk	sinner-SSA<Interrogativ<DuHam
sinnertorujussuuagununa	sinner+TUQ=RUJUK=SUAQ=U<Indikativ<ViDem+UNA
sisamaannalereqqaarfiinnaassallutinguna	sisamat-INNAQ-LIRI-QQAAR+FIK-INNAQ-U-SSA<Ledsagemåde<de_selv+UNA
sisamaannalilaarlara	sisamat-INNAQ-LIR_nv-LAAR<Optativ<JegHam
sisamaannanngorusufferujunneeqquiuk	sisamat-INNAQ-NNGUR+GUSUP+FIK-RUJUK<flertal<min<Lokalis+IP-QQU<Interrogativ<DuHam
sisamaannanngulaartartullu	sisamat-INNAQ-NNGUR-LAAR=TAR<Participium<de+LU
sisamanuna	sisamat<Talord<flertal<Absolut+UNA
Sisimiut	Sisimiut<Absolut
Sisimiulli	Sisimiut<Absolut+LI
Sisimiununa	Sisimiut<Absolut+UNA
Sisimiunik	Sisimiut<Instrumentalis
Sisimiuninguna	Sisimiut<Instrumentalis+UNA
Sisimiuni	Sisimiut<Lokalis
Sisimiuniikkaluarmata	Sisimiut<Lokalis+IP+GALUAR<Causativ<de
Sisimiuniilermalli	Sisimiut<Lokalis+IP-LIR<Causativ<han+LI
Sisimiuniittungalu	Sisimiut<Lokalis+IP<Participium<jeg+LU
Sisimiuneeqqaarlutilli	Sisimiut<Lokalis+IP-QQAAR<Ledsagemåde<de_selv+LI
Sisimiuneeqquassi	Sisimiut<Lokalis+IP-QQU<Indikativ<JegJer
Sisimiuneeqquiuk	Sisimiut<Lokalis+IP-QQU<Interrogativ<DuHam
Sisimiuneeqqulara	Sisimiut<Lokalis+IP-QQU<Optativ<JegHam
Sisimiuneeriarmalli	Sisimiut<Lokalis+IP-RIAR<Causativ<han+LI
Sisimiuneeriarnerali	Sisimiut<Lokalis+IP-RIAR+NIQ<ental<hans<Absolut+LI
Sisimiuneereerattali	Sisimiut<Lokalis+IP-RIIR<Causativ<vi+LI
Sisimiormiu	Sisimiut+MIU<ental<Absolut
Sisimiormiumilu	Sisimiut+MIU<ental<Lokalis+LU
Sisimiormiumukaqqutigit	Sisimiut+MIU<ental<Terminalis-KAR-QQU<Imperativ<ViDem
Sisimiormiunik	Sisimiut+MIU<flertal<Instrumentalis
Sisimiormiunilli	Sisimiut+MIU<flertal<Instrumentalis+LI
Sisimiormiunillu	Sisimiut+MIU<flertal<Instrumentalis+LU
Sisimiormiunilluunniit	Sisimiut+MIU<flertal<Instrumentalis+LUUNNIIT
Sisimiormiuninguna	Sisimiut+MIU<flertal<Instrumentalis+UNA
Sisimiormiuni	Sisimiut+MIU<flertal<Lokalis
Sisimiormiuniilaartartoqarpoq	Sisimiut+MIU<flertal<Lokalis+IP-LAAR=TAR+TUQ-QAR<Indikativ<han
Sisimiormiuniinngimmata	Sisimiut+MIU<flertal<Lokalis+IP-NNGIT<Causativ<de
Sisimiormiulerivugut	Sisimiut+MIU-LIRI<Indikativ<vi
Sisimiormiulerilaartuuikkamali	Sisimiut+MIU-LIRI-LAAR+TUQ-U-VIP<Causativ<jeg+LI
Sisimiormiulereqqutigit	Sisimiut+MIU-LIRI-QQU<Imperativ<ViDem
Sisimiormiunngoqqaarpugut	Sisimiut+MIU-NNGUR-QQAAR<Indikativ<vi
Sisimiormiunngoqqaarlutillu	Sisimiut+MIU-NNGUR-QQAAR<Ledsagemåde<de_selv+LU
Sisimiormiunngoqaalli	Sisimiut+MIU-NNGUR-QӘ<Indikativ<de+LI
Sisimiormiunngoriartoqaqaangaana	Sisimiut+MIU-NNGUR-RIAR+TUQ-QAR-QӘ<Indikativ<jeg+UNA
Sisimiormiunngussagaluartoq	Sisimiut+MIU-NNGUR-SSA=GALUAR<Participium<han
Sisimiormioqarpoq	Sisimiut+MIU-QAR<Indikativ<han
Sisimiormioqarporli	Sisimiut+MIU-QAR<Indikativ<han+LI
Sisimiormioqarpa	Sisimiut+MIU-QAR<Interrogativ<han
Sisimiormioqarneq	Sisimiut+MIU-QAR+NIQ<ental<Absolut
Sisimiormioqarnerlu	Sisimiut+MIU-QAR+NIQ<ental<Absolut+LU
Sisimiormioqarneruna	Sisimiut+MIU-QAR+NIQ<ental<Absolut+UNA
Sisimiormioqartoq	Sisimiut+MIU-QAR<Participium<han
Sisimiormioqartorli	Sisimiut+MIU-QAR<Participium<han+LI
Sisimiormioqartorlu	Sisimiut+MIU-QAR<Participium<han+LU
Sisimiormioqartoq	Sisimiut+MIU-QAR+TUQ<ental<Absolut
Sisimiormioqartorli	Sisimiut+MIU-QAR+TUQ<ental<Absolut+LI
Sisimiormiuugamalu	Sisimiut+MIU-U<Causativ<jeg+LU
Sisimiormiuugaluarferujugalu	Sisimiut+MIU-U+GALUAR+FIK-RUJUK<ental<min<Absolut+LU
Sisimiormioorusukkatta	Sisimiut+MIU-U+GUSUP<Causativ<vi
Sisimiormioorusunnerni	Sisimiut+MIU-U+GUSUP+NIQ<flertal<Lokalis
Sisimiormiuuvunga	Sisimiut+MIU-U<Indikativ<jeg
Sisimiormiuuinnarpunga	Sisimiut+MIU-U-INNAR<Indikativ<jeg
Sisimiormiuunini	Sisimiut+MIU-U+NIQ<ental<sin<Absolut
Sisimiormiooqqaarama	Sisimiut+MIU-U-QQAAR<Causativ<jeg
Sisimiormiooqqaarlutik	Sisimiut+MIU-U-QQAAR<Ledsagemåde<de_selv
Sisimiormiooqqaartooriarneratalu	Sisimiut+MIU-U-QQAAR+TUQ-U-RIAR+NIQ<ental<deres<Relativ+LU
Sisimiormiooqqutigilluunniit	Sisimiut+MIU-U-QQU<Imperativ<ViDem+LUUNNIIT
Sisimiormiooriarnini	Sisimiut+MIU-U-RIAR+NIQ<ental<sin<Absolut
Sisimiormiooreernerilli	Sisimiut+MIU-U-RIIR+NIQ<flertal<Relativ+LI
Sisimiormiooreernerpaaneeriarlutilli	Sisimiut+MIU-U-RIIR+NIRPAAQ<flertal<Lokalis+IP-RIAR<Ledsagemåde<de_selv+LI
Sisimiormiuusimanerpaamininguna	Sisimiut+MIU-U+SIMA+NIRPAAQ<ental<sin<Instrumentalis+UNA
Sisimiormiuusinnaasuata	Sisimiut+MIU-U+SINNAA+TUQ<ental<deres<Relativ
Sisimiormiuutillarali	Sisimiut+MIU-U+TIP<Optativ<JegHam+LI
Sisimiormiuuallaanngiffinngooriarfippassui	Sisimiut+MIU-U+VALLAAR=NNGIT+FIK-NNGUAQ-U-RIAR+FIK+PASSUAQ<flertal<deres<Absolut
Sisimiunut	Sisimiut<Terminalis
Sisimiunukalerneq	Sisimiut<Terminalis-KAR-LIR+NIQ<ental<Absolut
Sisimiunukalertut	Sisimiut<Terminalis-KAR-LIR<Participium<de
Sisimiunukanngitsoq	Sisimiut<Terminalis-KAR-NNGIT+TUQ<ental<Absolut
Sisimiunukariarfikkunneeqqaartoqanngilaq	Sisimiut<Terminalis-KAR-RIAR+FIK-KKUT<flertal<Instrumentalis-IR-QQAAR+TUQ-QAR-NNGIT<Indikativ<han
Sisimiunukariarlutik	Sisimiut<Terminalis-KAR-RIAR<Ledsagemåde<de_selv
Sisimiunukassaagununa	Sisimiut<Terminalis-KAR-SSA<Indikativ<vi+UNA
Sisimiunulli	Sisimiut<Terminalis+LI
Sisimiunununa	Sisimiut<Terminalis+UNA
siullerilerlara	siulleq+GӘ-LIR<Optativ<JegHam
siulliinnanngussagaluarattaana	siulleq-INNAQ-NNGUR-SSA=GALUAR<Causativ<vi+UNA
siullerujuga	siulleq-RUJUK<ental<min<Absolut
siullerujussuarneeqqaarmatali	siulleq-RUJUK=SUAQ<flertal<Lokalis+IP-QQAAR<Causativ<de+LI
siullertaavittoq	siulleq+TAAR-VIP+TUQ<ental<Absolut
sivikilluinnarneratalu	sivikip+LUINNAR+NIQ<ental<hans<Relativ+LU
sivikinnerilli	sivikip+NIQ<flertal<Relativ+LI
sivikeqqaarfeqartitsigilluunniit	sivikip-QQAAR+FIK-QAR+TIP<Imperativ<ViDem+LUUNNIIT
sivikeqqaarnerpaaqariartunngooriarfiinnaa	sivikip-QQAAR+NIRPAAQ-QAR-RIAR+TUQ-NNGUAQ-U-RIAR+FIK-INNAQ<ental<hans<Absolut
sivikeqquassiluunniit	sivikip-QQU<Indikativ<JegJer+LUUNNIIT
sivikeqqulara	sivikip-QQU<Optativ<JegHam
sivikeqaaq	sivikip-QӘ<Indikativ<han
sivikereermata	sivikip-RIIR<Causativ<de
sivikereeratta	sivikip-RIIR<Causativ<vi
sivikereernerpaavi	sivikip-RIIR+NIRPAAQ<flertal<hans<Absolut
sooq	sooq<Partikel
soorli	sooq<Partikel+LI
soorluunniit	sooq<Partikel+LUUNNIIT
soorunami	soorunami<Partikel
soorunamili	soorunami<Partikel+LI
soqutiginarnerinuna	soqutiginar+NIQ<flertal<Relativ+UNA
soqutiginarsimagatta	soqutiginar+SIMA<Causativ<vi
soqutiginarsimanini	soqutiginar+SIMA+NIQ<ental<sin<Absolut
soqutiginartarpa	soqutiginar+TAR<Interrogativ<han
soqutiginavittorigaluarpassi	soqutiginar-VIP+TUQ+GӘ+GALUAR<Indikativ<JegJer
soqutigigaluarpalli	soqutigә+GALUAR<Indikativ<DuHam+LI
soqutigiviuk	soqutigә<Interrogativ<DuHam
soqutigaluguli	soqutigә<Ledsagemåde<ham+LI
soqutigilerlara	soqutigә-LIR<Optativ<JegHam
soqutigeriartigilli	soqutigә-RIAR<Imperativ<ViDem+LI
soqutigisariaqartigilli	soqutigә+TARIAQAR<Imperativ<ViDem+LI
soqutigisorujorujussuullugu	soqutigә+TUQ=RUJUK=RUJUK=SUAQ=U<Ledsagemåde<ham
soqutigivallaannginnakku	soqutigә+VALLAAR=NNGIT<Causativ<JegHam
sorsunneranuna	sorsunneq<ental<Absolut<deres+UNA
sorsunnertullu	sorsunneq<ental<Aequalis+LU
sorsunninneeriarniniluunniit	sorsunneq<ental<min<Lokalis+IP-RIAR+NIQ<ental<sin<Absolut+LUUNNIIT
sorsunneriittulli	sorsunneq+GIIT<flertal<Aequalis+LI
sorsunnikkunni	sorsunneq-KKUT<flertal<Lokalis
sorsunnikunngulaartartulilerlungalu	sorsunneq-KU-NNGUR-LAAR=TAR+TUQ-LIR_nv-LIR<Ledsagemåde<mig+LU
sorsunnilinngoriartulilerinatik	sorsunneq-LIK-NNGUR-RIAR+TUQ-LIK-LIRI-NNGIT<Ledsagemåde<de_selv
sorsunnilinnginnakku	sorsunneq-LIR_nv-NNGIT<Causativ<JegHam
sorsunnileqigakkuuna	sorsunneq-LIR_nv-QӘ<Causativ<JegHam+UNA
sorsunnilissavaanngaana	sorsunneq-LIR_nv-SSA<Indikativ<DeMig+UNA
sorsunninngooqquaanga	sorsunneq-NNGUAQ-U-QQU<Indikativ<HanMig
sorsunnerpassuilli	sorsunneq+PASSUAQ<flertal<Absolut+LI
sorsunnerpassuillu	sorsunneq+PASSUAQ<flertal<Absolut+LU
sorsunnersiulertullu	sorsunneq+SIUR-LIR<Participium<de+LU
sorsunnissalerilluarnerneeriarneq	sorsunneq-SSAQ-LIRI+LUAR+NIQ<flertal<Lokalis+IP-RIAR+NIQ<ental<Absolut
sorsunnissaagaluata	sorsunneq-SSAQ=U=GALUAQ<ental<hans<Relativ
summallu	su<Causativ<han+LU
sujunnaarmallu	su+GUNNAAR<Causativ<han+LU
sujunnaartorli	su+GUNNAAR<Participium<han+LI
sujunnaartungalu	su+GUNNAAR<Participium<jeg+LU
sorusuffeqariarmata	su+GUSUP+FIK-QAR-RIAR<Causativ<de
sorusunnerpaaniilernerli	su+GUSUP+NIRPAAQ<flertal<Instrumentalis-IR-LIR+NIQ<ental<Absolut+LI
sorusuttussaagaluattununa	su+GUSUP+TUQ-SSAQ=U=GALUAQ<ental<deres<Aequalis+UNA
suvoq	su<Indikativ<han
suvungalu	su<Indikativ<jeg+LU
suit	su<Interrogativ<du
SULI	SULI<Partikel
SULIli	SULI<Partikel+LI
SULIlu	SULI<Partikel+LU
SULIluunniit	SULI<Partikel+LUUNNIIT
SULIuna	SULI<Partikel+UNA
sulerfeqalernini	su-LIR+FIK-QAR-LIR+NIQ<ental<sin<Absolut
sulerpugut	su-LIR<Indikativ<vi
sulluarnerpaamununa	su+LUAR+NIRPAAQ<ental<Terminalis+UNA
sunera	su+NIQ<ental<hans<Absolut
sunerinuna	su+NIQ<flertal<Relativ+UNA
sunernini	su+NIR+NIQ<ental<sin<Absolut
sunerpaaq	su+NIRPAAQ<ental<Absolut
sunnginnatta	su-NNGIT<Causativ<vi
sunngitsoqassasunga	su-NNGIT+TUQ-QAR-SSA<Participium<jeg
susunga	su<Participium<jeg
soqqaaratta	su-QQAAR<Causativ<vi
soqqaarfiinuna	su-QQAAR+FIK<flertal<Absolut+UNA
soqqaarfiinnakka	su-QQAAR+FIK-INNAQ<flertal<min<Absolut
soqqaarferujussuattut	su-QQAAR+FIK-RUJUK=SUAQ<ental<deres<Aequalis
soqqaarneralu	su-QQAAR+NIQ<ental<hans<Absolut+LU
soqqaarnini	su-QQAAR+NIQ<ental<sin<Absolut
soqqaarninili	su-QQAAR+NIQ<ental<sin<Absolut+LI
soqqaarnerpaanngulaarmallu	su-QQAAR+NIRPAAQ-NNGUR-LAAR<Causativ<han+LU
soqquat	su-QQU<Indikativ<DuHam
soqquarpununa	su-QQU<Indikativ<ViHam+UNA
soqqulara	su-QQU<Optativ<JegHam
soqimmata	su-QӘ<Causativ<de
soqalutilli	su-QӘ<Ledsagemåde<de_selv+LI
soqisununa	su-QӘ<Participium<de+UNA
soqisunnguuniniluunniit	su-QӘ+TUQ-NNGUAQ-U+NIQ<ental<sin<Absolut+LUUNNIIT
soqisorujussuilu	su-QӘ+TUQ-RUJUK=SUAQ<flertal<hans<Absolut+LU
soriaratta	su-RIAR<Causativ<vi
soriarlutik	su-RIAR<Ledsagemåde<de_selv
soreeramali	su-RIIR<Causativ<jeg+LI
soreerfeqalaartartuiuna	su-RIIR+FIK-QAR-LAAR=TAR+TUQ<flertal<hans<Absolut+UNA
soreerferujulluunniit	su-RIIR+FIK-RUJUK<ental<Absolut+LUUNNIIT
soreernertut	su-RIIR+NIQ<ental<Aequalis
soreertunga	su-RIIR<Participium<jeg
soreertukkui	su-RIIR+TUQ-KKUT<flertal<hans<Absolut
soreertorujoorusunnini	su-RIIR+TUQ-RUJUK-U+GUSUP+NIQ<ental<sin<Absolut
susimavoruna	su+SIMA<Indikativ<han+UNA
susimavunga	su+SIMA<Indikativ<jeg
susimasarattalu	su+SIMA=TAR<Causativ<vi+LU
sussagaluarferujussuattulluunniit	su-SSA=GALUAR+FIK-RUJUK=SUAQ<ental<deres<Aequalis+LUUNNIIT
sussagaluarpulli	su-SSA=GALUAR<Indikativ<de+LI
susaraluartunga	su+TAR=GALUAR<Participium<jeg
susartormiuummanuna	su+TAR+TUQ+MIU-U<Causativ<han+UNA
susorujorujussuullutik	su+TUQ=RUJUK=RUJUK=SUAQ=U<Ledsagemåde<de_selv
susussaasoq	su+TUQ=SSAQ=U<Participium<han
suikkamalu	su-VIP<Causativ<jeg+LU
taalaarakku	taa-LAAR<Causativ<JegHam
taalaartarakku	taa-LAAR=TAR<Causativ<JegHam
taalaartarlarali	taa-LAAR=TAR<Optativ<JegHam+LI
taalerpalli	taa-LIR<Indikativ<DuHam+LI
taanerulluguli	taa+NIRU<Ledsagemåde<ham+LI
taanngiliuk	taa-NNGIT<Interrogativ<DuHam
taareerpatit	taa-RIIR<Indikativ<DuDem
taasarmangaana	taa+TAR<Causativ<HanMig+UNA
taasorujussuutigilluunniit	taa+TUQ=RUJUK=SUAQ=U<Imperativ<ViDem+LUUNNIIT
taavallaarakkulu	taa+VALLAAR<Causativ<JegHam+LU
takisooq	takisooq<ental<Absolut
takisuualli	takisooq<ental<Absolut<deres+LI
takisuumiiginnarlutik	takisooq<ental<Instrumentalis-IR-INNAR<Ledsagemåde<de_selv
takulaarluginuna	taku-LAAR<Ledsagemåde<dem+UNA
takoqqaarmanga	taku-QQAAR<Causativ<HanMig
takoqilara	taku-QӘ<Optativ<JegHam
takoriartigillu	taku-RIAR<Imperativ<ViDem+LU
takoriarlara	taku-RIAR<Optativ<JegHam
takoriarlaralu	taku-RIAR<Optativ<JegHam+LU
takoreertigilli	taku-RIIR<Imperativ<ViDem+LI
takoreertigillu	taku-RIIR<Imperativ<ViDem+LU
takoreerlunga	taku-RIIR<Ledsagemåde<mig
takusimalaralu	taku+SIMA<Optativ<JegHam+LU
takussagaluarpassiuna	taku-SSA=GALUAR<Indikativ<JegJer+UNA
takusorujorujussuullugit	taku+TUQ=RUJUK=RUJUK=SUAQ=U<Ledsagemåde<dem
tallimaannalerereernerpaaq	tallimat-INNAQ-LIRI-RIIR+NIRPAAQ<ental<Absolut
tallimaannaleqaajuk	tallimat-INNAQ-LIR_nv-QӘ<Interrogativ<DuHam
tallimassalerisunga	tallimat-SSAQ-LIRI<Participium<jeg
tallimassalereerparpununa	tallimat-SSAQ-LIR_nv-RIIR<Indikativ<ViHam+UNA
tallimassanngoreerpisi	tallimat-SSAQ-NNGUR-RIIR<Interrogativ<I
tallimassaqassagaluarnerpaaqannginnerata	tallimat-SSAQ-QAR-SSA=GALUAR+NIRPAAQ-QAR-NNGIT+NIQ<ental<hans<Relativ
tallimassarsioqisorujussui	tallimat-SSAQ+SIUR-QӘ+TUQ-RUJUK=SUAQ<flertal<deres<Absolut
tallimassaaneratalu	tallimat-SSAQ-U+NIQ<ental<hans<Relativ+LU
tallimassaatippassilu	tallimat-SSAQ-U+TIP<Indikativ<JegJer+LU
tallimaninguna	tallimat<Talord<Instrumentalis+UNA
tallimani	tallimat<Talord<Lokalis
tamakku	tamakku<Pronomen<flertal<Absolut
tamakkuli	tamakku<Pronomen<flertal<Absolut+LI
tamanna	tamanna<Pronomen<ental<Absolut
tamannali	tamanna<Pronomen<ental<Absolut+LI
tamannaana	tamanna<Pronomen<ental<Absolut+UNA
tamarmik	tamarmik<Adjektiv
tamarmillu	tamarmik<Adjektiv+LU
tamarmilluunniit	tamarmik<Adjektiv+LUUNNIIT
tamatta	tamatta<Adjektiv
Tasiilaq	Tasiilaq<ental<Absolut
Tasiilarli	Tasiilaq<ental<Absolut+LI
Tasiilarlu	Tasiilaq<ental<Absolut+LU
Tasiilarluunniit	Tasiilaq<ental<Absolut+LUUNNIIT
Tasiilamik	Tasiilaq<Instrumentalis
Tasiilamilli	Tasiilaq<Instrumentalis+LI
Tasiilaminguna	Tasiilaq<Instrumentalis+UNA
Tasiilami	Tasiilaq<Lokalis
Tasiilameeqqaarneq	Tasiilaq<Lokalis+IP-QQAAR+NIQ<ental<Absolut
Tasiilameeriarmat	Tasiilaq<Lokalis+IP-RIAR<Causativ<han
Tasiilameeriarfittaareernini	Tasiilaq<Lokalis+IP-RIAR+FIK+TAAR-RIIR+NIQ<ental<sin<Absolut
Tasiilameeriarlutillu	Tasiilaq<Lokalis+IP-RIAR<Ledsagemåde<de_selv+LU
Tasiilameeriarniniuna	Tasiilaq<Lokalis+IP-RIAR+NIQ<ental<sin<Absolut+UNA
Tasiilameereermalli	Tasiilaq<Lokalis+IP-RIIR<Causativ<han+LI
Tasiilarmiuli	Tasiilaq+MIU<ental<Absolut+LI
Tasiilarmiunik	Tasiilaq+MIU<flertal<Instrumentalis
Tasiilarmiunillu	Tasiilaq+MIU<flertal<Instrumentalis+LU
Tasiilarmiuni	Tasiilaq+MIU<flertal<Lokalis
Tasiilarmiuneeqqaaratta	Tasiilaq+MIU<flertal<Lokalis+IP-QQAAR<Causativ<vi
Tasiilarmiulerimmalli	Tasiilaq+MIU-LIRI<Causativ<han+LI
Tasiilarmiuleripput	Tasiilaq+MIU-LIRI<Indikativ<de
Tasiilarmiulerinini	Tasiilaq+MIU-LIRI+NIQ<ental<sin<Absolut
Tasiilarmiunnguinnartullu	Tasiilaq+MIU-NNGUR-INNAR<Participium<de+LU
Tasiilarmiunngulaartartungaluunniit	Tasiilaq+MIU-NNGUR-LAAR=TAR<Participium<jeg+LUUNNIIT
Tasiilarmioqarpoq	Tasiilaq+MIU-QAR<Indikativ<han
Tasiilarmioqarporli	Tasiilaq+MIU-QAR<Indikativ<han+LI
Tasiilarmioqarpa	Tasiilaq+MIU-QAR<Interrogativ<han
Tasiilarmioqarneq	Tasiilaq+MIU-QAR+NIQ<ental<Absolut
Tasiilarmioqarnerli	Tasiilaq+MIU-QAR+NIQ<ental<Absolut+LI
Tasiilarmioqartorlu	Tasiilaq+MIU-QAR<Participium<han+LU
Tasiilarmioqartorli	Tasiilaq+MIU-QAR+TUQ<ental<Absolut+LI
Tasiilarmioqartoruna	Tasiilaq+MIU-QAR+TUQ<ental<Absolut+UNA
Tasiilarmiuufferujussuanni	Tasiilaq+MIU-U+FIK-RUJUK=SUAQ<flertal<min<Lokalis
Tasiilarmioorusummanuna	Tasiilaq+MIU-U+GUSUP<Causativ<han+UNA
Tasiilarmioorusullutilli	Tasiilaq+MIU-U+GUSUP<Ledsagemåde<de_selv+LI
Tasiilarmiuuinnartulereqigamaluunniit	Tasiilaq+MIU-U-INNAR+TUQ-LIRI-QӘ<Causativ<jeg+LUUNNIIT
Tasiilarmiooqquara	Tasiilaq+MIU-U-QQU<Indikativ<JegHam
Tasiilarmiooqqullunga	Tasiilaq+MIU-U-QQU<Ledsagemåde<mig
Tasiilarmiooriaratta	Tasiilaq+MIU-U-RIAR<Causativ<vi
Tasiilarmiuusarfigiileriniarnerma	Tasiilaq+MIU-U+TAR+FIK+GIIT-LIRI+NIAR+NIQ<ental<min<Relativ
Tasiilamut	Tasiilaq<Terminalis
Tasiilamukalaartarpungali	Tasiilaq<Terminalis-KAR-LAAR=TAR<Indikativ<jeg+LI
Tasiilamukannginnerlu	Tasiilaq<Terminalis-KAR-NNGIT+NIQ<ental<Absolut+LU
Tasiilamukanngitsulli	Tasiilaq<Terminalis-KAR-NNGIT<Participium<de+LI
Tasiilamukanngitsunga	Tasiilaq<Terminalis-KAR-NNGIT<Participium<jeg
Tasiilamukaqqaarmatali	Tasiilaq<Terminalis-KAR-QQAAR<Causativ<de+LI
Tasiilamukartorluunniit	Tasiilaq<Terminalis-KAR+TUQ<ental<Absolut+LUUNNIIT
Tasiilamukavinnerluunniit	Tasiilaq<Terminalis-KAR-VIP+NIQ<ental<Absolut+LUUNNIIT
Tasiilamullu	Tasiilaq<Terminalis+LU
Tasiilamulluunniit	Tasiilaq<Terminalis+LUUNNIIT
Tasiilamununa	Tasiilaq<Terminalis+UNA
Tasiilakkut	Tasiilaq<Vialis
Tasiilakkulli	Tasiilaq<Vialis+LI
Tasiilakkullu	Tasiilaq<Vialis+LU
Tasiilakkulluunniit	Tasiilaq<Vialis+LUUNNIIT
tassa	tassa<Partikel
tassali	tassa<Partikel+LI
tassalu	tassa<Partikel+LU
tassaluunniit	tassa<Partikel+LUUNNIIT
tikimmangalu	tikip<Causativ<HanMig+LU
tikippassi	tikip<Indikativ<JegJer
tikippiuk	tikip<Interrogativ<DuHam
tikilerlugu	tikip-LIR<Ledsagemåde<ham
tikilluarlugilluunniit	tikip+LUAR<Ledsagemåde<dem+LUUNNIIT
tikinneqarlutilluunniit	tikip+NIQAR<Ledsagemåde<de_selv+LUUNNIIT
tikeqqaarlugilli	tikip-QQAAR<Ledsagemåde<dem+LI
tikeqqutigilli	tikip-QQU<Imperativ<ViDem+LI
tikeqqullunga	tikip-QQU<Ledsagemåde<mig
tikeqqularalu	tikip-QQU<Optativ<JegHam+LU
tikeqimmanga	tikip-QӘ<Causativ<HanMig
tikeriartigilluunniit	tikip-RIAR<Imperativ<ViDem+LUUNNIIT
tikeriarlara	tikip-RIAR<Optativ<JegHam
tikeriarlaralu	tikip-RIAR<Optativ<JegHam+LU
tikereerpaanga	tikip-RIIR<Indikativ<HanMig
tikereerpiuk	tikip-RIIR<Interrogativ<DuHam
tikereerlara	tikip-RIIR<Optativ<JegHam
tikissimatigilluunniit	tikip+SIMA<Imperativ<ViDem+LUUNNIIT
tikivitsigilluunniit	tikip-VIP<Imperativ<ViDem+LUUNNIIT
timmisartorli	timmisartoq<ental<Absolut+LI
timmisartorluunniit	timmisartoq<ental<Absolut+LUUNNIIT
timmisartoralu	timmisartoq<ental<min<Absolut+LU
timmisartuninguna	timmisartoq<flertal<Instrumentalis+UNA
timmisartuni	timmisartoq<flertal<Lokalis
timmisartoriilerisorujussuunerpaaqavillutik	timmisartoq+GIIT-LIRI+TUQ=RUJUK=SUAQ=U+NIRPAAQ-QAR-VIP<Ledsagemåde<de_selv
timmisartukkulluunniit	timmisartoq-KKUT<flertal<Absolut+LUUNNIIT
timmisartukkunneeqqutiginuna	timmisartoq-KKUT<flertal<Lokalis+IP-QQU<Imperativ<ViDem+UNA
timmisartullilluunniit	timmisartoq-LIK<flertal<Absolut+LUUNNIIT
timmisartulinneerpallaartunga	timmisartoq-LIK<flertal<Instrumentalis-IR+VALLAAR<Participium<jeg
timmisartuleriniartunngooriarattaluunniit	timmisartoq-LIRI+NIAR+TUQ-NNGUAQ-U-RIAR<Causativ<vi+LUUNNIIT
timmisartunngui	timmisartoq-NNGUAQ<flertal<hans<Absolut
timmisartunnguanngulertukusiulaartukooqigatta	timmisartoq-NNGUAQ-NNGUR-LIR+TUQ-KU+SIUR-LAAR+TUQ-KU-U-QӘ<Causativ<vi
timmisartunngorsimasartullu	timmisartoq-NNGUR+SIMA=TAR<Participium<de+LU
timmisartoqannginnini	timmisartoq-QAR-NNGIT+NIQ<ental<sin<Absolut
timmisartorujunnilu	timmisartoq-RUJUK<ental<sin<Absolut+LU
timmisartorujoqassallutilluunniit	timmisartoq-RUJUK-QAR-SSA<Ledsagemåde<de_selv+LUUNNIIT
timmisartorujoqassallutinguna	timmisartoq-RUJUK-QAR-SSA<Ledsagemåde<de_selv+UNA
timmisartorujussioriartorujussuattulluunniit	timmisartoq-RUJUK+SIUR-RIAR+TUQ-RUJUK=SUAQ<ental<deres<Aequalis+LUUNNIIT
timmisartorsioqqaarlutik	timmisartoq+SIUR-QQAAR<Ledsagemåde<de_selv
timmisartussakkununa	timmisartoq-SSAQ<ental<Vialis+UNA
timmisartussalilerakkuli	timmisartoq-SSAQ-LIR_nv-LIR<Causativ<JegHam+LI
timmisartussartaaqqutigilluunniit	timmisartoq-SSAQ+TAAR-QQU<Imperativ<ViDem+LUUNNIIT
timmisartussaagaluaminik	timmisartoq-SSAQ=U=GALUAQ<flertal<sin<Instrumentalis
timmisartuuinnarpit	timmisartoq-U-INNAR<Interrogativ<du
timmisartooqqaarfittaassava	timmisartoq-U-QQAAR+FIK+TAAR-SSA<Interrogativ<han
timmisartooqqutigit	timmisartoq-U-QQU<Imperativ<ViDem
tulluarmatali	tulluar<Causativ<de+LI
tulluaraluartununa	tulluar+GALUAR<Participium<de+UNA
tulluariartorpisi	tulluar+GIARTUR<Interrogativ<I
tulluariartornerlu	tulluar+GIARTUR+NIQ<ental<Absolut+LU
tulluariartortulli	tulluar+GIARTUR<Participium<de+LI
tulluarpoq	tulluar<Indikativ<han
tulluaannarpisi	tulluar-INNAR<Interrogativ<I
tulluarluinnartunga	tulluar+LUINNAR<Participium<jeg
tulluarnerfittaalaartartutut	tulluar+NIR+FIK+TAAR-LAAR=TAR+TUQ<ental<Aequalis
tulluarnerummanuna	tulluar+NIRU<Causativ<han+UNA
tulluartut	tulluar<Participium<de
tulluaqqaarfikkunneereertoqarpoq	tulluar-QQAAR+FIK-KKUT<flertal<Instrumentalis-IR-RIIR+TUQ-QAR<Indikativ<han
tulluassasungali	tulluar-SSA<Participium<jeg+LI
tulluartartui	tulluar+TAR+TUQ<flertal<deres<Absolut
tulluartorujorujussuua	tulluar+TUQ=RUJUK=RUJUK=SUAQ=U<Interrogativ<han
tulluartorujorujussuullutinguna	tulluar+TUQ=RUJUK=RUJUK=SUAQ=U<Ledsagemåde<de_selv+UNA
tulluartorujussuunerit	tulluar+TUQ=RUJUK=SUAQ=U+NIQ<flertal<Absolut
tulluartussaanini	tulluar+TUQ=SSAQ=U+NIQ<ental<sin<Absolut
tunuliaqulli	tunuliaqut<ental<Absolut+LI
tunuliaqullu	tunuliaqut<ental<Absolut+LU
tunuliaqununa	tunuliaqut<ental<Absolut+UNA
tunuliaqummillu	tunuliaqut<ental<Instrumentalis+LU
tunuliaqummeeqqaarpit	tunuliaqut<ental<Lokalis+IP-QQAAR<Interrogativ<du
tunuliaqummukalaartartulli	tunuliaqut<ental<Terminalis-KAR-LAAR=TAR<Participium<de+LI
tunuliaqummukariarmalli	tunuliaqut<ental<Terminalis-KAR-RIAR<Causativ<han+LI
tunuliaqummukariarfeqaqigattali	tunuliaqut<ental<Terminalis-KAR-RIAR+FIK-QAR-QӘ<Causativ<vi+LI
tunuliaqummukariartorujunnilu	tunuliaqut<ental<Terminalis-KAR-RIAR+TUQ-RUJUK<ental<sin<Absolut+LU
tunuliaqummulluunniit	tunuliaqut<ental<Terminalis+LUUNNIIT
tunuliaqutileriarlugulu	tunuliaqut-LIR_nv-RIAR<Ledsagemåde<ham+LU
tunuliaquterpassui	tunuliaqut+PASSUAQ<flertal<deres<Absolut
tunuliaqutaasariaqarnerpaanili	tunuliaqut-U+TARIAQAR+NIRPAAQ<flertal<Lokalis+LI
tusagassiortooqisorujulereerakkuli	tusagassiortoq-U-QӘ+TUQ-RUJUK-LIR_nv-RIIR<Causativ<JegHam+LI
tusarnerutigillu	tusar+NIRU<Imperativ<ViDem+LU
tusaqqaarlara	tusar-QQAAR<Optativ<JegHam
tusaqquaannga	tusar-QQU<Indikativ<DeMig
tusareermanga	tusar-RIIR<Causativ<HanMig
tusartarluguuna	tusar+TAR<Ledsagemåde<ham+UNA
tusilalerpunga	tusilar-LIR<Indikativ<jeg
tusilanngilanga	tusilar-NNGIT<Indikativ<jeg
tusilarnatinguna	tusilar-NNGIT<Ledsagemåde<de_selv+UNA
tusilanngitsoq	tusilar-NNGIT<Participium<han
tusilavimmatalu	tusilar-VIP<Causativ<de+LU
tusilavittulli	tusilar-VIP<Participium<de+LI
tutsiuteqqimmat	tutsiuteqqip<Causativ<han
tutsiuteqqikkaluarferujooqqulara	tutsiuteqqip+GALUAR+FIK-RUJUK-U-QQU<Optativ<JegHam
tutsiuteqqikkiartortoqalaarnerpaavi	tutsiuteqqip+GIARTUR+TUQ-QAR-LAAR+NIRPAAQ<flertal<hans<Absolut
tutsiuteqqittunga	tutsiuteqqip<Participium<jeg
tutsiuteqqeqqaarpoq	tutsiuteqqip-QQAAR<Indikativ<han
tutsiuteqqeqimmatalu	tutsiuteqqip-QӘ<Causativ<de+LU
tutsiuteqqeriartoq	tutsiuteqqip-RIAR+TUQ<ental<Absolut
tutsiuteqqeriartukusiulaarnerpaarli	tutsiuteqqip-RIAR+TUQ-KU+SIUR-LAAR+NIRPAAQ<ental<Absolut+LI
tutsiuteqqissinnaanertulli	tutsiuteqqip+SINNAA+NIQ<ental<Aequalis+LI
tutsiuteqqittorujussuusulli	tutsiuteqqip+TUQ=RUJUK=SUAQ=U<Participium<de+LI
uagut	uagut<Pronomen<ental<Absolut
uagulli	uagut<Pronomen<ental<Absolut+LI
uagullu	uagut<Pronomen<ental<Absolut+LU
uagulluunniit	uagut<Pronomen<ental<Absolut+LUUNNIIT
uagununa	uagut<Pronomen<ental<Absolut+UNA
uannit	uanga<Pronomen<Ablativ<jeg
uannillu	uanga<Pronomen<Ablativ<jeg+LU
uannilluunniit	uanga<Pronomen<Ablativ<jeg+LUUNNIIT
uanninuna	uanga<Pronomen<Ablativ<jeg+UNA
uanga	uanga<Pronomen<jeg
uangali	uanga<Pronomen<jeg+LI
uangalu	uanga<Pronomen<jeg+LU
uannulluunniit	uanga<Pronomen<Terminalis<jeg+LUUNNIIT
uannununa	uanga<Pronomen<Terminalis<jeg+UNA
uani	uani<Partikel
uaniluunniit	uani<Partikel+LUUNNIIT
uaniuna	uani<Partikel+UNA
ukiigamaana	ukii<Causativ<jeg+UNA
ukeerusufferujooqquaraluunniit	ukii+GUSUP+FIK-RUJUK-U-QQU<Indikativ<JegHam+LUUNNIIT
ukeerusuttoq	ukii+GUSUP<Participium<han
ukiivit	ukii<Interrogativ<du
ukiilaarlutinguna	ukii-LAAR<Ledsagemåde<de_selv+UNA
ukiilluinnartungalu	ukii+LUINNAR<Participium<jeg+LU
ukiinikuugama	ukii+NIKUU<Causativ<jeg
ukiinerunerpaartaaqqularaluunniit	ukii+NIRU+NIRPAAQ+TAAR-QQU<Optativ<JegHam+LUUNNIIT
ukeeqqaarpit	ukii-QQAAR<Interrogativ<du
ukeeqquaa	ukii-QQU<Indikativ<HanHam
ukeeqaaq	ukii-QӘ<Indikativ<han
ukeeqalutilli	ukii-QӘ<Ledsagemåde<de_selv+LI
ukeeqalutillu	ukii-QӘ<Ledsagemåde<de_selv+LU
ukeeqisora	ukii-QӘ+TUQ<ental<min<Absolut
ukeeriarlutillu	ukii-RIAR<Ledsagemåde<de_selv+LU
ukeereerama	ukii-RIIR<Causativ<jeg
ukeereerfeqavippa	ukii-RIIR+FIK-QAR-VIP<Interrogativ<han
ukeereerpugununa	ukii-RIIR<Indikativ<vi+UNA
ukiisinnaaffeqavinnerpaanneeqqaarlutilluunniit	ukii+SINNAA+FIK-QAR-VIP+NIRPAAQv<flertal<min<Lokalis+IP-QQAAR<Ledsagemåde<de_selv+LUUNNIIT
ukiititsigit	ukii+TIP<Imperativ<ViDem
ukiisussaagamaluunniit	ukii+TUQ=SSAQ=U<Causativ<jeg+LUUNNIIT
ukioq	ukioq<ental<Absolut
ukiualluunniit	ukioq<ental<Absolut<deres+LUUNNIIT
ukiunnguinnarpa	ukioq-NNGUR-INNAR<Interrogativ<han
ukiortaannarnerlu	ukioq+TAAR-INNAR+NIQ<ental<Absolut+LU
ukiuujartornerpaarsioqqaarnini	ukioq-U+GIARTUR+NIRPAAQ+SIUR-QQAAR+NIQ<ental<sin<Absolut
ukiooqqutigillu	ukioq-U-QQU<Imperativ<ViDem+LU
ukiuusariaqarlutinguna	ukioq-U+TARIAQAR<Ledsagemåde<de_selv+UNA
ulapaaraluarpoq	ulapaar+GALUAR<Indikativ<han
ulapaalaartorisarpakkaluunniit	ulapaar-LAAR+TUQ+GӘ+TAR<Indikativ<JegDem+LUUNNIIT
ulapaarluarlutilluunniit	ulapaar+LUAR<Ledsagemåde<de_selv+LUUNNIIT
ulapaarluinnarpa	ulapaar+LUINNAR<Interrogativ<han
ulapaarniarninili	ulapaar+NIAR+NIQ<ental<sin<Absolut+LI
ulapaaqqaartoorusummata	ulapaar-QQAAR+TUQ-U+GUSUP<Causativ<de
ulapaarsinnaanerpaanngunngillalli	ulapaar+SINNAA+NIRPAAQ-NNGUR-NNGIT<Indikativ<de+LI
ullora	ulloq<ental<min<Absolut
ullumali	ulloq<ental<min<Relativ+LI
ullulilerititsiginuna	ulloq-LIK-LIRI+TIP<Imperativ<ViDem+UNA
ullulereqqulara	ulloq-LIRI-QQU<Optativ<JegHam
ullorujussuattulli	ulloq-RUJUK=SUAQ<ental<deres<Aequalis+LI
ullorsiulaarpa	ulloq+SIUR-LAAR<Interrogativ<han
ullooqaanuna	ulloq-U-QӘ<Indikativ<de+UNA
ullumi	ullumi<Partikel
ullumilu	ullumi<Partikel+LU
ullumiluunniit	ullumi<Partikel+LUUNNIIT
ungasifferujussuatali	ungasip+FIK-RUJUK=SUAQ<ental<deres<Relativ+LI
ungasittunga	ungasip<Participium<jeg
ungaseqqummanga	ungasip-QQU<Causativ<HanMig
ungaseqisui	ungasip-QӘ+TUQ<flertal<hans<Absolut
ungasereerpunga	ungasip-RIIR<Indikativ<jeg
ungasereernerpaartaartuugama	ungasip-RIIR+NIRPAAQ+TAAR+TUQ-U<Causativ<jeg
ungasereertoriileqqaartigilli	ungasip-RIIR+TUQ+GIIT-LIR_nv-QQAAR<Imperativ<ViDem+LI
ungasereertunngoorusuffiit	ungasip-RIIR+TUQ-NNGUAQ-U+GUSUP+FIK<flertal<Relativ
ungasissimasartooqqulara	ungasip+SIMA=TAR+TUQ-U-QQU<Optativ<JegHam
unimmata	unip<Causativ<de
unimmalli	unip<Causativ<han+LI
unimmallu	unip<Causativ<han+LU
unikkaluarfeqalerpungali	unip+GALUAR+FIK-QAR-LIR<Indikativ<jeg+LI
unippit	unip<Interrogativ<du
uninniarnatilluunniit	unip+NIAR=NNGIT<Ledsagemåde<de_selv+LUUNNIIT
unittorli	unip<Participium<han+LI
uneqqaarnerallu	unip-QQAAR+NIQ<ental<deres+LU
uneqqaartulli	unip-QQAAR<Participium<de+LI
uneqqugakku	unip-QQU<Causativ<JegHam
uneqqutigilli	unip-QQU<Imperativ<ViDem+LI
uneqqutiginuna	unip-QQU<Imperativ<ViDem+UNA
uneqquiuk	unip-QQU<Interrogativ<DuHam
uneqqullugu	unip-QQU<Ledsagemåde<ham
uneqqulara	unip-QQU<Optativ<JegHam
uneqaanga	unip-QӘ<Indikativ<jeg
uneqisussaleriarakku	unip-QӘ+TUQ-SSAQ-LIR_nv-RIAR<Causativ<JegHam
unereernerpaanili	unip-RIIR+NIRPAAQ<flertal<Lokalis+LI
unissagaluarpit	unip-SSA=GALUAR<Interrogativ<du
unittarporluunniit	unip+TAR<Indikativ<han+LUUNNIIT
unippallaarpungalu	unip+VALLAAR<Indikativ<jeg+LU
upernaaq	upernaaq<ental<Absolut
upernaarli	upernaaq<ental<Absolut+LI
upernaariileqalugilluunniit	upernaaq+GIIT-LIR_nv-QӘ<Ledsagemåde<dem+LUUNNIIT
upernaariinngoriarlutik	upernaaq+GIIT-NNGUR-RIAR<Ledsagemåde<de_selv
upernaarigaluarlarali	upernaaq+GӘ+GALUAR<Optativ<JegHam+LI
upernaariviuk	upernaaq+GӘ<Interrogativ<DuHam
upernaarinianngiliuk	upernaaq+GӘ+NIAR=NNGIT<Interrogativ<DuHam
upernaarissatigilli	upernaaq+GӘ-SSA<Imperativ<ViDem+LI
upernaakkunnilu	upernaaq-KKUT<flertal<Lokalis+LU
upernaakoqaqqaartoriilereqigattali	upernaaq-KU-QAR-QQAAR+TUQ+GIIT-LIRI-QӘ<Causativ<vi+LI
upernaalereriarlutinguna	upernaaq-LIRI-RIAR<Ledsagemåde<de_selv+UNA
upernaaleqaajuk	upernaaq-LIR_nv-QӘ<Interrogativ<DuHam
upernaalissallugilluunniit	upernaaq-LIR_nv-SSA<Ledsagemåde<dem+LUUNNIIT
upernaarmioqarpoq	upernaaq+MIU-QAR<Indikativ<han
upernaannguulaartarpa	upernaaq-NNGUAQ-U-LAAR=TAR<Interrogativ<han
upernaanngoqqaarattaana	upernaaq-NNGUR-QQAAR<Causativ<vi+UNA
upernaanngoqqutigit	upernaaq-NNGUR-QQU<Imperativ<ViDem
upernaarpassuaminik	upernaaq+PASSUAQ<flertal<sin<Instrumentalis
upernaaqassagaluarneq	upernaaq-QAR-SSA=GALUAR+NIQ<ental<Absolut
upernaaqassaangaana	upernaaq-QAR-SSA<Indikativ<jeg+UNA
upernaarujussuata	upernaaq-RUJUK=SUAQ<ental<hans<Relativ
upernaarsiorpit	upernaaq+SIUR<Interrogativ<du
upernaarsiulaarpungaana	upernaaq+SIUR-LAAR<Indikativ<jeg+UNA
upernaarsiulaartarmanuna	upernaaq+SIUR-LAAR=TAR<Causativ<han+UNA
upernaassalissagaluartigit	upernaaq-SSAQ-LIR_nv-SSA=GALUAR<Imperativ<ViDem
upernaajugaluarpunga	upernaaq-U+GALUAR<Indikativ<jeg
upernaaqqaarfililereerlunga	upernaaq-U-QQAAR+FIK-LIK-LIR_nv-RIIR<Ledsagemåde<mig
upernaajusorujorujussuunerpaaqavillutillu	upernaaq-U+TUQ=RUJUK=RUJUK=SUAQ=U+NIRPAAQ-QAR-VIP<Ledsagemåde<de_selv+LU
Upernavik	Upernavik<ental<Absolut
Upernavilli	Upernavik<ental<Absolut+LI
Upernavillu	Upernavik<ental<Absolut+LU
Upernavilluunniit	Upernavik<ental<Absolut+LUUNNIIT
Upernavinguna	Upernavik<ental<Absolut+UNA
Upernavimmik	Upernavik<Instrumentalis
Upernavimmilli	Upernavik<Instrumentalis+LI
Upernavimmillu	Upernavik<Instrumentalis+LU
Upernavimmilluunniit	Upernavik<Instrumentalis+LUUNNIIT
Upernavimminguna	Upernavik<Instrumentalis+UNA
Upernavimmi	Upernavik<Lokalis
Upernavimmeeqqaarlutik	Upernavik<Lokalis+IP-QQAAR<Ledsagemåde<de_selv
Upernavimmeeqqaartununa	Upernavik<Lokalis+IP-QQAAR<Participium<de+UNA
Upernavimmeeqqugakku	Upernavik<Lokalis+IP-QQU<Causativ<JegHam
Upernavimmeeqqulara	Upernavik<Lokalis+IP-QQU<Optativ<JegHam
Upernavimmeeriarattali	Upernavik<Lokalis+IP-RIAR<Causativ<vi+LI
Upernavimmeeriarnerilli	Upernavik<Lokalis+IP-RIAR+NIQ<flertal<Relativ+LI
Upernavimmiumeereeratta	Upernavik+MIU<ental<Lokalis+IP-RIIR<Causativ<vi
Upernavimmiunngoqalutilluunniit	Upernavik+MIU-NNGUR-QӘ<Ledsagemåde<de_selv+LUUNNIIT
Upernavimmioqarneq	Upernavik+MIU-QAR+NIQ<ental<Absolut
Upernavimmioqartorluunniit	Upernavik+MIU-QAR<Participium<han+LUUNNIIT
Upernavimmiooreerferujussua	Upernavik+MIU-U-RIIR+FIK-RUJUK=SUAQ<ental<hans<Absolut
Upernavimmukalaarporli	Upernavik<Terminalis-KAR-LAAR<Indikativ<han+LI
Upernavimmulluunniit	Upernavik<Terminalis+LUUNNIIT
Upernavikkut	Upernavik<Vialis
Upernavikkulli	Upernavik<Vialis+LI
Upernavikkullu	Upernavik<Vialis+LU
Upernavikkulluunniit	Upernavik<Vialis+LUUNNIIT
Upernavikkununa	Upernavik<Vialis+UNA
usiartorlutinguna	usi+GIARTUR<Ledsagemåde<de_selv+UNA
userusukkatta	usi+GUSUP<Causativ<vi
usilluinnarnerit	usi+LUINNAR+NIQ<flertal<Absolut
usinianngitsorujoqaviffilli	usi+NIAR=NNGIT+TUQ-RUJUK-QAR-VIP+FIK<ental<Absolut+LI
usiniartunga	usi+NIAR<Participium<jeg
usinikuusullu	usi+NIKUU<Participium<de+LU
usinerferujooriarferujoqassavisi	usi+NIR+FIK-RUJUK-U-RIAR+FIK-RUJUK-QAR-SSA<Interrogativ<I
usinerullutilli	usi+NIRU<Ledsagemåde<de_selv+LI
useqqaarattaana	usi-QQAAR<Causativ<vi+UNA
useqqaartulli	usi-QQAAR<Participium<de+LI
useqquassili	usi-QQU<Indikativ<JegJer+LI
useqquiuk	usi-QQU<Interrogativ<DuHam
useqqulara	usi-QQU<Optativ<JegHam
useqqularalu	usi-QQU<Optativ<JegHam+LU
useqalutilli	usi-QӘ<Ledsagemåde<de_selv+LI
useqalutinguna	usi-QӘ<Ledsagemåde<de_selv+UNA
useriarmata	usi-RIAR<Causativ<de
useriarmataluunniit	usi-RIAR<Causativ<de+LUUNNIIT
useriarfissiuippununa	usi-RIAR+FIK+SIUR-VIP<Indikativ<de+UNA
useriarlutilli	usi-RIAR<Ledsagemåde<de_selv+LI
useriarneq	usi-RIAR+NIQ<ental<Absolut
usereerlutik	usi-RIIR<Ledsagemåde<de_selv
usereertoq	usi-RIIR+TUQ<ental<Absolut
usisimammatali	usi+SIMA<Causativ<de+LI
usisimasarnerpaanngortorujorujussuunerpaaminik	usi+SIMA=TAR+NIRPAAQ-NNGUR+TUQ=RUJUK=RUJUK=SUAQ=U+NIRPAAQ<ental<sin<Instrumentalis
usissallutilli	usi-SSA<Ledsagemåde<de_selv+LI
usisorujussuuppulluunniit	usi+TUQ=RUJUK=SUAQ=U<Indikativ<de+LUUNNIIT
Uummannaq	Uummannaq<ental<Absolut
Uummannarli	Uummannaq<ental<Absolut+LI
Uummannarlu	Uummannaq<ental<Absolut+LU
Uummannarluunniit	Uummannaq<ental<Absolut+LUUNNIIT
Uummannaruna	Uummannaq<ental<Absolut+UNA
Uummannamik	Uummannaq<Instrumentalis
Uummannamilli	Uummannaq<Instrumentalis+LI
Uummannamillu	Uummannaq<Instrumentalis+LU
Uummannaminguna	Uummannaq<Instrumentalis+UNA
Uummannami	Uummannaq<Lokalis
Uummannamiimmatalu	Uummannaq<Lokalis+IP<Causativ<de+LU
Uummannamiilaartartoqanngilaq	Uummannaq<Lokalis+IP-LAAR=TAR+TUQ-QAR-NNGIT<Indikativ<han
Uummannameeriarniniuna	Uummannaq<Lokalis+IP-RIAR+NIQ<ental<sin<Absolut+UNA
Uummannameereertoruna	Uummannaq<Lokalis+IP-RIIR+TUQ<ental<Absolut+UNA
Uummannameereertoqanngilaruna	Uummannaq<Lokalis+IP-RIIR+TUQ-QAR-NNGIT<Indikativ<han+UNA
Uummannamilu	Uummannaq<Lokalis+LU
Uummannarmiuuna	Uummannaq+MIU<ental<Absolut+UNA
Uummannarmiunik	Uummannaq+MIU<flertal<Instrumentalis
Uummannarmiunilluunniit	Uummannaq+MIU<flertal<Instrumentalis+LUUNNIIT
Uummannarmiulerivikkamaluunniit	Uummannaq+MIU-LIRI-VIP<Causativ<jeg+LUUNNIIT
Uummannarmiunngulernerpaata	Uummannaq+MIU-NNGUR-LIR+NIRPAAQ<ental<deres<Relativ
Uummannarmiunngunngilangaana	Uummannaq+MIU-NNGUR-NNGIT<Indikativ<jeg+UNA
Uummannarmiunngunngilasi	Uummannaq+MIU-NNGUR-NNGIT<Interrogativ<I
Uummannarmiunngoqqutigilli	Uummannaq+MIU-NNGUR-QQU<Imperativ<ViDem+LI
Uummannarmiunngussaanga	Uummannaq+MIU-NNGUR-SSA<Indikativ<jeg
Uummannarmiunngussasunga	Uummannaq+MIU-NNGUR-SSA<Participium<jeg
Uummannarmioqarpoq	Uummannaq+MIU-QAR<Indikativ<han
Uummannarmioqarporli	Uummannaq+MIU-QAR<Indikativ<han+LI
Uummannarmioqarnerli	Uummannaq+MIU-QAR+NIQ<ental<Absolut+LI
Uummannarmioqartoq	Uummannaq+MIU-QAR<Participium<han
Uummannarmioqartorli	Uummannaq+MIU-QAR<Participium<han+LI
Uummannarmioqartoruna	Uummannaq+MIU-QAR<Participium<han+UNA
Uummannarmiuuvugununa	Uummannaq+MIU-U<Indikativ<vi+UNA
Uummannarmiuulaartarferujooreerlutinguna	Uummannaq+MIU-U-LAAR=TAR+FIK-RUJUK-U-RIIR<Ledsagemåde<de_selv+UNA
Uummannarmiuulluartoruna	Uummannaq+MIU-U+LUAR<Participium<han+UNA
Uummannarmiuuniannginnatta	Uummannaq+MIU-U+NIAR=NNGIT<Causativ<vi
Uummannarmiuuniartooqquaa	Uummannaq+MIU-U+NIAR+TUQ-U-QQU<Indikativ<HanHam
Uummannarmiooqqaartortaartussaaffeqalerferujussuanneeqqaarpulli	Uummannaq+MIU-U-QQAAR+TUQ+TAAR+TUQ=SSAQ=U+FIK-QAR-LIR+FIK-RUJUK=SUAQ<flertal<min<Lokalis+IP-QQAAR<Indikativ<de+LI
Uummannarmiooqquaali	Uummannaq+MIU-U-QQU<Indikativ<HanHam+LI
Uummannarmiooqqulara	Uummannaq+MIU-U-QQU<Optativ<JegHam
Uummannarmiooqimmata	Uummannaq+MIU-U-QӘ<Causativ<de
Uummannarmiuusorujorujussuusooriarnera	Uummannaq+MIU-U+TUQ=RUJUK=RUJUK=SUAQ=U+TUQ-U-RIAR+NIQ<ental<hans<Absolut
Uummannamut	Uummannaq<Terminalis
Uummannamukaannarama	Uummannaq<Terminalis-KAR-INNAR<Causativ<jeg
Uummannamukaannarpulli	Uummannaq<Terminalis-KAR-INNAR<Indikativ<de+LI
Uummannamukannginnerli	Uummannaq<Terminalis-KAR-NNGIT+NIQ<ental<Absolut+LI
Uummannamukanngitsungalu	Uummannaq<Terminalis-KAR-NNGIT<Participium<jeg+LU
Uummannamukaqqaartungali	Uummannaq<Terminalis-KAR-QQAAR<Participium<jeg+LI
Uummannamukaqqaartorlu	Uummannaq<Terminalis-KAR-QQAAR+TUQ<ental<Absolut+LU
Uummannamukariarmatali	Uummannaq<Terminalis-KAR-RIAR<Causativ<de+LI
Uummannamulli	Uummannaq<Terminalis+LI
Uummannamullu	Uummannaq<Terminalis+LU
Uummannamulluunniit	Uummannaq<Terminalis+LUUNNIIT
Uummannamununa	Uummannaq<Terminalis+UNA
Uummannakkut	Uummannaq<Vialis
Uummannakkulli	Uummannaq<Vialis+LI
Uummannakkullu	Uummannaq<Vialis+LU
Uummannakkulluunniit	Uummannaq<Vialis+LUUNNIIT
Uummannakkununa	Uummannaq<Vialis+UNA
